HomeTeam,AwayTeam,Year,HomeGoals,AwayGoals,TotalGoals
Spain,Czechoslovakia,1930,1,0,1
Portugal,Czechoslovakia,1930,1,0,1
Greece,Yugoslavia,1930,2,1,3
Northern Ireland,Wales,1930,7,0,7
Italy,Switzerland,1930,4,2,6
Kenya,Uganda,1930,0,0,0
Scotland,Northern Ireland,1930,3,1,4
Portugal,France,1930,2,0,2
Germany,Italy,1930,0,2,2
Czechoslovakia,Austria,1930,2,2,4
France,Switzerland,1930,3,3,6
England,Scotland,1930,5,2,7
Netherlands,Italy,1930,1,1,2
France,Belgium,1930,1,6,7
Switzerland,Hungary,1930,2,2,4
Yugoslavia,Bulgaria,1930,6,1,7
Curaçao,Aruba,1930,2,1,3
Czechoslovakia,Hungary,1930,1,1,2
Uganda,Kenya,1930,5,0,5
Netherlands,Belgium,1930,2,2,4
Switzerland,Germany,1930,0,5,5
Yugoslavia,Romania,1930,2,1,3
Germany,England,1930,3,3,6
Belgium,Republic of Ireland,1930,1,3,4
France,Czechoslovakia,1930,2,3,5
Hungary,Italy,1930,0,5,5
Austria,England,1930,0,0,0
Belgium,Netherlands,1930,3,1,4
France,Scotland,1930,0,2,2
Argentina,Uruguay,1930,1,1,2
Belgium,France,1930,1,2,3
Romania,Greece,1930,8,1,9
China PR,Philippines,1930,5,0,5
Japan,China PR,1930,3,3,6
Hungary,Austria,1930,2,1,3
Norway,Finland,1930,6,2,8
Belgium,Portugal,1930,2,1,3
Hungary,Netherlands,1930,6,2,8
Catalonia,Basque Country,1930,0,1,1
Czechoslovakia,Spain,1930,2,0,2
Bulgaria,Yugoslavia,1930,2,2,4
Sweden,Switzerland,1930,1,0,1
Finland,Denmark,1930,1,6,7
Norway,Switzerland,1930,3,0,3
Denmark,Sweden,1930,6,1,7
Italy,Spain,1930,2,3,5
Estonia,Latvia,1930,1,1,2
Sweden,Norway,1930,6,3,9
Belgium,United States,1930,0,3,3
France,Mexico,1930,4,1,5
Brazil,Yugoslavia,1930,1,2,3
Peru,Romania,1930,1,3,4
Argentina,France,1930,1,0,1
Chile,Mexico,1930,3,0,3
Bolivia,Yugoslavia,1930,0,4,4
Paraguay,United States,1930,0,3,3
Estonia,Sweden,1930,1,5,6
Uruguay,Peru,1930,1,0,1
Argentina,Mexico,1930,6,3,9
Chile,France,1930,1,0,1
Belgium,Paraguay,1930,0,1,1
Bolivia,Brazil,1930,0,4,4
Uruguay,Romania,1930,4,0,4
Argentina,Chile,1930,3,1,4
Latvia,Sweden,1930,0,5,5
Argentina,United States,1930,6,1,7
Uruguay,Yugoslavia,1930,6,1,7
Uruguay,Argentina,1930,4,2,6
Brazil,France,1930,3,2,5
Argentina,Yugoslavia,1930,3,1,4
Latvia,Finland,1930,3,0,3
Estonia,Finland,1930,4,0,4
Brazil,Yugoslavia,1930,4,1,5
Lithuania,Estonia,1930,2,1,3
Estonia,Latvia,1930,2,3,5
Brazil,United States,1930,4,3,7
Lithuania,Latvia,1930,3,3,6
Denmark,Germany,1930,6,3,9
Lithuania,Estonia,1930,4,0,4
Austria,Hungary,1930,2,3,5
Belgium,Czechoslovakia,1930,2,3,5
Norway,Denmark,1930,1,0,1
Belgium,Sweden,1930,2,2,4
Finland,Sweden,1930,4,4,8
Germany,Hungary,1930,5,3,8
Sweden,Poland,1930,0,3,3
Bulgaria,Romania,1930,5,3,8
England,Northern Ireland,1930,5,1,6
Scotland,Wales,1930,1,1,2
Hungary,Czechoslovakia,1930,1,1,2
Poland,Latvia,1930,6,0,6
Germany,Norway,1930,1,1,2
Switzerland,Netherlands,1930,6,3,9
Austria,Sweden,1930,4,1,5
Bulgaria,Yugoslavia,1930,0,3,3
Wales,England,1930,0,4,4
Portugal,Spain,1930,0,1,1
France,Belgium,1930,2,2,4
Greece,Bulgaria,1930,6,1,7
Basque Country,Catalonia,1931,3,2,5
Italy,France,1931,5,0,5
Barbados,Martinique,1931,3,2,5
Barbados,Martinique,1931,0,0,0
France,Czechoslovakia,1931,1,2,3
Northern Ireland,Scotland,1931,0,0,0
Italy,Austria,1931,2,1,3
Barbados,Martinique,1931,1,2,3
Guyana,Trinidad and Tobago,1931,2,1,3
Barbados,Trinidad and Tobago,1931,1,5,6
Guyana,Trinidad and Tobago,1931,0,2,2
Barbados,Trinidad and Tobago,1931,1,7,8
Guyana,Barbados,1931,9,0,9
Guyana,Barbados,1931,7,0,7
France,Germany,1931,1,0,1
Yugoslavia,Greece,1931,4,1,5
Czechoslovakia,Hungary,1931,3,3,6
Scotland,England,1931,2,0,2
Netherlands,Belgium,1931,3,2,5
Switzerland,Italy,1931,1,1,2
Curaçao,Aruba,1931,1,0,1
Austria,Czechoslovakia,1931,2,1,3
Hungary,Switzerland,1931,6,2,8
Portugal,Italy,1931,0,2,2
Paraguay,Argentina,1931,0,1,1
Spain,Italy,1931,0,0,0
Yugoslavia,Bulgaria,1931,1,0,1
Wales,Northern Ireland,1931,3,2,5
Paraguay,Argentina,1931,1,1,2
Netherlands,Germany,1931,1,1,2
Spain,Republic of Ireland,1931,1,1,2
Austria,Hungary,1931,0,0,0
Belgium,Netherlands,1931,4,2,6
Romania,Bulgaria,1931,5,2,7
France,England,1931,5,2,7
Austria,Scotland,1931,5,0,5
Belgium,England,1931,1,4,5
Italy,Scotland,1931,3,0,3
Yugoslavia,Hungary,1931,3,2,5
Germany,Austria,1931,0,6,6
Switzerland,Scotland,1931,2,3,5
Denmark,Norway,1931,3,1,4
Latvia,Estonia,1931,0,1,1
Portugal,Belgium,1931,3,2,5
Estonia,Lithuania,1931,4,1,5
Czechoslovakia,Switzerland,1931,7,3,10
Denmark,Netherlands,1931,0,2,2
Poland,Czechoslovakia,1931,0,4,4
Austria,Switzerland,1931,2,0,2
Finland,Estonia,1931,3,1,4
Sweden,Germany,1931,0,0,0
Norway,Germany,1931,2,2,4
Sweden,Denmark,1931,3,1,4
Yugoslavia,Romania,1931,2,4,6
Latvia,Lithuania,1931,5,2,7
Sweden,Finland,1931,8,2,10
Argentina,Paraguay,1931,1,1,2
Sweden,Estonia,1931,3,1,4
Argentina,Paraguay,1931,3,1,4
Sweden,Latvia,1931,6,0,6
Yugoslavia,Czechoslovakia,1931,2,1,3
Finland,Latvia,1931,4,0,4
Poland,Romania,1931,2,3,5
Lithuania,Romania,1931,2,4,6
Estonia,Lithuania,1931,2,0,2
Latvia,Lithuania,1931,1,0,1
Estonia,Latvia,1931,3,1,4
Brazil,Uruguay,1931,2,0,2
Finland,Norway,1931,4,4,8
Austria,Germany,1931,5,0,5
Scotland,Northern Ireland,1931,3,1,4
Hungary,Czechoslovakia,1931,3,0,3
Bulgaria,Turkey,1931,5,1,6
Germany,Denmark,1931,4,2,6
Latvia,Estonia,1931,2,1,3
Norway,Sweden,1931,2,1,3
Turkey,Yugoslavia,1931,2,0,2
Bulgaria,Yugoslavia,1931,3,2,5
Hungary,Austria,1931,2,2,4
Belgium,Poland,1931,2,1,3
Denmark,Finland,1931,2,3,5
Kenya,Uganda,1931,2,1,3
Northern Ireland,England,1931,2,6,8
Bulgaria,Greece,1931,2,1,3
Poland,Yugoslavia,1931,6,3,9
Wales,Scotland,1931,2,3,5
Hungary,Sweden,1931,3,1,4
Italy,Czechoslovakia,1931,2,2,4
England,Wales,1931,3,1,4
France,Netherlands,1931,3,4,7
Greece,Romania,1931,2,4,6
Switzerland,Austria,1931,1,8,9
Northern Ireland,Wales,1931,4,0,4
Belgium,Switzerland,1931,2,1,3
England,Spain,1931,7,1,8
Republic of Ireland,Spain,1931,0,5,5
Italy,Hungary,1931,3,2,5
Italy,Switzerland,1932,3,0,3
Egypt,Hungary,1932,0,0,0
Germany,Switzerland,1932,2,0,2
Haiti,Jamaica,1932,4,1,5
Austria,Italy,1932,2,1,3
Belgium,Netherlands,1932,1,4,5
Czechoslovakia,Hungary,1932,1,3,4
Haiti,Jamaica,1932,0,1,1
Switzerland,France,1932,3,3,6
Dominica,Martinique,1932,1,0,1
Greece,Bulgaria,1932,1,2,3
Greece,Bulgaria,1932,2,2,4
England,Scotland,1932,3,0,3
France,Italy,1932,1,2,3
Guyana,Trinidad and Tobago,1932,1,0,1
Barbados,Trinidad and Tobago,1932,1,0,1
Netherlands,Belgium,1932,2,1,3
Switzerland,Czechoslovakia,1932,5,1,6
Barbados,Guyana,1932,0,1,1
Barbados,Guyana,1932,2,2,4
Guyana,Trinidad and Tobago,1932,1,2,3
Austria,Hungary,1932,8,2,10
Spain,Yugoslavia,1932,2,1,3
Barbados,Trinidad and Tobago,1932,1,3,4
Belgium,France,1932,5,2,7
Portugal,Yugoslavia,1932,3,2,5
France,Scotland,1932,1,3,4
Hungary,Italy,1932,1,1,2
Netherlands,Republic of Ireland,1932,0,2,2
Argentina,Uruguay,1932,2,0,2
Sweden,Finland,1932,7,1,8
Uruguay,Argentina,1932,1,0,1
Czechoslovakia,Austria,1932,1,1,2
Netherlands,Czechoslovakia,1932,1,2,3
Yugoslavia,Poland,1932,0,3,3
Estonia,Latvia,1932,3,0,3
Denmark,Belgium,1932,3,4,7
Norway,Estonia,1932,3,0,3
Yugoslavia,France,1932,2,1,3
Bulgaria,France,1932,3,5,8
Finland,Sweden,1932,1,3,4
Romania,France,1932,6,3,9
Sweden,Belgium,1932,3,1,4
Norway,Finland,1932,2,1,3
Denmark,Sweden,1932,3,1,4
Switzerland,Hungary,1932,3,1,4
Bulgaria,Romania,1932,2,0,2
Yugoslavia,Greece,1932,7,1,8
Greece,Romania,1932,0,3,3
Lithuania,Latvia,1932,2,3,5
Yugoslavia,Bulgaria,1932,2,3,5
Finland,Germany,1932,1,4,5
Sweden,Norway,1932,1,4,5
Bulgaria,Greece,1932,2,0,2
Yugoslavia,Romania,1932,3,1,4
Poland,Sweden,1932,2,0,2
Latvia,Sweden,1932,0,0,0
Estonia,Sweden,1932,1,3,4
Sweden,Austria,1932,3,4,7
Latvia,Lithuania,1932,2,1,3
Lithuania,Estonia,1932,1,0,1
Estonia,Finland,1932,0,3,3
Uganda,Kenya,1932,13,1,14
Latvia,Lithuania,1932,4,1,5
Estonia,Lithuania,1932,1,2,3
Finland,Denmark,1932,4,2,6
Latvia,Estonia,1932,1,0,1
Lithuania,Latvia,1932,1,0,1
Northern Ireland,Scotland,1932,0,4,4
Hungary,Czechoslovakia,1932,2,1,3
Germany,Sweden,1932,4,3,7
Norway,Denmark,1932,1,2,3
Sweden,Lithuania,1932,8,1,9
Hungary,Austria,1932,2,3,5
Poland,Latvia,1932,2,1,3
Romania,Poland,1932,0,5,5
Czechoslovakia,Yugoslavia,1932,2,1,3
England,Northern Ireland,1932,1,0,1
Austria,Switzerland,1932,3,1,4
Scotland,Wales,1932,2,5,7
Czechoslovakia,Italy,1932,2,1,3
Hungary,Germany,1932,2,1,3
Turkey,Bulgaria,1932,2,3,5
Switzerland,Sweden,1932,2,1,3
Wales,England,1932,0,0,0
Italy,Hungary,1932,4,2,6
Germany,Netherlands,1932,0,2,2
Uruguay,Brazil,1932,1,2,3
England,Austria,1932,4,3,7
Wales,Northern Ireland,1932,4,1,5
Belgium,Austria,1932,1,6,7
Italy,Germany,1933,3,1,4
Uruguay,Argentina,1933,2,1,3
Netherlands,Switzerland,1933,0,2,2
Portugal,Hungary,1933,1,0,1
Argentina,Uruguay,1933,4,1,5
Belgium,Italy,1933,2,3,5
France,Austria,1933,0,4,4
Netherlands,Hungary,1933,1,2,3
Switzerland,Belgium,1933,3,3,6
Germany,France,1933,3,3,6
Hungary,Czechoslovakia,1933,2,0,2
France,Belgium,1933,3,0,3
Scotland,England,1933,2,1,3
Spain,Portugal,1933,3,0,3
Switzerland,Italy,1933,0,3,3
Austria,Czechoslovakia,1933,1,2,3
Belgium,Netherlands,1933,1,3,4
France,Spain,1933,1,0,1
Hungary,Austria,1933,1,1,2
Yugoslavia,Spain,1933,1,1,2
Italy,Czechoslovakia,1933,2,0,2
Netherlands,Belgium,1933,1,2,3
Switzerland,Yugoslavia,1933,4,1,5
Italy,England,1933,1,1,2
Switzerland,England,1933,0,4,4
Spain,Bulgaria,1933,13,0,13
France,Wales,1933,1,1,2
Latvia,Estonia,1933,2,0,2
Greece,Yugoslavia,1933,3,5,8
Poland,Belgium,1933,0,1,1
Romania,Bulgaria,1933,7,0,7
Australia,New Zealand,1933,4,2,6
Bulgaria,Yugoslavia,1933,0,4,4
Bulgaria,Greece,1933,2,0,2
Czechoslovakia,France,1933,4,0,4
Austria,Belgium,1933,4,1,5
Denmark,Norway,1933,2,2,4
Romania,Yugoslavia,1933,5,0,5
Sweden,Estonia,1933,6,2,8
Latvia,Lithuania,1933,6,2,8
Australia,New Zealand,1933,6,4,10
Sweden,Denmark,1933,2,3,5
Australia,New Zealand,1933,4,2,6
Lithuania,Sweden,1933,0,2,2
Sweden,Hungary,1933,5,2,7
Latvia,Sweden,1933,1,1,2
Sweden,Finland,1933,2,0,2
Estonia,Lithuania,1933,2,1,3
Yugoslavia,Czechoslovakia,1933,2,1,3
Estonia,Latvia,1933,2,1,3
Finland,Lithuania,1933,9,2,11
Finland,Estonia,1933,2,1,3
Lithuania,Estonia,1933,1,1,2
Estonia,Latvia,1933,0,1,1
Finland,Norway,1933,1,5,6
Lithuania,Latvia,1933,2,2,4
Lithuania,Estonia,1933,0,5,5
Poland,Yugoslavia,1933,4,3,7
Scotland,Northern Ireland,1933,1,2,3
Czechoslovakia,Austria,1933,3,3,6
Hungary,Switzerland,1933,3,0,3
Norway,Sweden,1933,0,1,1
Yugoslavia,Switzerland,1933,2,2,4
Austria,Hungary,1933,2,2,4
Wales,Scotland,1933,3,2,5
Silesia,Poland,1933,1,2,3
Aruba,Curaçao,1933,1,3,4
Denmark,Finland,1933,2,0,2
Aruba,Curaçao,1933,0,2,2
Northern Ireland,England,1933,0,3,3
Poland,Czechoslovakia,1933,1,2,3
Germany,Belgium,1933,8,1,9
Hungary,Italy,1933,0,1,1
Trinidad and Tobago,Barbados,1933,8,4,12
Trinidad and Tobago,Guyana,1933,2,0,2
Barbados,Guyana,1933,0,2,2
Trinidad and Tobago,Guyana,1933,1,1,2
Switzerland,Romania,1933,2,2,4
Trinidad and Tobago,Barbados,1933,3,1,4
Trinidad and Tobago,Guyana,1933,1,0,1
Barbados,Guyana,1933,2,5,7
Northern Ireland,Wales,1933,1,1,2
Germany,Norway,1933,2,2,4
Trinidad and Tobago,Barbados,1933,6,0,6
England,Wales,1933,1,2,3
Switzerland,Germany,1933,0,2,2
Belgium,Denmark,1933,2,2,4
Scotland,Austria,1933,2,2,4
Germany,Poland,1933,1,0,1
Italy,Switzerland,1933,5,2,7
England,France,1933,4,1,5
Netherlands,Austria,1933,0,1,1
Uruguay,Argentina,1933,0,1,1
Germany,Hungary,1934,3,1,4
Belgium,France,1934,2,3,5
Haiti,Cuba,1934,1,3,4
Haiti,Cuba,1934,1,1,2
Catalonia,Spain,1934,0,2,2
Haiti,Cuba,1934,0,6,6
Italy,Austria,1934,2,4,6
Republic of Ireland,Belgium,1934,4,4,8
Mexico,Cuba,1934,3,2,5
France,Switzerland,1934,0,1,1
Luxembourg,Germany,1934,1,9,10
Mexico,Cuba,1934,5,0,5
Netherlands,Belgium,1934,9,3,12
Spain,Portugal,1934,9,0,9
Guadeloupe,Martinique,1934,0,6,6
Egypt,Israel,1934,7,1,8
Bulgaria,Yugoslavia,1934,1,2,3
Mexico,Cuba,1934,4,1,5
Portugal,Spain,1934,1,2,3
Bulgaria,Hungary,1934,1,4,5
France,Czechoslovakia,1934,1,2,3
Italy,Greece,1934,4,0,4
Switzerland,Austria,1934,2,3,5
Yugoslavia,Bulgaria,1934,2,3,5
Israel,Egypt,1934,1,4,5
Netherlands,Republic of Ireland,1934,5,2,7
England,Scotland,1934,3,0,3
Austria,Hungary,1934,5,2,7
Luxembourg,France,1934,1,6,7
Austria,Bulgaria,1934,6,1,7
Hungary,Bulgaria,1934,4,1,5
Belgium,Netherlands,1934,2,4,6
Czechoslovakia,Hungary,1934,2,2,4
Romania,Yugoslavia,1934,2,1,3
Hungary,England,1934,2,1,3
Netherlands,France,1934,4,5,9
Philippines,China PR,1934,0,2,2
Japan,Indonesia,1934,1,7,8
China PR,Indonesia,1934,2,0,2
Czechoslovakia,England,1934,2,1,3
Philippines,Indonesia,1934,3,2,5
China PR,Japan,1934,4,3,7
Denmark,Poland,1934,4,2,6
Sweden,Poland,1934,4,2,6
Mexico,United States,1934,2,4,6
Argentina,Sweden,1934,2,3,5
Austria,France,1934,3,2,5
Belgium,Germany,1934,2,5,7
Brazil,Spain,1934,1,3,4
Czechoslovakia,Romania,1934,2,1,3
Egypt,Hungary,1934,2,4,6
Italy,United States,1934,7,1,8
Netherlands,Switzerland,1934,2,3,5
Austria,Hungary,1934,2,1,3
Czechoslovakia,Switzerland,1934,3,2,5
Germany,Sweden,1934,2,1,3
Italy,Spain,1934,1,1,2
Italy,Spain,1934,1,0,1
Czechoslovakia,Germany,1934,3,1,4
Italy,Austria,1934,1,0,1
Yugoslavia,Brazil,1934,8,4,12
Austria,Germany,1934,2,3,5
Italy,Czechoslovakia,1934,2,1,3
Lithuania,Latvia,1934,2,0,2
Denmark,Sweden,1934,3,5,8
Catalonia,Brazil,1934,2,1,3
Catalonia,Brazil,1934,2,2,4
Lithuania,Estonia,1934,1,1,2
Sweden,Norway,1934,3,3,6
Finland,Denmark,1934,2,1,3
Uruguay,Argentina,1934,2,2,4
Curaçao,Suriname,1934,3,1,4
Curaçao,Suriname,1934,3,2,5
Curaçao,Suriname,1934,2,2,4
Aruba,Suriname,1934,1,1,2
Suriname,Trinidad and Tobago,1934,3,3,6
Estonia,Finland,1934,1,1,2
Estonia,Hungary,1934,2,2,4
Latvia,Finland,1934,1,1,2
Argentina,Uruguay,1934,1,0,1
Lithuania,Finland,1934,1,0,1
Yugoslavia,Poland,1934,4,1,5
Czechoslovakia,Yugoslavia,1934,3,1,4
Norway,Finland,1934,4,2,6
Latvia,Lithuania,1934,1,3,4
Poland,Germany,1934,2,5,7
Austria,Czechoslovakia,1934,2,2,4
Finland,Sweden,1934,5,4,9
Norway,Denmark,1934,3,1,4
Sweden,Latvia,1934,3,1,4
Wales,England,1934,0,4,4
Denmark,Germany,1934,2,5,7
Hungary,Austria,1934,3,1,4
Latvia,Poland,1934,2,6,8
Poland,Romania,1934,3,3,6
Switzerland,Czechoslovakia,1934,2,2,4
Northern Ireland,Scotland,1934,2,1,3
Switzerland,Netherlands,1934,2,4,6
Austria,Switzerland,1934,3,0,3
England,Italy,1934,3,2,5
Scotland,Wales,1934,3,2,5
Italy,Hungary,1934,4,2,6
Republic of Ireland,Hungary,1934,2,4,6
France,Yugoslavia,1934,3,2,5
Greece,Yugoslavia,1934,2,1,3
Bulgaria,Yugoslavia,1934,3,4,7
Greece,Romania,1934,2,2,4
Bulgaria,Romania,1934,2,3,5
Greece,Bulgaria,1935,1,2,3
Romania,Yugoslavia,1935,0,4,4
Argentina,Chile,1935,4,1,5
Peru,Uruguay,1935,0,1,1
Chile,Uruguay,1935,1,2,3
Peru,Argentina,1935,1,4,5
Spain,France,1935,2,0,2
Peru,Chile,1935,1,0,1
Argentina,Uruguay,1935,0,3,3
Germany,Switzerland,1935,4,0,4
England,Northern Ireland,1935,2,1,3
Italy,France,1935,2,1,3
Netherlands,Germany,1935,2,3,5
Uganda,Kenya,1935,5,1,6
Czechoslovakia,Switzerland,1935,3,1,4
France,Germany,1935,1,3,4
Curaçao,Aruba,1935,2,0,2
Austria,Italy,1935,0,2,2
Curaçao,Aruba,1935,4,0,4
Wales,Northern Ireland,1935,3,1,4
Netherlands,Belgium,1935,4,2,6
Scotland,England,1935,2,0,2
Belgium,France,1935,1,1,2
Czechoslovakia,Austria,1935,0,0,0
Switzerland,Hungary,1935,6,2,8
Belgium,Germany,1935,1,6,7
Portugal,Spain,1935,3,3,6
Switzerland,Republic of Ireland,1935,1,0,1
Germany,Republic of Ireland,1935,3,1,4
Kenya,Uganda,1935,1,3,4
Austria,Poland,1935,5,2,7
Belgium,Netherlands,1935,0,2,2
Germany,Spain,1935,1,2,3
Hungary,Austria,1935,6,3,9
Netherlands,England,1935,0,1,1
France,Hungary,1935,2,0,2
United States,Scotland,1935,1,5,6
Suriname,Curaçao,1935,0,1,1
Suriname,Curaçao,1935,4,1,5
Suriname,Curaçao,1935,2,1,3
Germany,Czechoslovakia,1935,2,1,3
Belgium,Switzerland,1935,2,2,4
Latvia,Lithuania,1935,6,1,7
United States,Scotland,1935,1,4,5
Latvia,Estonia,1935,1,1,2
Sweden,Finland,1935,2,2,4
Bulgaria,Greece,1935,5,2,7
Sweden,Denmark,1935,3,1,4
Romania,Yugoslavia,1935,0,2,2
Bulgaria,Romania,1935,4,0,4
Estonia,Lithuania,1935,2,2,4
Greece,Yugoslavia,1935,1,6,7
Denmark,Norway,1935,1,0,1
Bulgaria,Yugoslavia,1935,3,3,6
Greece,Romania,1935,2,2,4
Norway,Germany,1935,1,1,2
Sweden,Germany,1935,3,1,4
Latvia,Sweden,1935,0,3,3
Estonia,Sweden,1935,1,2,3
Uruguay,Argentina,1935,1,1,2
Suriname,Trinidad and Tobago,1935,0,3,3
Estonia,Finland,1935,2,2,4
Argentina,Uruguay,1935,3,0,3
Germany,Finland,1935,6,0,6
Luxembourg,Germany,1935,0,1,1
Poland,Yugoslavia,1935,2,3,5
Estonia,Lithuania,1935,1,2,3
Latvia,Lithuania,1935,2,2,4
Estonia,Latvia,1935,1,1,2
Germany,Romania,1935,4,2,6
Sweden,Romania,1935,7,1,8
Yugoslavia,Czechoslovakia,1935,0,0,0
Finland,Norway,1935,1,5,6
Lithuania,Latvia,1935,2,2,4
Germany,Estonia,1935,5,0,5
Germany,Poland,1935,1,0,1
Poland,Latvia,1935,3,3,6
Lithuania,Estonia,1935,2,2,4
Curaçao,Aruba,1935,1,0,1
Hungary,Czechoslovakia,1935,1,0,1
Norway,Sweden,1935,0,2,2
Wales,Scotland,1935,1,1,2
Austria,Hungary,1935,4,4,8
Denmark,Finland,1935,5,1,6
Poland,Austria,1935,1,0,1
Germany,Latvia,1935,3,0,3
Northern Ireland,England,1935,1,3,4
Germany,Bulgaria,1935,4,2,6
Czechoslovakia,Italy,1935,2,1,3
Switzerland,France,1935,2,1,3
Netherlands,Denmark,1935,3,0,3
Romania,Poland,1935,4,1,5
Switzerland,Norway,1935,2,0,2
France,Sweden,1935,2,0,2
Hungary,Switzerland,1935,6,1,7
Scotland,Northern Ireland,1935,2,1,3
Belgium,Sweden,1935,5,1,6
Italy,Hungary,1935,2,2,4
England,Germany,1935,3,0,3
Republic of Ireland,Netherlands,1935,3,5,8
Curaçao,Trinidad and Tobago,1935,3,1,4
Jamaica,Trinidad and Tobago,1935,2,3,5
French Guiana,Suriname,1936,1,3,4
Jamaica,Trinidad and Tobago,1936,0,1,1
Jamaica,Trinidad and Tobago,1936,1,2,3
France,Netherlands,1936,1,6,7
Spain,Austria,1936,4,5,9
Portugal,Austria,1936,2,3,5
Curaçao,Trinidad and Tobago,1936,4,2,6
England,Wales,1936,1,2,3
France,Czechoslovakia,1936,0,3,3
Belgium,Poland,1936,0,2,2
Trinidad and Tobago,Curaçao,1936,3,0,3
Spain,Germany,1936,1,2,3
Portugal,Germany,1936,1,3,4
France,Belgium,1936,3,0,3
Northern Ireland,Wales,1936,3,2,5
Hungary,Germany,1936,3,2,5
Republic of Ireland,Switzerland,1936,1,0,1
Austria,Czechoslovakia,1936,1,1,2
Netherlands,Belgium,1936,8,0,8
England,Scotland,1936,1,1,2
Austria,Hungary,1936,3,5,8
Switzerland,Italy,1936,1,2,3
Belgium,Netherlands,1936,1,1,2
Hungary,Republic of Ireland,1936,3,3,6
Switzerland,Spain,1936,0,2,2
Austria,England,1936,2,1,3
Belgium,England,1936,3,2,5
Luxembourg,Republic of Ireland,1936,1,5,6
Romania,Yugoslavia,1936,3,2,5
Italy,Austria,1936,2,2,4
Romania,Greece,1936,5,2,7
Bulgaria,Greece,1936,5,4,9
Romania,Bulgaria,1936,4,1,5
Switzerland,Belgium,1936,1,1,2
Estonia,Latvia,1936,3,4,7
Hungary,Italy,1936,1,2,3
Denmark,Sweden,1936,4,3,7
Lithuania,Latvia,1936,1,5,6
Norway,Switzerland,1936,1,2,3
Egypt,Greece,1936,3,1,4
Sweden,Switzerland,1936,5,2,7
Finland,Denmark,1936,1,4,5
Lithuania,Estonia,1936,2,0,2
New Zealand,Australia,1936,1,7,8
Sweden,Norway,1936,2,0,2
New Zealand,Australia,1936,0,10,10
Turkey,Yugoslavia,1936,3,3,6
New Zealand,Australia,1936,1,4,5
Sweden,Norway,1936,3,4,7
Argentina,Uruguay,1936,1,0,1
Estonia,Finland,1936,2,2,4
Latvia,Lithuania,1936,2,1,3
Estonia,Lithuania,1936,2,1,3
Latvia,Estonia,1936,2,1,3
Latvia,Poland,1936,3,3,6
Norway,Finland,1936,0,2,2
Yugoslavia,Poland,1936,9,3,12
Poland,Germany,1936,1,1,2
Norway,Denmark,1936,3,3,6
Uruguay,Argentina,1936,2,1,3
Czechoslovakia,Germany,1936,1,2,3
Finland,Sweden,1936,1,2,3
Germany,Luxembourg,1936,7,2,9
Hungary,Austria,1936,5,3,8
Denmark,Poland,1936,2,1,3
Romania,Hungary,1936,1,2,3
Scotland,Germany,1936,2,0,2
Republic of Ireland,Germany,1936,5,2,7
Wales,England,1936,2,1,3
Czechoslovakia,Hungary,1936,5,2,7
Italy,Switzerland,1936,4,2,6
Northern Ireland,Scotland,1936,1,3,4
Netherlands,Norway,1936,3,3,6
Switzerland,Austria,1936,1,3,4
Germany,Italy,1936,2,2,4
England,Northern Ireland,1936,3,1,4
England,Hungary,1936,6,2,8
Scotland,Wales,1936,1,2,3
Republic of Ireland,Hungary,1936,2,3,5
France,Yugoslavia,1936,1,0,1
Italy,Czechoslovakia,1936,2,0,2
Brazil,Peru,1936,3,2,5
Argentina,Chile,1936,2,1,3
Paraguay,Uruguay,1937,4,2,6
Brazil,Chile,1937,6,4,10
Suriname,Guyana,1937,8,0,8
Guyana,Trinidad and Tobago,1937,0,3,3
Peru,Uruguay,1937,2,4,6
Suriname,Trinidad and Tobago,1937,1,1,2
Suriname,Trinidad and Tobago,1937,3,3,6
Argentina,Paraguay,1937,6,1,7
Chile,Uruguay,1937,3,0,3
Suriname,Trinidad and Tobago,1937,2,2,4
Guyana,Trinidad and Tobago,1937,2,3,5
Brazil,Paraguay,1937,5,0,5
Argentina,Peru,1937,1,0,1
Chile,Paraguay,1937,2,3,5
Brazil,Uruguay,1937,3,2,5
Chile,Peru,1937,2,2,4
Argentina,Uruguay,1937,2,3,5
France,Austria,1937,1,2,3
Paraguay,Peru,1937,0,1,1
Argentina,Brazil,1937,1,0,1
Germany,Netherlands,1937,2,2,4
Argentina,Brazil,1937,2,0,2
Belgium,France,1937,3,1,4
Czechoslovakia,Switzerland,1937,5,3,8
Netherlands,Switzerland,1937,2,1,3
Wales,Northern Ireland,1937,4,1,5
Germany,France,1937,4,0,4
Luxembourg,Germany,1937,2,3,5
Belgium,Netherlands,1937,2,1,3
Switzerland,Hungary,1937,1,5,6
Scotland,England,1937,3,1,4
Belgium,Switzerland,1937,1,2,3
Romania,Czechoslovakia,1937,1,1,2
Germany,Belgium,1937,1,0,1
Italy,Hungary,1937,2,0,2
Aruba,Curaçao,1937,1,1,2
Aruba,Curaçao,1937,1,1,2
Netherlands,Belgium,1937,1,0,1
Switzerland,Germany,1937,0,1,1
Czechoslovakia,Basque Country,1937,3,2,5
Austria,Scotland,1937,1,1,2
Hungary,Yugoslavia,1937,1,1,2
Norway,England,1937,0,6,6
Germany,Denmark,1937,8,0,8
Sweden,England,1937,0,4,4
Switzerland,Republic of Ireland,1937,0,1,1
Uganda,Kenya,1937,9,5,14
Finland,England,1937,0,8,8
Czechoslovakia,Italy,1937,0,1,1
France,Republic of Ireland,1937,0,2,2
Hungary,Austria,1937,2,2,4
Norway,Italy,1937,1,3,4
Lithuania,Estonia,1937,1,2,3
Czechoslovakia,Basque Country,1937,2,1,3
Yugoslavia,Belgium,1937,1,1,2
Silesia,Basque Country,1937,3,4,7
Romania,Belgium,1937,2,1,3
Denmark,Norway,1937,5,1,6
Sweden,Finland,1937,4,0,4
Sweden,Estonia,1937,7,2,9
Poland,Sweden,1937,3,1,4
Latvia,Germany,1937,1,3,4
Romania,Sweden,1937,2,2,4
Finland,Germany,1937,0,2,2
Poland,Romania,1937,2,4,6
Estonia,Romania,1937,2,1,3
Latvia,Lithuania,1937,4,2,6
Yugoslavia,Turkey,1937,3,1,4
Finland,Estonia,1937,0,1,1
Norway,Basque Country,1937,1,3,4
Germany,Estonia,1937,4,1,5
Denmark,Basque Country,1937,1,11,12
Lithuania,Latvia,1937,1,5,6
Estonia,Latvia,1937,1,1,2
Finland,Norway,1937,0,2,2
Lithuania,Estonia,1937,0,4,4
Estonia,Latvia,1937,0,2,2
Bulgaria,Poland,1937,3,3,6
Mexico,United States,1937,7,2,9
Poland,Denmark,1937,3,1,4
Austria,Switzerland,1937,4,3,7
Hungary,Czechoslovakia,1937,8,3,11
Latvia,Estonia,1937,3,1,4
Mexico,United States,1937,7,3,10
Norway,Sweden,1937,3,2,5
Czechoslovakia,Yugoslavia,1937,5,4,9
Sweden,Denmark,1937,1,2,3
Austria,Latvia,1937,2,1,3
Austria,Hungary,1937,1,2,3
France,Switzerland,1937,2,1,3
Norway,Republic of Ireland,1937,3,2,5
Poland,Yugoslavia,1937,4,0,4
Poland,Latvia,1937,2,1,3
Uruguay,Argentina,1937,0,3,3
El Salvador,Honduras,1937,3,2,5
Czechoslovakia,Latvia,1937,4,0,4
Denmark,Finland,1937,2,1,3
Northern Ireland,England,1937,1,5,6
Czechoslovakia,Austria,1937,2,1,3
Germany,Norway,1937,3,0,3
Wales,Scotland,1937,2,1,3
Netherlands,France,1937,2,3,5
Switzerland,Italy,1937,2,2,4
Bulgaria,Czechoslovakia,1937,1,1,2
Republic of Ireland,Norway,1937,3,3,6
Scotland,Northern Ireland,1937,1,1,2
Argentina,Uruguay,1937,5,1,6
Hungary,Switzerland,1937,2,0,2
England,Wales,1937,2,1,3
Germany,Sweden,1937,5,0,5
Netherlands,Luxembourg,1937,4,0,4
Spain,Portugal,1937,1,2,3
Mexico,Basque Country,1937,1,4,5
England,Czechoslovakia,1937,5,4,9
France,Italy,1937,0,0,0
Mexico,Basque Country,1937,1,2,3
Scotland,Czechoslovakia,1937,5,0,5
Mexico,Basque Country,1937,0,4,4
Dominica,Saint Lucia,1938,4,1,5
Portugal,Hungary,1938,4,0,4
Mexico,Basque Country,1938,3,1,4
Dominica,Saint Lucia,1938,1,3,4
Dominica,Saint Lucia,1938,1,0,1
Luxembourg,Hungary,1938,0,6,6
Israel,Greece,1938,1,3,4
France,Belgium,1938,5,3,8
Portugal,Spain,1938,1,0,1
Germany,Switzerland,1938,1,1,2
Greece,Israel,1938,1,0,1
Netherlands,Belgium,1938,7,2,9
Haiti,Jamaica,1938,5,2,7
Luxembourg,Belgium,1938,2,3,5
Switzerland,Poland,1938,3,3,6
Northern Ireland,Wales,1938,1,0,1
Haiti,Jamaica,1938,2,0,2
Germany,Luxembourg,1938,2,1,3
Germany,Hungary,1938,1,1,2
Haiti,Jamaica,1938,2,0,2
France,Bulgaria,1938,6,1,7
Hungary,Greece,1938,11,1,12
Guyana,Trinidad and Tobago,1938,1,1,2
Guyana,Trinidad and Tobago,1938,0,3,3
Belgium,Netherlands,1938,1,1,2
Switzerland,Czechoslovakia,1938,4,0,4
Yugoslavia,Poland,1938,1,0,1
Guyana,Trinidad and Tobago,1938,0,2,2
England,Scotland,1938,0,1,1
Czechoslovakia,Bulgaria,1938,6,0,6
Germany,Portugal,1938,1,1,2
Switzerland,Portugal,1938,2,1,3
Romania,Yugoslavia,1938,0,1,1
Switzerland,Belgium,1938,0,3,3
Germany,England,1938,3,6,9
Italy,Belgium,1938,6,1,7
Latvia,Lithuania,1938,2,0,2
Czechoslovakia,Republic of Ireland,1938,2,2,4
Netherlands,Scotland,1938,1,3,4
Switzerland,England,1938,2,1,3
Italy,Yugoslavia,1938,4,0,4
Poland,Republic of Ireland,1938,6,0,6
France,England,1938,2,4,6
Belgium,Yugoslavia,1938,2,2,4
Cuba,Basque Country,1938,0,4,4
Norway,Estonia,1938,1,0,1
Germany,Switzerland,1938,1,1,2
Brazil,Poland,1938,6,5,11
Cuba,Romania,1938,3,3,6
Czechoslovakia,Netherlands,1938,3,0,3
France,Belgium,1938,3,1,4
Hungary,Indonesia,1938,6,0,6
Italy,Norway,1938,2,1,3
Cuba,Romania,1938,2,1,3
Germany,Switzerland,1938,2,4,6
Sweden,Latvia,1938,3,3,6
Lithuania,Estonia,1938,0,2,2
Brazil,Czechoslovakia,1938,1,1,2
Cuba,Sweden,1938,0,8,8
France,Italy,1938,1,3,4
Hungary,Switzerland,1938,2,0,2
Brazil,Czechoslovakia,1938,2,1,3
Sweden,Finland,1938,2,0,2
Brazil,Italy,1938,1,2,3
Hungary,Sweden,1938,5,1,6
Norway,Finland,1938,9,0,9
Argentina,Uruguay,1938,1,0,1
Brazil,Sweden,1938,4,2,6
Hungary,Italy,1938,2,4,6
Cuba,Basque Country,1938,3,4,7
Denmark,Sweden,1938,0,1,1
Estonia,Hungary,1938,2,3,5
Netherlands,Indonesia,1938,9,2,11
Finland,Sweden,1938,2,4,6
Curaçao,Suriname,1938,2,1,3
Curaçao,Suriname,1938,1,0,1
Aruba,Suriname,1938,5,0,5
Curaçao,Suriname,1938,4,1,5
Trinidad and Tobago,Suriname,1938,1,2,3
Suriname,Trinidad and Tobago,1938,3,0,3
Estonia,Latvia,1938,0,2,2
Suriname,Trinidad and Tobago,1938,0,1,1
Sweden,Czechoslovakia,1938,2,6,8
Bolivia,Ecuador,1938,1,1,2
Colombia,Peru,1938,2,4,6
Colombia,Ecuador,1938,1,2,3
Bolivia,Venezuela,1938,3,1,4
Ecuador,Peru,1938,1,9,10
Colombia,Venezuela,1938,2,0,2
Colombia,Bolivia,1938,1,2,3
Estonia,Finland,1938,1,3,4
Peru,Venezuela,1938,2,1,3
Saint Kitts and Nevis,Grenada,1938,0,4,4
Saint Kitts and Nevis,Grenada,1938,2,4,6
Ecuador,Venezuela,1938,5,2,7
Bolivia,Ecuador,1938,2,1,3
Yugoslavia,Czechoslovakia,1938,1,3,4
Finland,Denmark,1938,2,1,3
Australia,India,1938,5,3,8
Estonia,Lithuania,1938,3,1,4
Latvia,Lithuania,1938,1,1,2
Norway,Sweden,1938,2,1,3
Estonia,Latvia,1938,1,1,2
Yugoslavia,Romania,1938,1,1,2
Australia,India,1938,4,4,8
Australia,India,1938,1,4,5
Finland,Lithuania,1938,3,1,4
Germany,Poland,1938,4,1,5
Republic of Ireland,Switzerland,1938,4,0,4
Norway,Denmark,1938,1,1,2
Australia,India,1938,5,4,9
Latvia,Poland,1938,2,1,3
Poland,Yugoslavia,1938,4,4,8
Romania,Germany,1938,1,4,5
Australia,India,1938,3,1,4
Sweden,Norway,1938,2,3,5
Northern Ireland,Scotland,1938,0,2,2
Kenya,Uganda,1938,1,3,4
Uruguay,Argentina,1938,2,3,5
Mexico,Basque Country,1938,8,4,12
Wales,England,1938,4,2,6
Denmark,Netherlands,1938,2,2,4
Poland,Norway,1938,2,2,4
Mexico,Basque Country,1938,2,6,8
Mexico,Basque Country,1938,1,3,4
Switzerland,Portugal,1938,1,0,1
England,Norway,1938,4,0,4
Scotland,Wales,1938,3,2,5
Republic of Ireland,Poland,1938,3,2,5
England,Northern Ireland,1938,7,0,7
Italy,Switzerland,1938,2,0,2
Czechoslovakia,Romania,1938,6,2,8
Italy,France,1938,1,0,1
Scotland,Hungary,1938,3,1,4
Dominica,Martinique,1939,3,1,4
Brazil,Argentina,1939,1,5,6
Chile,Paraguay,1939,1,5,6
Peru,Ecuador,1939,5,2,7
Brazil,Argentina,1939,3,2,5
Ecuador,Uruguay,1939,0,6,6
France,Poland,1939,4,0,4
Peru,Chile,1939,3,1,4
Belgium,Germany,1939,1,4,5
Chile,Uruguay,1939,2,3,5
Peru,Paraguay,1939,3,0,3
Chile,Ecuador,1939,4,1,5
Paraguay,Uruguay,1939,1,3,4
Ecuador,Paraguay,1939,1,3,4
Peru,Uruguay,1939,2,1,3
Portugal,Switzerland,1939,2,4,6
Chile,Paraguay,1939,4,1,5
Germany,Yugoslavia,1939,3,2,5
Netherlands,Hungary,1939,3,2,5
Haiti,Panama,1939,1,0,1
Wales,Northern Ireland,1939,3,1,4
France,Hungary,1939,2,2,4
Belgium,Netherlands,1939,5,4,9
Haiti,Panama,1939,1,1,2
Republic of Ireland,Hungary,1939,2,2,4
Haiti,Panama,1939,3,0,3
Italy,Germany,1939,3,2,5
Luxembourg,Germany,1939,2,1,3
Switzerland,Hungary,1939,3,1,4
Scotland,England,1939,1,2,3
Netherlands,Belgium,1939,3,2,5
Brittany,Luxembourg,1939,3,1,4
Romania,Yugoslavia,1939,1,0,1
Switzerland,Netherlands,1939,2,1,3
Italy,England,1939,2,2,4
Belgium,Switzerland,1939,1,2,3
Belgium,France,1939,1,3,4
Hungary,Republic of Ireland,1939,2,2,4
Romania,Latvia,1939,4,0,4
Yugoslavia,England,1939,2,1,3
France,Wales,1939,2,1,3
Germany,Republic of Ireland,1939,1,1,2
Bulgaria,Latvia,1939,3,0,3
Romania,England,1939,0,2,2
Poland,Belgium,1939,3,3,6
Sweden,Norway,1939,3,2,5
Poland,Switzerland,1939,1,1,2
Yugoslavia,Italy,1939,1,2,3
Hungary,Italy,1939,1,3,4
Sweden,Finland,1939,5,1,6
Romania,Italy,1939,0,1,1
Sweden,Lithuania,1939,7,0,7
Norway,Sweden,1939,1,0,1
Denmark,Finland,1939,5,0,5
Denmark,Norway,1939,6,3,9
Norway,Germany,1939,0,4,4
Denmark,Germany,1939,0,2,2
Estonia,Germany,1939,0,2,2
Finland,Italy,1939,2,3,5
Latvia,Estonia,1939,3,3,6
Finland,Estonia,1939,4,2,6
Panama,Cuba,1939,0,4,4
Paraguay,Argentina,1939,0,1,1
Paraguay,Argentina,1939,2,2,4
Czechoslovakia,Yugoslavia,1939,7,3,10
Estonia,Lithuania,1939,0,1,1
Poland,Hungary,1939,4,2,6
Slovakia,Germany,1939,2,0,2
China PR,Japan,1939,0,3,3
Finland,Norway,1939,1,2,3
Manchukuo,Japan,1939,0,6,6
Denmark,Finland,1939,8,1,9
Norway,Sweden,1939,2,3,5
Finland,Latvia,1939,0,3,3
Hungary,Germany,1939,5,1,6
Sweden,Denmark,1939,4,1,5
Yugoslavia,Germany,1939,1,5,6
Bulgaria,Germany,1939,1,2,3
Denmark,Norway,1939,4,1,5
Germany,Czechoslovakia,1939,4,4,8
Switzerland,Italy,1939,3,1,4
Yugoslavia,Hungary,1939,0,2,2
Germany,Italy,1939,5,2,7
Uganda,Kenya,1939,5,2,7
Germany,Slovakia,1939,3,1,4
France,Portugal,1940,3,2,5
Argentina,Paraguay,1940,3,1,4
Brazil,Argentina,1940,2,2,4
Kenya,Uganda,1940,3,6,9
Argentina,Paraguay,1940,4,0,4
Brazil,Argentina,1940,0,3,3
Argentina,Chile,1940,4,1,5
Italy,Switzerland,1940,1,1,2
Argentina,Brazil,1940,6,1,7
Argentina,Chile,1940,3,2,5
Argentina,Brazil,1940,2,3,5
Uruguay,Chile,1940,3,2,5
Argentina,Brazil,1940,5,1,6
Belgium,Netherlands,1940,7,1,8
Brazil,Uruguay,1940,3,4,7
Brazil,Uruguay,1940,1,1,2
Hungary,Switzerland,1940,3,0,3
Netherlands,Luxembourg,1940,4,5,9
Romania,Yugoslavia,1940,3,3,6
Croatia,Switzerland,1940,4,0,4
Germany,Hungary,1940,2,2,4
Germany,Yugoslavia,1940,1,2,3
Italy,Romania,1940,2,1,3
Netherlands,Belgium,1940,4,2,6
Switzerland,Croatia,1940,0,1,1
Israel,Lebanon,1940,5,1,6
Hungary,Croatia,1940,1,0,1
Italy,Germany,1940,3,2,5
Hungary,Romania,1940,2,0,2
Bulgaria,Slovakia,1940,1,4,5
Japan,Manchukuo,1940,7,0,7
Japan,China PR,1940,6,0,6
Japan,Philippines,1940,1,0,1
Germany,Romania,1940,9,3,12
Estonia,Latvia,1940,2,1,3
Uruguay,Argentina,1940,3,0,3
Lithuania,Estonia,1940,2,0,2
Argentina,Uruguay,1940,5,0,5
Finland,Sweden,1940,2,3,5
Germany,Finland,1940,13,0,13
Latvia,Lithuania,1940,1,0,1
Estonia,Lithuania,1940,1,1,2
Latvia,Estonia,1940,2,2,4
Slovakia,Germany,1940,0,1,1
Sweden,Finland,1940,5,0,5
Yugoslavia,Romania,1940,1,2,3
Hungary,Yugoslavia,1940,0,0,0
Hungary,Germany,1940,2,2,4
Sweden,Denmark,1940,1,1,2
Lithuania,Latvia,1940,4,3,7
Denmark,Sweden,1940,3,3,6
Germany,Bulgaria,1940,7,3,10
Yugoslavia,Germany,1940,2,0,2
Cuba,Puerto Rico,1940,1,1,2
Germany,Denmark,1940,1,0,1
Italy,Hungary,1940,1,1,2
Croatia,Hungary,1940,1,1,2
Chile,Argentina,1941,1,2,3
Chile,Argentina,1941,2,5,7
Portugal,Spain,1941,2,2,4
Curaçao,Aruba,1941,4,0,4
Curaçao,Aruba,1941,2,1,3
Peru,Argentina,1941,1,1,2
Peru,Argentina,1941,1,1,2
Peru,Argentina,1941,0,3,3
Chile,Ecuador,1941,5,0,5
Chile,Peru,1941,1,0,1
Ecuador,Uruguay,1941,0,6,6
Argentina,Peru,1941,2,1,3
Argentina,Ecuador,1941,6,1,7
Chile,Uruguay,1941,0,2,2
Guadeloupe,Martinique,1941,1,2,3
Uganda,Kenya,1941,3,4,7
Argentina,Uruguay,1941,1,0,1
Ecuador,Peru,1941,0,4,4
Peru,Uruguay,1941,0,2,2
Chile,Argentina,1941,0,1,1
Germany,Switzerland,1941,4,2,6
Spain,Portugal,1941,5,1,6
Yugoslavia,Hungary,1941,1,1,2
Germany,Hungary,1941,7,0,7
Aruba,Curaçao,1941,0,0,0
Aruba,Curaçao,1941,2,2,4
Switzerland,Germany,1941,2,1,3
Curaçao,Panama,1941,3,3,6
Costa Rica,Nicaragua,1941,7,2,9
Costa Rica,Panama,1941,7,0,7
Curaçao,El Salvador,1941,2,2,4
Costa Rica,Curaçao,1941,6,2,8
El Salvador,Nicaragua,1941,8,0,8
Curaçao,Nicaragua,1941,9,1,10
El Salvador,Panama,1941,4,3,7
Costa Rica,El Salvador,1941,3,1,4
Nicaragua,Panama,1941,2,5,7
Romania,Germany,1941,1,4,5
Germany,Croatia,1941,5,1,6
Afghanistan,India,1941,1,3,4
India,Iran,1941,0,1,1
Martinique,Guadeloupe,1941,5,0,5
Sweden,Denmark,1941,2,2,4
Croatia,Slovakia,1941,5,2,7
Finland,Germany,1941,0,6,6
Sweden,Germany,1941,4,2,6
Romania,Slovakia,1941,3,2,5
Denmark,Sweden,1941,2,1,3
Germany,Denmark,1941,1,1,2
Switzerland,Hungary,1941,1,2,3
Germany,Slovakia,1941,4,0,4
Spain,Switzerland,1941,3,2,5
Portugal,Switzerland,1942,3,0,3
Uruguay,Chile,1942,6,1,7
Argentina,Paraguay,1942,4,3,7
Brazil,Chile,1942,6,1,7
Argentina,Brazil,1942,2,1,3
Paraguay,Peru,1942,1,1,2
Uruguay,Ecuador,1942,7,0,7
Croatia,Germany,1942,0,2,2
Brazil,Peru,1942,2,1,3
Argentina,Ecuador,1942,12,0,12
Chile,Paraguay,1942,0,2,2
Uruguay,Brazil,1942,1,0,1
Argentina,Peru,1942,3,1,4
Ecuador,Paraguay,1942,1,3,4
Cuba,Puerto Rico,1942,1,0,1
Ecuador,Peru,1942,1,2,3
Uruguay,Paraguay,1942,3,1,4
Cuba,Puerto Rico,1942,1,0,1
Argentina,Chile,1942,0,0,0
Brazil,Ecuador,1942,5,1,6
Germany,Switzerland,1942,1,2,3
Uruguay,Peru,1942,3,0,3
Brazil,Paraguay,1942,1,1,2
Chile,Ecuador,1942,2,1,3
Chile,Peru,1942,0,0,0
Uruguay,Argentina,1942,1,0,1
France,Switzerland,1942,0,2,2
Spain,France,1942,4,0,4
Italy,Croatia,1942,4,0,4
Barbados,Trinidad and Tobago,1942,3,3,6
Germany,Spain,1942,1,1,2
Italy,Spain,1942,4,0,4
Hungary,Germany,1942,3,5,8
Argentina,Uruguay,1942,4,1,5
Curaçao,Aruba,1942,2,2,4
Slovakia,Croatia,1942,1,2,3
Hungary,Croatia,1942,1,1,2
Denmark,Sweden,1942,0,3,3
Kenya,Uganda,1942,4,3,7
Bulgaria,Germany,1942,0,3,3
Latvia,Estonia,1942,4,0,4
China PR,Japan,1942,1,6,7
Manchukuo,Japan,1942,0,3,3
Japan,Mongolia,1942,12,0,12
Germany,Romania,1942,7,0,7
Estonia,Latvia,1942,1,8,9
Slovakia,Romania,1942,1,0,1
Uruguay,Argentina,1942,1,1,2
Croatia,Slovakia,1942,6,1,7
Germany,Sweden,1942,2,3,5
Sweden,Denmark,1942,2,1,3
Romania,Croatia,1942,2,2,4
Switzerland,Germany,1942,3,5,8
Germany,Croatia,1942,5,1,6
Hungary,Switzerland,1942,3,0,3
Switzerland,Sweden,1942,3,1,4
Slovakia,Germany,1942,2,5,7
Uganda,Kenya,1943,2,1,3
Argentina,Uruguay,1943,3,3,6
Switzerland,Croatia,1943,1,0,1
Uruguay,Argentina,1943,0,1,1
Croatia,Slovakia,1943,1,0,1
Switzerland,Hungary,1943,1,3,4
Bulgaria,Hungary,1943,2,4,6
Romania,Slovakia,1943,2,2,4
Sweden,Switzerland,1943,1,0,1
Denmark,Sweden,1943,3,2,5
Paraguay,Argentina,1943,2,5,7
Paraguay,Argentina,1943,2,1,3
Sweden,Hungary,1943,2,3,5
Finland,Hungary,1943,0,3,3
Curaçao,Aruba,1943,3,3,6
Curaçao,Aruba,1943,2,2,4
Finland,Sweden,1943,1,1,2
Hungary,Sweden,1943,2,7,9
Guyana,Suriname,1943,2,0,2
Guyana,Suriname,1943,0,1,1
Guyana,Suriname,1943,0,4,4
Costa Rica,Nicaragua,1943,7,0,7
El Salvador,Guatemala,1943,2,2,4
Costa Rica,Guatemala,1943,2,3,5
El Salvador,Nicaragua,1943,8,1,9
El Salvador,Costa Rica,1943,4,2,6
Guatemala,Nicaragua,1943,6,2,8
Aruba,Curaçao,1943,1,2,3
Aruba,Curaçao,1943,1,1,2
El Salvador,Guatemala,1943,2,1,3
Nicaragua,Costa Rica,1943,2,3,5
El Salvador,Nicaragua,1943,10,1,11
Guatemala,Costa Rica,1943,4,2,6
El Salvador,Costa Rica,1943,2,4,6
Nicaragua,Guatemala,1943,1,5,6
Trinidad and Tobago,Barbados,1944,5,0,5
Aruba,Venezuela,1944,1,3,4
Curaçao,Haiti,1944,5,0,5
Haiti,Venezuela,1944,0,2,2
Aruba,Haiti,1944,1,1,2
Croatia,Slovakia,1944,7,3,10
Curaçao,Venezuela,1944,3,3,6
Curaçao,Aruba,1944,3,1,4
Brazil,Uruguay,1944,6,1,7
Brazil,Uruguay,1944,4,0,4
Curaçao,Aruba,1944,2,4,6
Curaçao,Aruba,1944,2,3,5
Suriname,Curaçao,1944,1,2,3
Suriname,Aruba,1944,5,0,5
Aruba,Curaçao,1944,1,2,3
Suriname,Curaçao,1944,0,2,2
Aruba,Curaçao,1944,1,5,6
Suriname,Aruba,1944,2,3,5
Trinidad and Tobago,Guyana,1944,1,1,2
Barbados,Trinidad and Tobago,1944,1,1,2
Trinidad and Tobago,Barbados,1944,3,0,3
Barbados,Guyana,1944,0,3,3
Barbados,Trinidad and Tobago,1944,1,1,2
Trinidad and Tobago,Barbados,1944,6,1,7
Barbados,Guyana,1944,0,1,1
Trinidad and Tobago,Guyana,1944,3,0,3
Barbados,Trinidad and Tobago,1944,1,4,5
Trinidad and Tobago,Guyana,1944,3,0,3
Kenya,Uganda,1944,2,1,3
France,Belgium,1944,3,1,4
Argentina,Paraguay,1945,5,2,7
Argentina,Paraguay,1945,5,3,8
Chile,Ecuador,1945,6,3,9
Argentina,Bolivia,1945,4,0,4
Brazil,Colombia,1945,3,0,3
Chile,Bolivia,1945,5,0,5
Ecuador,Uruguay,1945,1,5,6
Bolivia,Brazil,1945,0,2,2
Colombia,Uruguay,1945,0,7,7
Argentina,Ecuador,1945,4,2,6
Chile,Colombia,1945,2,0,2
Argentina,Colombia,1945,9,1,10
Brazil,Uruguay,1945,3,0,3
Bolivia,Ecuador,1945,0,0,0
Chile,Argentina,1945,1,1,2
Argentina,Brazil,1945,3,1,4
Bolivia,Uruguay,1945,0,2,2
Chile,Uruguay,1945,1,0,1
Colombia,Ecuador,1945,3,1,4
Bolivia,Colombia,1945,3,3,6
Brazil,Ecuador,1945,9,2,11
Argentina,Uruguay,1945,1,0,1
Chile,Brazil,1945,0,1,1
Portugal,Spain,1945,2,2,4
Switzerland,France,1945,1,0,1
Uganda,Kenya,1945,4,1,5
Spain,Portugal,1945,4,2,6
Luxembourg,Belgium,1945,4,1,5
Switzerland,Portugal,1945,1,0,1
England,France,1945,2,2,4
Sweden,Denmark,1945,2,1,3
Latvia,Lithuania,1945,3,7,10
Denmark,Sweden,1945,3,4,7
Paraguay,Argentina,1945,5,1,6
Paraguay,Argentina,1945,1,3,4
Uruguay,Argentina,1945,2,2,4
Switzerland,England,1945,3,1,4
Argentina,Uruguay,1945,6,2,8
Hungary,Austria,1945,2,0,2
Hungary,Austria,1945,5,2,7
Uganda,Tanzania,1945,7,0,7
Denmark,Norway,1945,4,2,6
Suriname,Guyana,1945,3,1,4
Sweden,Finland,1945,7,2,9
Suriname,Guyana,1945,4,1,5
Suriname,Guyana,1945,6,0,6
Lithuania,Estonia,1945,2,3,5
Norway,Denmark,1945,1,5,6
Northern Ireland,England,1945,0,1,1
Estonia,Lithuania,1945,1,2,3
Finland,Sweden,1945,1,6,7
Hungary,Romania,1945,7,2,9
Sweden,Denmark,1945,4,1,5
England,Wales,1945,0,1,1
Sweden,Norway,1945,10,0,10
Switzerland,Italy,1945,4,4,8
Switzerland,Sweden,1945,3,0,3
Austria,France,1945,4,1,5
Aruba,Curaçao,1945,2,1,3
Aruba,Curaçao,1945,2,1,3
Belgium,France,1945,2,1,3
Brazil,Argentina,1945,3,4,7
Brazil,Argentina,1945,6,2,8
Brazil,Argentina,1945,3,1,4
Uruguay,Brazil,1946,4,3,7
Argentina,Paraguay,1946,2,0,2
Bolivia,Brazil,1946,0,3,3
Chile,Uruguay,1946,0,1,1
Argentina,Bolivia,1946,7,1,8
Chile,Paraguay,1946,2,1,3
England,Belgium,1946,2,0,2
Brazil,Uruguay,1946,4,3,7
Scotland,Belgium,1946,2,2,4
Argentina,Chile,1946,3,1,4
Bolivia,Paraguay,1946,2,4,6
Bolivia,Uruguay,1946,0,5,5
Brazil,Paraguay,1946,1,1,2
Argentina,Uruguay,1946,3,1,4
Brazil,Chile,1946,5,1,6
Bolivia,Chile,1946,1,4,5
Paraguay,Uruguay,1946,2,1,3
Argentina,Brazil,1946,2,0,2
Belgium,Luxembourg,1946,7,0,7
El Salvador,Guatemala,1946,1,3,4
Panama,Honduras,1946,1,0,1
Costa Rica,Nicaragua,1946,7,1,8
Costa Rica,Panama,1946,7,0,7
El Salvador,Nicaragua,1946,7,2,9
Honduras,Guatemala,1946,5,3,8
Costa Rica,Honduras,1946,5,1,6
El Salvador,Panama,1946,4,1,5
Guatemala,Nicaragua,1946,7,0,7
Costa Rica,Guatemala,1946,1,4,5
El Salvador,Honduras,1946,3,1,4
Luxembourg,Netherlands,1946,2,6,8
Panama,Nicaragua,1946,0,2,2
Costa Rica,El Salvador,1946,4,0,4
Honduras,Nicaragua,1946,10,0,10
Panama,Guatemala,1946,3,3,6
France,Czechoslovakia,1946,3,0,3
Scotland,England,1946,1,0,1
Austria,Hungary,1946,3,2,5
Portugal,France,1946,2,1,3
England,Scotland,1946,2,2,4
France,Austria,1946,3,1,4
Czechoslovakia,Yugoslavia,1946,0,2,2
England,Switzerland,1946,4,1,5
Netherlands,Belgium,1946,6,3,9
Scotland,Switzerland,1946,3,1,4
France,England,1946,2,1,3
Curaçao,Aruba,1946,2,1,3
Belgium,Netherlands,1946,2,2,4
Aruba,Suriname,1946,8,1,9
Curaçao,Suriname,1946,6,0,6
Norway,Denmark,1946,2,1,3
Portugal,Republic of Ireland,1946,3,1,4
Zimbabwe,Zambia,1946,0,4,4
Denmark,Sweden,1946,3,1,4
Spain,Republic of Ireland,1946,0,1,1
Norway,Finland,1946,12,0,12
Sweden,Switzerland,1946,7,2,9
Denmark,Norway,1946,2,0,2
Iceland,Denmark,1946,0,3,3
Luxembourg,Norway,1946,3,2,5
Albania,Montenegro,1946,5,0,5
Finland,Denmark,1946,2,5,7
Czechoslovakia,Switzerland,1946,3,2,5
Finland,Sweden,1946,0,7,7
Norway,Sweden,1946,0,3,3
Kenya,Tanzania,1946,3,0,3
Kenya,Uganda,1946,2,1,3
Northern Ireland,England,1946,2,7,9
Republic of Ireland,England,1946,0,1,1
Hungary,Austria,1946,2,0,2
Sweden,Denmark,1946,3,3,6
Albania,Yugoslavia,1946,2,3,5
Bulgaria,Romania,1946,2,2,4
Albania,Bulgaria,1946,3,1,4
Romania,Yugoslavia,1946,2,1,3
Albania,Romania,1946,1,0,1
Wales,Scotland,1946,3,1,4
Denmark,Norway,1946,7,1,8
Guyana,Suriname,1946,0,3,3
Guyana,Suriname,1946,0,1,1
Austria,Czechoslovakia,1946,3,4,7
Guyana,Suriname,1946,3,1,4
Luxembourg,Hungary,1946,2,7,9
El Salvador,Panama,1946,2,3,5
El Salvador,Panama,1946,3,3,6
Switzerland,Austria,1946,1,0,1
England,Wales,1946,3,0,3
Aruba,Curaçao,1946,0,4,4
Aruba,Curaçao,1946,3,1,4
England,Netherlands,1946,8,2,10
Scotland,Northern Ireland,1946,0,0,0
Italy,Austria,1946,3,2,5
Venezuela,Bolivia,1947,2,2,4
Portugal,Switzerland,1947,2,2,4
Portugal,Spain,1947,4,1,5
Jamaica,Trinidad and Tobago,1947,0,0,0
Jamaica,Trinidad and Tobago,1947,2,1,3
Madagascar,Mauritius,1947,1,2,3
Jamaica,Trinidad and Tobago,1947,1,0,1
Jamaica,Trinidad and Tobago,1947,1,2,3
Zambia,Zimbabwe,1947,2,2,4
Jamaica,Trinidad and Tobago,1947,0,6,6
Curaçao,Trinidad and Tobago,1947,4,0,4
Curaçao,Trinidad and Tobago,1947,3,0,3
Republic of Ireland,Spain,1947,3,2,5
Suriname,French Guiana,1947,9,1,10
France,Portugal,1947,1,0,1
Uruguay,Brazil,1947,0,0,0
Brazil,Uruguay,1947,3,2,5
Netherlands,Belgium,1947,2,1,3
England,Scotland,1947,1,1,2
Northern Ireland,Wales,1947,2,1,3
Italy,Switzerland,1947,5,2,7
England,France,1947,3,0,3
Belgium,Netherlands,1947,1,2,3
Hungary,Austria,1947,5,2,7
Republic of Ireland,Portugal,1947,0,2,2
Australia,South Africa,1947,1,2,3
Czechoslovakia,Yugoslavia,1947,3,1,4
Italy,Hungary,1947,3,2,5
Mauritius,Réunion,1947,2,1,3
Belgium,Scotland,1947,2,1,3
Switzerland,England,1947,1,0,1
Australia,South Africa,1947,2,4,6
Luxembourg,Scotland,1947,0,6,6
Albania,Romania,1947,0,4,4
Portugal,England,1947,0,10,10
France,Netherlands,1947,4,0,4
Australia,South Africa,1947,3,3,6
France,Belgium,1947,4,2,6
Madagascar,Réunion,1947,4,2,6
Australia,South Africa,1947,5,1,6
Switzerland,France,1947,1,2,3
Norway,Poland,1947,3,1,4
Australia,South Africa,1947,1,2,3
Bulgaria,Albania,1947,2,0,2
Denmark,Sweden,1947,1,4,5
Denmark,Czechoslovakia,1947,2,2,4
Curaçao,Aruba,1947,4,1,5
Curaçao,Aruba,1947,0,0,0
Romania,Yugoslavia,1947,1,3,4
Finland,Norway,1947,1,2,3
Sweden,Denmark,1947,6,1,7
New Zealand,South Africa,1947,5,6,11
Norway,Sweden,1947,1,5,6
Yugoslavia,Hungary,1947,2,3,5
New Zealand,South Africa,1947,0,6,6
Bulgaria,Romania,1947,2,3,5
New Zealand,South Africa,1947,3,8,11
Mexico,United States,1947,5,0,5
Cuba,Mexico,1947,1,3,4
New Zealand,South Africa,1947,1,4,5
Poland,Romania,1947,1,2,3
Cuba,United States,1947,5,2,7
Iceland,Norway,1947,2,4,6
Hungary,Bulgaria,1947,9,0,9
Hungary,Albania,1947,3,0,3
Sweden,Finland,1947,7,0,7
Czechoslovakia,Poland,1947,6,3,9
Suriname,Guyana,1947,4,0,4
Suriname,Guyana,1947,0,0,0
Finland,Norway,1947,3,3,6
Suriname,Guyana,1947,1,0,1
Albania,Yugoslavia,1947,2,4,6
Austria,Hungary,1947,4,3,7
Sweden,Poland,1947,5,4,9
Finland,Poland,1947,1,4,5
Kenya,Uganda,1947,2,3,5
Tanzania,Zanzibar,1947,3,1,4
Tanzania,Uganda,1947,2,4,6
Belgium,England,1947,2,5,7
Netherlands,Switzerland,1947,6,2,8
Norway,Denmark,1947,3,5,8
Romania,Czechoslovakia,1947,2,6,8
Latvia,Lithuania,1947,3,2,5
Northern Ireland,Scotland,1947,2,0,2
Czechoslovakia,Austria,1947,3,2,5
Denmark,Finland,1947,4,1,5
Lithuania,Latvia,1947,0,3,3
Sweden,Norway,1947,4,1,5
Lithuania,Estonia,1947,0,0,0
Romania,Hungary,1947,0,3,3
Yugoslavia,Bulgaria,1947,2,1,3
Wales,England,1947,0,3,3
Yugoslavia,Poland,1947,7,1,8
Catalonia,Spain,1947,3,1,4
Iran,Turkey,1947,1,3,4
Romania,Poland,1947,0,0,0
Switzerland,Belgium,1947,4,0,4
England,Northern Ireland,1947,2,2,4
Trinidad and Tobago,Guyana,1947,1,2,3
Guyana,Jamaica,1947,2,0,2
Trinidad and Tobago,Jamaica,1947,6,0,6
Austria,Italy,1947,5,1,6
Guyana,Jamaica,1947,0,0,0
Scotland,Wales,1947,1,2,3
Trinidad and Tobago,Jamaica,1947,1,0,1
Trinidad and Tobago,Guyana,1947,2,0,2
England,Sweden,1947,4,2,6
Portugal,France,1947,2,4,6
Ecuador,Bolivia,1947,2,2,4
Argentina,Paraguay,1947,6,0,6
Colombia,Uruguay,1947,0,2,2
Argentina,Bolivia,1947,7,0,7
Ecuador,Colombia,1947,0,0,0
Djibouti,Ethiopia,1947,0,5,5
Chile,Uruguay,1947,0,6,6
Cuba,Puerto Rico,1947,4,0,4
Paraguay,Peru,1947,2,2,4
Bolivia,Uruguay,1947,0,3,3
Chile,Peru,1947,2,1,3
Cuba,Puerto Rico,1947,0,0,0
Argentina,Peru,1947,3,2,5
Ecuador,Chile,1947,0,3,3
Bolivia,Colombia,1947,0,0,0
Paraguay,Uruguay,1947,4,2,6
Italy,Czechoslovakia,1947,3,1,4
Argentina,Chile,1947,1,1,2
Ecuador,Uruguay,1947,1,6,7
Argentina,Colombia,1947,6,0,6
Bolivia,Paraguay,1947,1,3,4
Colombia,Paraguay,1947,0,2,2
Ecuador,Peru,1947,0,0,0
Chile,Paraguay,1947,0,1,1
Colombia,Peru,1947,1,5,6
Ecuador,Argentina,1947,0,2,2
Peru,Uruguay,1947,0,1,1
Bolivia,Peru,1947,0,2,2
Argentina,Uruguay,1947,3,1,4
Chile,Colombia,1947,4,1,5
Ecuador,Paraguay,1947,0,4,4
Bolivia,Chile,1947,3,4,7
Costa Rica,El Salvador,1948,3,1,4
Guatemala,El Salvador,1948,3,0,3
Guatemala,Costa Rica,1948,1,1,2
Panama,Curaçao,1948,1,3,4
Guatemala,Curaçao,1948,2,2,4
Costa Rica,Curaçao,1948,2,1,3
El Salvador,Panama,1948,1,2,3
El Salvador,Curaçao,1948,1,0,1
Guatemala,Panama,1948,4,3,7
Wales,Northern Ireland,1948,2,0,2
Costa Rica,Panama,1948,3,1,4
Curaçao,El Salvador,1948,0,2,2
Suriname,Trinidad and Tobago,1948,0,2,2
Guatemala,El Salvador,1948,1,1,2
Belgium,Netherlands,1948,1,1,2
Curaçao,Panama,1948,2,5,7
Suriname,Trinidad and Tobago,1948,0,0,0
Guatemala,Costa Rica,1948,3,2,5
Panama,El Salvador,1948,2,0,2
Suriname,Trinidad and Tobago,1948,1,0,1
El Salvador,Costa Rica,1948,0,6,6
Guatemala,Curaçao,1948,2,2,4
Curaçao,Costa Rica,1948,4,1,5
Guatemala,Panama,1948,4,5,9
Spain,Portugal,1948,2,0,2
Bulgaria,Poland,1948,1,1,2
France,Italy,1948,1,3,4
Uruguay,Brazil,1948,1,1,2
Scotland,England,1948,0,2,2
Uruguay,Brazil,1948,4,2,6
Austria,Switzerland,1948,3,1,4
Netherlands,Belgium,1948,2,2,4
Poland,Czechoslovakia,1948,3,1,4
Silesia,Czechoslovakia,1948,2,1,3
Hungary,Switzerland,1948,7,4,11
Greece,Turkey,1948,1,3,4
Scotland,Belgium,1948,2,0,2
Austria,Hungary,1948,3,2,5
Romania,Albania,1948,0,1,1
Italy,England,1948,0,4,4
Switzerland,Scotland,1948,2,1,3
Albania,Hungary,1948,0,0,0
France,Scotland,1948,3,0,3
Hungary,Czechoslovakia,1948,2,1,3
Portugal,Republic of Ireland,1948,2,0,2
DR Congo,Zambia,1948,2,3,5
Norway,Netherlands,1948,1,2,3
Spain,Republic of Ireland,1948,2,1,3
Turkey,Austria,1948,0,1,1
Djibouti,Ethiopia,1948,1,2,3
Belgium,France,1948,4,2,6
Hungary,Romania,1948,9,0,9
Jamaica,Cuba,1948,3,0,3
Netherlands,Sweden,1948,1,0,1
Czechoslovakia,France,1948,0,4,4
Denmark,Norway,1948,1,2,3
Jamaica,Cuba,1948,1,1,2
Finland,Denmark,1948,0,3,3
Romania,Bulgaria,1948,3,2,5
Switzerland,Spain,1948,3,3,6
Denmark,Poland,1948,8,0,8
Yugoslavia,Albania,1948,0,0,0
Iceland,Finland,1948,2,0,2
Bulgaria,Yugoslavia,1948,1,3,4
Romania,Czechoslovakia,1948,2,1,3
Sweden,Austria,1948,3,2,5
Madagascar,Réunion,1948,2,1,3
Mauritius,Madagascar,1948,4,1,5
Mauritius,Réunion,1948,5,1,6
Sweden,Austria,1948,3,0,3
Norway,United States,1948,11,0,11
Northern Ireland,United States,1948,5,0,5
New Zealand,Australia,1948,0,6,6
Poland,Yugoslavia,1948,0,1,1
Zimbabwe,Zambia,1948,4,0,4
New Zealand,Australia,1948,0,7,7
Bulgaria,Czechoslovakia,1948,1,0,1
Martinique,Dominica,1948,5,0,5
New Zealand,Australia,1948,0,4,4
Norway,Finland,1948,2,0,2
New Zealand,Australia,1948,1,8,9
Finland,Sweden,1948,2,2,4
Norway,Sweden,1948,3,5,8
Poland,Hungary,1948,2,6,8
Kenya,Zanzibar,1948,3,1,4
Uganda,Tanzania,1948,6,0,6
Uganda,Kenya,1948,2,1,3
Denmark,England,1948,0,0,0
French Guiana,Suriname,1948,2,4,6
Latvia,Lithuania,1948,0,1,1
United States,Israel,1948,3,1,4
Estonia,Lithuania,1948,1,2,3
Latvia,Estonia,1948,1,1,2
Suriname,Guyana,1948,3,0,3
Hungary,Austria,1948,2,1,3
Northern Ireland,England,1948,2,6,8
French Guiana,Guyana,1948,3,2,5
Poland,Romania,1948,0,0,0
Sweden,Denmark,1948,1,0,1
Switzerland,Czechoslovakia,1948,1,1,2
Jamaica,Haiti,1948,1,0,1
Jamaica,Haiti,1948,1,2,3
Jamaica,Haiti,1948,3,0,3
France,Belgium,1948,3,3,6
Poland,Finland,1948,1,0,1
Trinidad and Tobago,Haiti,1948,0,0,0
Wales,Scotland,1948,1,3,4
Romania,Hungary,1948,1,5,6
Trinidad and Tobago,Haiti,1948,4,0,4
Iran,Turkey,1948,1,1,2
Trinidad and Tobago,Haiti,1948,4,0,4
Czechoslovakia,Austria,1948,3,1,4
Bulgaria,Hungary,1948,1,0,1
England,Wales,1948,1,0,1
Austria,Sweden,1948,2,1,3
Scotland,Northern Ireland,1948,3,2,5
Belgium,Netherlands,1948,1,1,2
Turkey,Greece,1948,2,1,3
England,Switzerland,1948,6,0,6
Republic of Ireland,Switzerland,1948,0,1,1
Dominica,Martinique,1948,0,6,6
Guadeloupe,Haiti,1948,1,0,1
Guadeloupe,French Guiana,1948,7,2,9
Martinique,Suriname,1948,4,3,7
Guadeloupe,Martinique,1948,3,0,3
Egypt,Norway,1948,1,1,2
China PR,South Korea,1949,3,2,5
Spain,Belgium,1949,1,1,2
Vietnam,South Korea,1949,3,3,6
Macau,South Korea,1949,1,5,6
Italy,Portugal,1949,4,1,5
Northern Ireland,Wales,1949,0,2,2
Netherlands,Belgium,1949,3,3,6
Austria,Turkey,1949,1,0,1
Portugal,Spain,1949,1,1,2
Czechoslovakia,Luxembourg,1949,2,2,4
Spain,Italy,1949,1,3,4
Brazil,Ecuador,1949,9,1,10
Switzerland,Austria,1949,1,2,3
Bolivia,Chile,1949,3,2,5
Colombia,Paraguay,1949,0,3,3
England,Scotland,1949,1,3,4
Brazil,Bolivia,1949,10,1,11
Colombia,Peru,1949,0,4,4
Czechoslovakia,Hungary,1949,5,2,7
Ecuador,Paraguay,1949,0,1,1
Brazil,Chile,1949,2,1,3
Ecuador,Uruguay,1949,2,3,5
Paraguay,Peru,1949,3,1,4
Bolivia,Uruguay,1949,3,2,5
Brazil,Colombia,1949,5,0,5
Chile,Ecuador,1949,1,0,1
Chile,Colombia,1949,1,1,2
Ecuador,Peru,1949,0,4,4
Haiti,Trinidad and Tobago,1949,2,2,4
Paraguay,Uruguay,1949,1,2,3
Haiti,Trinidad and Tobago,1949,2,3,5
Netherlands,France,1949,4,1,5
Brazil,Peru,1949,7,1,8
Republic of Ireland,Belgium,1949,0,2,2
Bolivia,Ecuador,1949,2,0,2
Haiti,Trinidad and Tobago,1949,5,0,5
Uruguay,Colombia,1949,2,2,4
Bolivia,Peru,1949,0,3,3
Chile,Paraguay,1949,2,4,6
Scotland,France,1949,2,0,2
Bolivia,Paraguay,1949,0,7,7
Brazil,Uruguay,1949,5,1,6
Chile,Peru,1949,0,3,3
Ethiopia,Djibouti,1949,6,0,6
Jamaica,Trinidad and Tobago,1949,3,1,4
Colombia,Ecuador,1949,1,4,5
Jamaica,Trinidad and Tobago,1949,2,1,3
Peru,Uruguay,1949,4,3,7
Bolivia,Colombia,1949,4,0,4
Jamaica,Trinidad and Tobago,1949,1,2,3
Brazil,Paraguay,1949,1,2,3
Chile,Uruguay,1949,3,1,4
Hungary,Austria,1949,6,1,7
Romania,Poland,1949,2,1,3
Cuba,Martinique,1949,0,0,0
Puerto Rico,Trinidad and Tobago,1949,2,8,10
Brazil,Paraguay,1949,7,0,7
Puerto Rico,Trinidad and Tobago,1949,0,7,7
Egypt,Turkey,1949,2,3,5
Suriname,Cuba,1949,0,1,1
Sweden,England,1949,3,1,4
Cuba,Dominican Republic,1949,0,1,1
Greece,Turkey,1949,1,2,3
Portugal,Wales,1949,3,2,5
Greece,Egypt,1949,1,3,4
Norway,England,1949,1,4,5
Belgium,Wales,1949,3,1,4
Czechoslovakia,Romania,1949,3,2,5
France,England,1949,1,3,4
Republic of Ireland,Portugal,1949,1,0,1
Italy,Austria,1949,3,1,4
Switzerland,Wales,1949,4,0,4
Sweden,Republic of Ireland,1949,3,1,4
France,Switzerland,1949,4,2,6
Denmark,Netherlands,1949,1,2,3
Hungary,Italy,1949,1,1,2
Republic of Ireland,Spain,1949,1,4,5
Finland,Netherlands,1949,1,4,5
Madagascar,Mauritius,1949,1,3,4
France,Spain,1949,1,5,6
Norway,Yugoslavia,1949,1,3,4
Poland,Denmark,1949,1,2,3
Sweden,Hungary,1949,2,2,4
United States,Scotland,1949,0,4,4
Switzerland,Luxembourg,1949,5,2,7
Martinique,Trinidad and Tobago,1949,2,0,2
Finland,Norway,1949,1,1,2
Hungary,Poland,1949,8,2,10
Curaçao,Aruba,1949,3,0,3
Israel,Cyprus,1949,3,1,4
El Salvador,Panama,1949,3,1,4
El Salvador,Panama,1949,2,3,5
Denmark,Iceland,1949,5,1,6
Suriname,French Guiana,1949,5,0,5
Suriname,French Guiana,1949,2,1,3
Yugoslavia,Israel,1949,6,0,6
Czechoslovakia,Bulgaria,1949,1,3,4
Mexico,United States,1949,6,0,6
Republic of Ireland,Finland,1949,3,0,3
Denmark,Finland,1949,0,2,2
Mexico,Cuba,1949,2,0,2
Norway,Denmark,1949,0,2,2
Cuba,United States,1949,1,1,2
Israel,Yugoslavia,1949,2,5,7
Luxembourg,Switzerland,1949,2,3,5
Mexico,United States,1949,6,2,8
England,Republic of Ireland,1949,0,2,2
United States,Cuba,1949,5,2,7
Austria,Czechoslovakia,1949,3,1,4
Mexico,Cuba,1949,3,0,3
Northern Ireland,Scotland,1949,2,8,10
Belgium,Switzerland,1949,3,0,3
Poland,Bulgaria,1949,3,2,5
Sweden,Finland,1949,8,1,9
Sweden,Norway,1949,3,3,6
Réunion,Mauritius,1949,0,6,6
Sierra Leone,Nigeria,1949,0,2,2
Finland,Republic of Ireland,1949,1,1,2
Yugoslavia,France,1949,1,1,2
Réunion,Madagascar,1949,1,3,4
Wales,England,1949,1,4,5
Austria,Hungary,1949,3,4,7
Denmark,Sweden,1949,3,2,5
Lithuania,Estonia,1949,2,1,3
Romania,Albania,1949,1,1,2
Latvia,Estonia,1949,2,1,3
Lithuania,Latvia,1949,1,0,1
Czechoslovakia,Poland,1949,2,0,2
France,Yugoslavia,1949,1,1,2
Hungary,Bulgaria,1949,5,0,5
Netherlands,Belgium,1949,0,1,1
Poland,Albania,1949,2,1,3
Scotland,Wales,1949,2,0,2
France,Czechoslovakia,1949,1,0,1
Republic of Ireland,Sweden,1949,1,3,4
Yugoslavia,Austria,1949,2,5,7
England,Northern Ireland,1949,9,2,11
Bulgaria,Albania,1949,0,0,0
Hungary,Sweden,1949,5,0,5
Turkey,Syria,1949,7,0,7
Wales,Belgium,1949,5,1,6
Greece,Syria,1949,8,0,8
Albania,Romania,1949,1,4,5
England,Italy,1949,2,0,2
Zanzibar,Kenya,1949,2,3,5
Kenya,Tanzania,1949,0,2,2
France,Yugoslavia,1949,2,3,5
Netherlands,Denmark,1949,0,1,1
Cuba,Jamaica,1949,2,5,7
Haiti,Jamaica,1949,2,0,2
Haiti,Cuba,1949,3,0,3
Zambia,DR Congo,1950,1,0,1
Egypt,Greece,1950,2,0,2
Bolivia,Chile,1950,2,0,2
Croatia,Serbia,1950,4,1,5
Italy,Belgium,1950,3,1,4
Wales,Northern Ireland,1950,0,0,0
Chile,Bolivia,1950,5,0,5
Austria,Switzerland,1950,3,3,6
Guyana,Trinidad and Tobago,1950,0,1,1
Guyana,Trinidad and Tobago,1950,1,4,5
Argentina,Paraguay,1950,2,2,4
Guyana,Trinidad and Tobago,1950,1,0,1
Argentina,Paraguay,1950,4,0,4
Guyana,Trinidad and Tobago,1950,1,2,3
Austria,Italy,1950,1,0,1
Spain,Portugal,1950,5,1,6
Chile,Uruguay,1950,1,5,6
Chile,Uruguay,1950,2,1,3
Portugal,Spain,1950,2,2,4
Mauritius,Réunion,1950,15,2,17
Scotland,England,1950,0,1,1
Belgium,Netherlands,1950,2,0,2
South Korea,Taiwan,1950,3,1,4
Scotland,Switzerland,1950,3,1,4
Hungary,Czechoslovakia,1950,5,0,5
Paraguay,Uruguay,1950,3,2,5
Albania,Poland,1950,0,0,0
Brazil,Uruguay,1950,3,4,7
Brazil,Paraguay,1950,2,0,2
Belgium,Republic of Ireland,1950,5,1,6
Brazil,Paraguay,1950,3,3,6
Austria,Hungary,1950,5,3,8
Brazil,Uruguay,1950,3,2,5
Poland,Romania,1950,3,3,6
Portugal,England,1950,3,5,8
Belgium,England,1950,1,4,5
Portugal,Scotland,1950,2,2,4
Romania,Czechoslovakia,1950,1,1,2
France,Scotland,1950,0,1,1
Ghana,Nigeria,1950,1,0,1
Turkey,Iran,1950,6,1,7
Yugoslavia,Denmark,1950,5,1,6
Albania,Bulgaria,1950,2,1,3
Belgium,France,1950,4,1,5
Poland,Hungary,1950,2,5,7
Sweden,Netherlands,1950,4,1,5
Finland,Netherlands,1950,4,1,5
Switzerland,Yugoslavia,1950,0,4,4
Zimbabwe,Australia,1950,0,5,5
Zimbabwe,Australia,1950,1,4,5
Denmark,Norway,1950,4,0,4
Brazil,Mexico,1950,4,0,4
South Africa,Australia,1950,3,2,5
Chile,England,1950,0,2,2
Denmark,Norway,1950,1,4,5
Italy,Sweden,1950,2,3,5
Spain,United States,1950,3,1,4
Switzerland,Yugoslavia,1950,0,3,3
Brazil,Switzerland,1950,2,2,4
Mexico,Yugoslavia,1950,1,4,5
Chile,Spain,1950,0,2,2
England,United States,1950,0,1,1
Paraguay,Sweden,1950,2,2,4
Brazil,Yugoslavia,1950,2,0,2
South Africa,Australia,1950,2,1,3
Bolivia,Uruguay,1950,0,8,8
Chile,United States,1950,5,2,7
England,Spain,1950,0,1,1
Italy,Paraguay,1950,2,0,2
Mexico,Switzerland,1950,1,2,3
South Africa,Australia,1950,1,2,3
Brazil,Sweden,1950,7,1,8
Spain,Uruguay,1950,2,2,4
Madagascar,Réunion,1950,2,3,5
Madagascar,Mauritius,1950,1,5,6
Brazil,Spain,1950,6,1,7
Sweden,Uruguay,1950,2,3,5
Brazil,Uruguay,1950,1,2,3
Spain,Sweden,1950,1,3,4
Zambia,Zimbabwe,1950,3,2,5
South Africa,Australia,1950,0,2,2
Norway,Luxembourg,1950,2,2,4
Bulgaria,Czechoslovakia,1950,1,2,3
Finland,Denmark,1950,1,2,3
Suriname,Guyana,1950,0,1,1
Suriname,Guyana,1950,3,0,3
El Salvador,Guatemala,1950,2,1,3
Suriname,Guyana,1950,4,1,5
Sweden,Yugoslavia,1950,1,2,3
El Salvador,Guatemala,1950,2,0,2
Finland,Yugoslavia,1950,3,2,5
Denmark,Yugoslavia,1950,1,4,5
Norway,Finland,1950,4,1,5
Finland,Sweden,1950,0,1,1
Hungary,Albania,1950,12,0,12
Norway,Sweden,1950,1,3,4
Northern Ireland,England,1950,1,4,5
Austria,Yugoslavia,1950,7,2,9
Romania,Albania,1950,6,0,6
Tanzania,Zanzibar,1950,4,0,4
Kenya,Uganda,1950,3,1,4
Jamaica,Haiti,1950,2,1,3
Kenya,Tanzania,1950,1,1,2
Sweden,Denmark,1950,4,0,4
Switzerland,Netherlands,1950,7,5,12
Kenya,Tanzania,1950,1,2,3
Wales,Scotland,1950,1,3,4
Poland,Czechoslovakia,1950,1,4,5
Iran,Afghanistan,1950,4,0,4
Israel,Turkey,1950,5,1,6
Hungary,Austria,1950,4,3,7
Bulgaria,Poland,1950,0,1,1
France,Belgium,1950,3,3,6
Scotland,Northern Ireland,1950,6,1,7
Austria,Denmark,1950,5,1,6
Yugoslavia,Norway,1950,4,0,4
Belgium,Netherlands,1950,7,2,9
Bulgaria,Hungary,1950,1,1,2
Switzerland,Sweden,1950,4,2,6
England,Wales,1950,4,2,6
Curaçao,Suriname,1950,2,3,5
England,Yugoslavia,1950,2,2,4
Germany,Switzerland,1950,1,0,1
Trinidad and Tobago,Curaçao,1950,3,2,5
Trinidad and Tobago,Suriname,1950,5,0,5
Republic of Ireland,Norway,1950,2,2,4
Curaçao,Suriname,1950,3,0,3
Trinidad and Tobago,Suriname,1950,1,1,2
Trinidad and Tobago,Curaçao,1950,5,1,6
Turkey,Israel,1950,3,2,5
Guadeloupe,Trinidad and Tobago,1950,0,1,1
France,Netherlands,1950,5,2,7
Scotland,Austria,1950,0,1,1
France,Yugoslavia,1951,2,1,3
Spain,Switzerland,1951,6,3,9
Zimbabwe,Zambia,1951,2,1,3
Costa Rica,Nicaragua,1951,8,1,9
Panama,Costa Rica,1951,2,0,2
Panama,Nicaragua,1951,4,0,4
Panama,Costa Rica,1951,1,1,2
Nicaragua,Costa Rica,1951,1,4,5
Panama,Nicaragua,1951,6,2,8
Northern Ireland,Wales,1951,1,2,3
Barbados,Grenada,1951,1,3,4
Martinique,Guadeloupe,1951,3,0,3
Barbados,Grenada,1951,3,2,5
Portugal,Italy,1951,1,4,5
England,Scotland,1951,2,3,5
Netherlands,Belgium,1951,5,4,9
Switzerland,Germany,1951,2,3,5
Italy,Yugoslavia,1951,0,0,0
England,Argentina,1951,2,1,3
Northern Ireland,France,1951,2,2,4
Scotland,Denmark,1951,3,1,4
Wales,Portugal,1951,2,1,3
Republic of Ireland,Argentina,1951,0,1,1
Scotland,France,1951,1,0,1
Wales,Switzerland,1951,3,2,5
Guadeloupe,Martinique,1951,1,1,2
England,Portugal,1951,5,2,7
Belgium,Scotland,1951,0,5,5
Czechoslovakia,Romania,1951,2,2,4
Barbados,Jamaica,1951,3,0,3
Barbados,Jamaica,1951,0,1,1
Austria,Scotland,1951,4,0,4
Hungary,Poland,1951,6,0,6
Barbados,Jamaica,1951,5,2,7
Norway,Republic of Ireland,1951,2,3,5
Italy,France,1951,4,1,5
Netherlands,Norway,1951,2,3,5
Belgium,Spain,1951,3,3,6
Sweden,Turkey,1951,3,1,4
Denmark,Austria,1951,3,3,6
Germany,Turkey,1951,1,2,3
Portugal,Belgium,1951,1,1,2
Sweden,Spain,1951,0,0,0
Yugoslavia,Switzerland,1951,7,3,10
Iceland,Sweden,1951,4,3,7
Madagascar,Réunion,1951,3,1,4
Mauritius,Madagascar,1951,7,1,8
Mauritius,Réunion,1951,10,2,12
Norway,Iceland,1951,3,1,4
Finland,Norway,1951,1,1,2
Norway,Yugoslavia,1951,2,4,6
Suriname,Guyana,1951,6,1,7
Suriname,Guyana,1951,5,0,5
Sweden,Finland,1951,3,2,5
Yugoslavia,Sweden,1951,2,1,3
Suriname,Guyana,1951,4,0,4
Norway,Denmark,1951,2,0,2
New Caledonia,New Zealand,1951,2,0,2
New Caledonia,New Zealand,1951,4,6,10
Austria,Germany,1951,0,2,2
New Caledonia,New Zealand,1951,2,0,2
Kenya,Uganda,1951,2,1,3
Tanzania,Zanzibar,1951,1,0,1
Tanzania,Kenya,1951,3,2,5
Denmark,Finland,1951,1,0,1
New Caledonia,New Zealand,1951,1,3,4
Sweden,Norway,1951,3,4,7
England,France,1951,2,2,4
New Zealand,Vanuatu,1951,9,0,9
Northern Ireland,Scotland,1951,0,3,3
Fiji,New Zealand,1951,4,6,10
Belgium,Austria,1951,1,8,9
Czechoslovakia,Hungary,1951,1,2,3
Switzerland,France,1951,1,2,3
Republic of Ireland,Germany,1951,3,2,5
Nigeria,Ghana,1951,5,0,5
Wales,England,1951,1,1,2
Denmark,Sweden,1951,3,1,4
Netherlands,Finland,1951,4,4,8
France,Austria,1951,2,2,4
Luxembourg,Finland,1951,3,0,3
Italy,Sweden,1951,1,1,2
England,Northern Ireland,1951,2,0,2
Scotland,Wales,1951,0,1,1
Turkey,Sweden,1951,1,0,1
Hungary,Finland,1951,8,0,8
Turkey,Germany,1951,0,2,2
Greece,Egypt,1951,1,0,1
Netherlands,Belgium,1951,6,7,13
Switzerland,Italy,1951,1,1,2
England,Austria,1951,2,2,4
Venezuela,Panama,1951,4,1,5
Guadeloupe,Trinidad and Tobago,1951,0,2,2
Germany,Luxembourg,1951,4,1,5
Jamaica,Haiti,1951,2,2,4
Jamaica,Haiti,1951,0,1,1
Jamaica,Haiti,1951,2,1,3
Curaçao,Aruba,1952,3,0,3
Curaçao,Aruba,1952,3,1,4
Aruba,Suriname,1952,2,1,3
Guyana,Suriname,1952,0,9,9
Belgium,Italy,1952,2,0,2
Guadeloupe,Martinique,1952,4,0,4
Martinique,Guadeloupe,1952,1,2,3
Myanmar,India,1952,0,4,4
Chile,Panama,1952,6,1,7
Myanmar,Pakistan,1952,0,1,1
Wales,Northern Ireland,1952,3,0,3
Austria,Belgium,1952,2,0,2
India,Pakistan,1952,0,0,0
Mexico,Uruguay,1952,1,3,4
Panama,Peru,1952,1,7,8
Sri Lanka,India,1952,1,2,3
Chile,Mexico,1952,4,0,4
France,Sweden,1952,0,1,1
Sri Lanka,Pakistan,1952,0,2,2
Peru,Uruguay,1952,2,5,7
Chile,Peru,1952,3,2,5
Scotland,England,1952,1,2,3
Belgium,Netherlands,1952,4,2,6
Brazil,Mexico,1952,2,0,2
Panama,Uruguay,1952,1,6,7
Brazil,Peru,1952,0,0,0
Mexico,Panama,1952,4,2,6
Brazil,Panama,1952,5,0,5
Chile,Uruguay,1952,2,0,2
Brazil,Uruguay,1952,4,2,6
Chile,Brazil,1952,0,3,3
France,Portugal,1952,3,0,3
Luxembourg,Germany,1952,0,3,3
Mexico,Peru,1952,0,3,3
Scotland,United States,1952,6,0,6
Germany,Republic of Ireland,1952,3,0,3
Austria,Republic of Ireland,1952,6,0,6
Romania,Czechoslovakia,1952,3,1,4
Netherlands,Sweden,1952,0,0,0
Hungary,German DR,1952,5,0,5
Italy,England,1952,1,1,2
Poland,Bulgaria,1952,0,1,1
Belgium,France,1952,1,2,3
Russia,Hungary,1952,1,1,2
Austria,England,1952,2,3,5
Denmark,Scotland,1952,1,2,3
Romania,Poland,1952,1,0,1
Russia,Hungary,1952,2,1,3
Switzerland,England,1952,0,3,3
Sweden,Scotland,1952,3,1,4
Spain,Republic of Ireland,1952,6,0,6
Turkey,Switzerland,1952,1,5,6
Turkey,Spain,1952,0,0,0
Norway,Finland,1952,1,2,3
Denmark,Sweden,1952,0,2,2
Finland,Sweden,1952,3,1,4
Poland,Hungary,1952,1,5,6
Finland,Hungary,1952,1,6,7
Sweden,Denmark,1952,4,3,7
Switzerland,Austria,1952,1,1,2
Yugoslavia,Norway,1952,4,1,5
Netherlands,Curaçao,1952,3,3,6
Haiti,Jamaica,1952,4,1,5
Haiti,Jamaica,1952,3,3,6
Haiti,Jamaica,1952,2,0,2
Réunion,Madagascar,1952,0,1,1
Haiti,Jamaica,1952,3,2,5
Réunion,Mauritius,1952,0,6,6
Madagascar,Mauritius,1952,0,7,7
Finland,China PR,1952,4,0,4
Netherlands,Egypt,1952,1,1,2
Silesia,China PR,1952,5,1,6
Norway,Finland,1952,7,2,9
Zambia,Zimbabwe,1952,1,4,5
Fiji,New Zealand,1952,0,2,2
Zambia,Zimbabwe,1952,3,2,5
Czechoslovakia,Poland,1952,2,2,4
Fiji,New Zealand,1952,0,9,9
Fiji,New Zealand,1952,2,5,7
Switzerland,Hungary,1952,2,4,6
Denmark,Netherlands,1952,3,2,5
Finland,Sweden,1952,1,8,9
Poland,German DR,1952,3,0,3
Tahiti,New Zealand,1952,2,2,4
Yugoslavia,Austria,1952,4,2,6
Uganda,Tanzania,1952,4,0,4
Kenya,Zanzibar,1952,7,1,8
Tanzania,Zanzibar,1952,1,3,4
Uganda,Kenya,1952,6,3,9
Tahiti,New Zealand,1952,3,5,8
Northern Ireland,England,1952,2,2,4
Finland,Denmark,1952,2,1,3
France,Germany,1952,3,1,4
Norway,Sweden,1952,1,2,3
Wales,Scotland,1952,1,2,3
Austria,France,1952,1,2,3
Belgium,Netherlands,1952,2,1,3
Denmark,Norway,1952,1,3,4
Hungary,Czechoslovakia,1952,5,0,5
Romania,German DR,1952,3,1,4
Sweden,Italy,1952,1,1,2
Yugoslavia,Egypt,1952,5,0,5
Scotland,Northern Ireland,1952,1,1,2
Germany,Switzerland,1952,5,1,6
France,Northern Ireland,1952,3,1,4
England,Wales,1952,5,2,7
Republic of Ireland,France,1952,1,1,2
Portugal,Austria,1952,1,1,2
England,Belgium,1952,5,0,5
Albania,Czechoslovakia,1952,3,2,5
Spain,Argentina,1952,0,1,1
Portugal,Argentina,1952,1,3,4
Germany,Yugoslavia,1952,3,2,5
France,Belgium,1952,0,1,1
Italy,Switzerland,1952,2,0,2
Spain,Germany,1952,2,2,4
Egypt,Yugoslavia,1953,1,3,4
Gambia,Sierra Leone,1953,2,1,3
Peru,Bolivia,1953,0,1,1
Bolivia,Uruguay,1953,0,2,2
Chile,Paraguay,1953,0,3,3
Peru,Ecuador,1953,1,0,1
Bolivia,Brazil,1953,1,8,9
Chile,Uruguay,1953,3,2,5
Ecuador,Paraguay,1953,0,0,0
Peru,Chile,1953,0,0,0
Netherlands,Denmark,1953,1,2,3
Bolivia,Ecuador,1953,1,1,2
Costa Rica,El Salvador,1953,5,1,6
Honduras,Nicaragua,1953,2,1,3
Peru,Paraguay,1953,2,2,4
Guatemala,Curaçao,1953,1,1,2
Costa Rica,Panama,1953,3,0,3
El Salvador,Nicaragua,1953,4,1,5
Curaçao,Nicaragua,1953,8,0,8
Guatemala,Honduras,1953,1,0,1
Brazil,Ecuador,1953,2,0,2
Panama,Curaçao,1953,2,4,6
Paraguay,Uruguay,1953,2,2,4
Costa Rica,Honduras,1953,4,1,5
Guatemala,El Salvador,1953,3,2,5
Panama,Nicaragua,1953,0,2,2
Brazil,Uruguay,1953,1,0,1
Costa Rica,Curaçao,1953,1,0,1
El Salvador,Honduras,1953,0,3,3
Bolivia,Paraguay,1953,1,2,3
Costa Rica,Nicaragua,1953,3,0,3
Panama,Guatemala,1953,2,2,4
Chile,Ecuador,1953,3,0,3
Curaçao,Honduras,1953,3,4,7
El Salvador,Panama,1953,2,1,3
Guatemala,Nicaragua,1953,1,0,1
Peru,Brazil,1953,1,0,1
Spain,Belgium,1953,3,1,4
Costa Rica,Guatemala,1953,3,0,3
El Salvador,Curaçao,1953,1,1,2
Honduras,Panama,1953,3,1,4
Germany,Austria,1953,0,0,0
Netherlands,Switzerland,1953,1,2,3
Brazil,Chile,1953,3,2,5
Ecuador,Uruguay,1953,0,6,6
Republic of Ireland,Austria,1953,4,0,4
Brazil,Paraguay,1953,1,2,3
Bolivia,Chile,1953,2,2,4
Peru,Uruguay,1953,0,3,3
Brazil,Paraguay,1953,2,3,5
Hong Kong,South Korea,1953,4,0,4
South Korea,Taiwan,1953,2,4,6
Singapore,South Korea,1953,2,3,5
Northern Ireland,Wales,1953,2,3,5
Malaysia,South Korea,1953,2,3,5
Martinique,Guadeloupe,1953,4,3,7
England,Scotland,1953,2,2,4
Singapore,South Korea,1953,3,1,4
Netherlands,Belgium,1953,0,2,2
Singapore,South Korea,1953,1,3,4
Singapore,South Korea,1953,0,0,0
Czechoslovakia,Italy,1953,2,0,2
Hungary,Austria,1953,1,1,2
Silesia,Poland,1953,2,3,5
Indonesia,South Korea,1953,1,3,4
Scotland,Sweden,1953,1,2,3
Yugoslavia,Greece,1953,1,0,1
Poland,Czechoslovakia,1953,1,1,2
Argentina,England,1953,3,1,4
Belgium,Yugoslavia,1953,1,3,4
France,Wales,1953,6,1,7
Argentina,England,1953,0,0,0
Guadeloupe,Martinique,1953,0,2,2
Italy,Hungary,1953,0,3,3
Yugoslavia,Wales,1953,5,2,7
Chile,England,1953,1,2,3
Finland,Belgium,1953,2,4,6
Switzerland,Turkey,1953,1,2,3
Sweden,Belgium,1953,2,3,5
Uruguay,England,1953,2,1,3
Gambia,Guinea-Bissau,1953,1,3,4
Turkey,Yugoslavia,1953,2,2,4
Guinea-Bissau,Gambia,1953,1,0,1
United States,England,1953,3,6,9
Sweden,France,1953,1,0,1
German DR,Bulgaria,1953,0,0,0
Singapore,Philippines,1953,3,1,4
Denmark,Sweden,1953,1,3,4
Norway,Saarland,1953,2,3,5
Switzerland,Denmark,1953,1,4,5
Czechoslovakia,Romania,1953,2,0,2
Romania,Bulgaria,1953,3,1,4
Argentina,Spain,1953,1,0,1
Sweden,Hungary,1953,2,4,6
Chile,Spain,1953,1,2,3
Mauritius,Réunion,1953,9,4,13
Madagascar,Réunion,1953,6,4,10
Mexico,Haiti,1953,8,0,8
Madagascar,Mauritius,1953,2,3,5
Peru,Chile,1953,1,2,3
Peru,Chile,1953,5,0,5
Finland,Sweden,1953,3,3,6
Denmark,Iceland,1953,4,0,4
Catalonia,Spain,1953,0,6,6
Jamaica,Trinidad and Tobago,1953,3,2,5
Jamaica,Trinidad and Tobago,1953,0,1,1
Norway,Iceland,1953,3,1,4
Sweden,Finland,1953,4,0,4
Norway,Germany,1953,1,1,2
Suriname,Aruba,1953,3,3,6
Finland,Norway,1953,1,4,5
Suriname,Aruba,1953,3,3,6
Bulgaria,Czechoslovakia,1953,1,2,3
Vanuatu,Tahiti,1953,2,4,6
Bulgaria,Poland,1953,2,2,4
Norway,Denmark,1953,0,1,1
Silesia,Poland,1953,3,3,6
Vanuatu,Tahiti,1953,2,4,6
Uganda,Burundi,1953,9,1,10
Czechoslovakia,Switzerland,1953,5,0,5
Luxembourg,France,1953,1,6,7
New Caledonia,Tahiti,1953,5,0,5
Belgium,Finland,1953,2,2,4
New Caledonia,Tahiti,1953,4,1,5
Austria,Portugal,1953,9,1,10
New Caledonia,Tahiti,1953,4,1,5
Kernow,Trinidad and Tobago,1953,3,6,9
Norway,Netherlands,1953,4,0,4
Zanzibar,Uganda,1953,1,5,6
Kenya,Tanzania,1953,7,1,8
Kernow,Trinidad and Tobago,1953,2,4,6
Kenya,Uganda,1953,6,2,8
Northern Ireland,Scotland,1953,1,3,4
Kernow,Trinidad and Tobago,1953,1,1,2
Bulgaria,Hungary,1953,1,1,2
Czechoslovakia,Hungary,1953,1,5,6
Denmark,Finland,1953,6,1,7
Republic of Ireland,France,1953,3,5,8
Belgium,Sweden,1953,2,0,2
Wales,England,1953,1,4,5
Austria,Hungary,1953,2,3,5
Bulgaria,Romania,1953,1,2,3
Germany,Saarland,1953,3,0,3
Ghana,Nigeria,1953,1,0,1
Zambia,Zimbabwe,1953,1,0,1
Sweden,Norway,1953,0,0,0
Yugoslavia,France,1953,3,1,4
Myanmar,Sri Lanka,1953,3,2,5
Netherlands,Belgium,1953,1,0,1
Romania,Czechoslovakia,1953,0,1,1
Sri Lanka,India,1953,0,2,2
Myanmar,Pakistan,1953,1,1,2
Republic of Ireland,Luxembourg,1953,4,0,4
Myanmar,India,1953,2,4,6
Greece,Israel,1953,1,0,1
Scotland,Wales,1953,3,3,6
Czechoslovakia,Bulgaria,1953,0,0,0
Saarland,Norway,1953,0,0,0
Spain,Sweden,1953,2,2,4
Yugoslavia,Israel,1953,1,0,1
England,Northern Ireland,1953,3,1,4
France,Switzerland,1953,2,4,6
Egypt,Italy,1953,1,2,3
Haiti,Jamaica,1953,4,1,5
Hungary,Sweden,1953,2,2,4
Haiti,Jamaica,1953,1,0,1
Germany,Norway,1953,5,1,6
Portugal,South Africa,1953,3,1,4
Switzerland,Belgium,1953,2,2,4
England,Hungary,1953,3,6,9
France,Republic of Ireland,1953,1,0,1
Albania,Poland,1953,2,0,2
Portugal,Austria,1953,0,0,0
Italy,Czechoslovakia,1953,3,0,3
France,Luxembourg,1953,8,0,8
Haiti,Mexico,1953,0,4,4
Spain,Turkey,1954,4,1,5
Mexico,United States,1954,4,0,4
Mexico,United States,1954,3,1,4
Italy,Egypt,1954,5,1,6
Egypt,Hungary,1954,0,3,3
Paraguay,Chile,1954,4,0,4
Chile,Paraguay,1954,1,3,4
Chile,Brazil,1954,0,2,2
Japan,South Korea,1954,1,5,6
Luxembourg,Republic of Ireland,1954,0,1,1
Paraguay,Brazil,1954,0,1,1
Israel,Greece,1954,0,2,2
Belgium,Portugal,1954,0,0,0
Brazil,Chile,1954,1,0,1
Japan,South Korea,1954,2,2,4
Turkey,Spain,1954,1,0,1
Turkey,Spain,1954,2,2,4
Martinique,Guadeloupe,1954,2,2,4
Israel,Yugoslavia,1954,0,1,1
Brazil,Paraguay,1954,4,1,5
Greece,Yugoslavia,1954,0,1,1
Saarland,Germany,1954,1,3,4
Wales,Northern Ireland,1954,1,2,3
Haiti,United States,1954,2,3,5
Scotland,England,1954,2,4,6
Belgium,Netherlands,1954,4,0,4
Haiti,United States,1954,0,3,3
Uruguay,Paraguay,1954,1,4,5
Austria,Hungary,1954,0,1,1
France,Italy,1954,1,3,4
Paraguay,Uruguay,1954,1,1,2
Singapore,Pakistan,1954,2,2,4
Switzerland,Germany,1954,3,5,8
Ethiopia,Djibouti,1954,10,2,12
South Africa,Israel,1954,2,1,3
Zambia,Israel,1954,0,0,0
Scotland,Norway,1954,1,0,1
Zimbabwe,Israel,1954,2,1,3
German DR,Romania,1954,0,1,1
Austria,Wales,1954,2,0,2
Yugoslavia,Belgium,1954,0,2,2
Zimbabwe,Israel,1954,1,2,3
Yugoslavia,England,1954,1,0,1
Norway,Scotland,1954,1,1,2
Sweden,Netherlands,1954,6,1,7
Guadeloupe,Martinique,1954,2,4,6
Hungary,England,1954,7,1,8
Switzerland,Uruguay,1954,3,3,6
Zimbabwe,Zambia,1954,1,0,1
Finland,Scotland,1954,1,2,3
Austria,Norway,1954,5,0,5
Belgium,France,1954,3,3,6
Switzerland,Netherlands,1954,3,1,4
Djibouti,Ethiopia,1954,0,2,2
Ghana,Sierra Leone,1954,2,0,2
Djibouti,Ethiopia,1954,1,2,3
Hong Kong,Taiwan,1954,2,2,4
Denmark,Norway,1954,1,2,3
Sweden,Finland,1954,6,0,6
Saarland,Uruguay,1954,1,7,8
Sweden,Norway,1954,3,0,3
Finland,Denmark,1954,2,2,4
Austria,Scotland,1954,1,0,1
Brazil,Mexico,1954,5,0,5
Czechoslovakia,Uruguay,1954,0,2,2
France,Yugoslavia,1954,0,1,1
Belgium,England,1954,4,4,8
Germany,Turkey,1954,4,1,5
Hungary,South Korea,1954,9,0,9
Switzerland,Italy,1954,2,1,3
Austria,Czechoslovakia,1954,5,0,5
Brazil,Yugoslavia,1954,1,1,2
France,Mexico,1954,3,2,5
Scotland,Uruguay,1954,0,7,7
Belgium,Italy,1954,1,4,5
Germany,Hungary,1954,3,8,11
South Korea,Turkey,1954,0,7,7
Switzerland,England,1954,0,2,2
Germany,Turkey,1954,7,2,9
Switzerland,Italy,1954,4,1,5
England,Uruguay,1954,2,4,6
Switzerland,Austria,1954,5,7,12
Brazil,Hungary,1954,2,4,6
Germany,Yugoslavia,1954,2,0,2
Austria,Germany,1954,1,6,7
Hungary,Uruguay,1954,4,2,6
Austria,Uruguay,1954,3,1,4
Germany,Hungary,1954,3,2,5
Iceland,Norway,1954,1,0,1
Madagascar,Réunion,1954,2,6,8
Mauritius,Madagascar,1954,4,1,5
Mauritius,Réunion,1954,11,0,11
Curaçao,Netherlands,1954,2,0,2
Aruba,Netherlands,1954,2,2,4
Curaçao,Netherlands,1954,2,1,3
Suriname,Netherlands,1954,3,4,7
Suriname,Netherlands,1954,0,2,2
Poland,Bulgaria,1954,2,2,4
Australia,New Zealand,1954,1,2,3
Finland,Sweden,1954,1,10,11
Zimbabwe,Zambia,1954,2,4,6
Sweden,Iceland,1954,3,2,5
Australia,New Zealand,1954,4,1,5
Norway,Finland,1954,3,1,4
Australia,New Zealand,1954,4,1,5
Russia,Sweden,1954,7,0,7
Chile,Peru,1954,2,1,3
Chile,Peru,1954,2,4,6
Denmark,Switzerland,1954,1,1,2
Hungary,Romania,1954,5,1,6
Norway,Sweden,1954,1,1,2
Wales,Yugoslavia,1954,1,3,4
Belgium,Germany,1954,2,0,2
German DR,Poland,1954,0,1,1
Russia,Hungary,1954,1,1,2
Saarland,Yugoslavia,1954,1,5,6
Northern Ireland,England,1954,0,2,2
Austria,Yugoslavia,1954,2,2,4
Kenya,Zanzibar,1954,5,0,5
Tanzania,Uganda,1954,3,5,8
Kenya,Uganda,1954,2,2,4
Hungary,Switzerland,1954,3,0,3
Kenya,Uganda,1954,1,4,5
Sweden,Denmark,1954,5,2,7
Germany,France,1954,1,3,4
Wales,Scotland,1954,0,1,1
Yugoslavia,Turkey,1954,5,1,6
Belgium,Netherlands,1954,4,3,7
Bulgaria,German DR,1954,3,1,4
Hungary,Czechoslovakia,1954,4,1,5
Nigeria,Ghana,1954,3,0,3
Denmark,Norway,1954,0,1,1
Sweden,Austria,1954,2,1,3
Cambodia,Thailand,1954,7,1,8
Scotland,Northern Ireland,1954,2,2,4
Greece,Egypt,1954,1,1,2
Republic of Ireland,Norway,1954,2,1,3
England,Wales,1954,3,2,5
France,Belgium,1954,2,2,4
Hungary,Austria,1954,4,1,5
Portugal,Argentina,1954,1,3,4
England,Germany,1954,3,1,4
Italy,Argentina,1954,2,0,2
Scotland,Hungary,1954,2,4,6
Sri Lanka,Pakistan,1954,1,2,3
India,Myanmar,1954,2,1,3
Portugal,Germany,1954,0,3,3
India,Sri Lanka,1954,1,1,2
Myanmar,Pakistan,1954,1,1,2
Myanmar,Sri Lanka,1954,1,2,3
Egypt,Bulgaria,1955,1,0,1
Myanmar,Japan,1955,0,1,1
Italy,Belgium,1955,1,0,1
Lebanon,Bulgaria,1955,2,3,5
Chile,Ecuador,1955,7,1,8
Martinique,Guadeloupe,1955,4,1,5
Argentina,Paraguay,1955,5,3,8
Chile,Peru,1955,5,4,9
Argentina,Ecuador,1955,4,0,4
Paraguay,Uruguay,1955,1,3,4
Chile,Uruguay,1955,2,2,4
Ecuador,Peru,1955,2,4,6
Netherlands,Denmark,1955,1,1,2
Argentina,Peru,1955,2,2,4
Ecuador,Paraguay,1955,0,2,2
Spain,France,1955,1,2,3
Chile,Paraguay,1955,5,0,5
Ecuador,Uruguay,1955,1,5,6
Paraguay,Peru,1955,1,1,2
Argentina,Uruguay,1955,6,1,7
Czechoslovakia,Austria,1955,3,2,5
Chile,Argentina,1955,0,1,1
Germany,Italy,1955,1,2,3
Peru,Uruguay,1955,2,1,3
England,Scotland,1955,7,2,9
France,Sweden,1955,2,0,2
Netherlands,Belgium,1955,1,0,1
Northern Ireland,Wales,1955,2,3,5
Austria,Hungary,1955,2,2,4
Republic of Ireland,Netherlands,1955,1,0,1
Switzerland,Austria,1955,2,3,5
Scotland,Portugal,1955,3,0,3
Martinique,Guadeloupe,1955,1,1,2
Norway,Hungary,1955,0,5,5
Sweden,Hungary,1955,3,7,10
Denmark,Hungary,1955,0,6,6
France,England,1955,1,0,1
Yugoslavia,Scotland,1955,2,2,4
Spain,England,1955,1,1,2
Austria,Scotland,1955,1,4,5
Finland,Hungary,1955,1,9,10
Netherlands,Switzerland,1955,4,1,5
Bulgaria,Egypt,1955,2,1,3
Portugal,England,1955,3,1,4
Norway,Republic of Ireland,1955,1,3,4
Germany,Republic of Ireland,1955,2,1,3
Ghana,Nigeria,1955,1,0,1
Hungary,Scotland,1955,3,1,4
Italy,Yugoslavia,1955,0,4,4
Romania,Poland,1955,2,2,4
Belgium,Czechoslovakia,1955,1,3,4
Norway,Romania,1955,0,1,1
Sweden,Romania,1955,4,1,5
El Salvador,Honduras,1955,2,2,4
Denmark,Finland,1955,2,1,3
El Salvador,Honduras,1955,0,0,0
Switzerland,Spain,1955,0,3,3
Bulgaria,Poland,1955,1,1,2
Sweden,Russia,1955,0,6,6
Yugoslavia,Switzerland,1955,0,0,0
Iceland,Denmark,1955,0,4,4
Réunion,Mauritius,1955,1,3,4
Réunion,Madagascar,1955,2,4,6
Tahiti,New Caledonia,1955,1,1,2
Madagascar,Mauritius,1955,2,1,3
Costa Rica,Guatemala,1955,9,1,10
Guatemala,Costa Rica,1955,3,1,4
Costa Rica,Aruba,1955,3,2,5
Finland,Norway,1955,1,3,4
Honduras,Cuba,1955,3,0,3
Guatemala,El Salvador,1955,2,3,5
Costa Rica,Cuba,1955,6,0,6
Curaçao,Aruba,1955,2,1,3
Honduras,El Salvador,1955,3,1,4
Guatemala,Curaçao,1955,4,1,5
Aruba,Cuba,1955,4,1,5
Costa Rica,El Salvador,1955,4,0,4
El Salvador,Cuba,1955,2,1,3
Honduras,Curaçao,1955,0,2,2
Guatemala,Costa Rica,1955,0,2,2
Russia,Germany,1955,3,2,5
Honduras,Aruba,1955,1,1,2
Costa Rica,Curaçao,1955,2,1,3
El Salvador,Aruba,1955,2,0,2
Iceland,United States,1955,3,2,5
Curaçao,El Salvador,1955,3,0,3
Curaçao,Cuba,1955,2,0,2
Honduras,Costa Rica,1955,1,2,3
Sweden,Finland,1955,3,0,3
Australia,South Africa,1955,0,3,3
Australia,South Africa,1955,0,2,2
Finland,Poland,1955,1,3,4
Norway,Denmark,1955,1,1,2
Russia,India,1955,11,1,12
Australia,South Africa,1955,0,8,8
Switzerland,Hungary,1955,4,5,9
Brazil,Chile,1955,1,1,2
Romania,German DR,1955,2,3,5
Brazil,Chile,1955,2,1,3
Australia,South Africa,1955,0,6,6
Czechoslovakia,Belgium,1955,5,2,7
Hungary,Russia,1955,1,1,2
Sweden,Norway,1955,1,1,2
Yugoslavia,Germany,1955,3,1,4
Romania,Belgium,1955,1,0,1
Australia,South Africa,1955,1,4,5
Czechoslovakia,Hungary,1955,1,3,4
Denmark,England,1955,1,5,6
Northern Ireland,Scotland,1955,2,1,3
Japan,Myanmar,1955,0,0,0
Romania,Bulgaria,1955,1,1,2
Switzerland,France,1955,1,2,3
Kenya,Uganda,1955,0,1,1
Kenya,Zanzibar,1955,8,0,8
Tanzania,Uganda,1955,1,5,6
Denmark,Sweden,1955,3,3,6
Hungary,Austria,1955,6,1,7
Netherlands,Belgium,1955,2,2,4
Republic of Ireland,Yugoslavia,1955,1,4,5
Wales,England,1955,2,1,3
Russia,France,1955,2,2,4
Austria,Yugoslavia,1955,2,1,3
Ghana,Nigeria,1955,7,0,7
England,Northern Ireland,1955,3,0,3
Netherlands,Norway,1955,3,0,3
Scotland,Wales,1955,2,0,2
France,Yugoslavia,1955,1,1,2
Brazil,Paraguay,1955,3,0,3
Bulgaria,Czechoslovakia,1955,3,0,3
Hungary,Sweden,1955,4,2,6
Germany,Norway,1955,2,0,2
Saarland,Netherlands,1955,1,2,3
Brazil,Paraguay,1955,3,3,6
German DR,Bulgaria,1955,1,0,1
Portugal,Sweden,1955,2,6,8
Wales,Austria,1955,1,2,3
Hungary,Italy,1955,2,0,2
Republic of Ireland,Spain,1955,2,2,4
England,Spain,1955,4,1,5
Suriname,Trinidad and Tobago,1955,5,2,7
Suriname,Trinidad and Tobago,1955,3,1,4
Pakistan,Myanmar,1955,4,2,6
Italy,Germany,1955,2,1,3
Sri Lanka,India,1955,3,4,7
Suriname,Trinidad and Tobago,1955,3,0,3
Turkey,Portugal,1955,3,1,4
Myanmar,India,1955,1,2,3
Egypt,Portugal,1955,0,4,4
Belgium,France,1955,2,1,3
Myanmar,Sri Lanka,1955,3,1,4
Curaçao,Martinique,1956,3,1,4
Curaçao,Martinique,1956,3,1,4
Uruguay,Paraguay,1956,4,2,6
Argentina,Peru,1956,2,1,3
Brazil,Chile,1956,1,4,5
Uruguay,Peru,1956,2,0,2
Argentina,Chile,1956,2,0,2
Brazil,Paraguay,1956,0,0,0
Argentina,Paraguay,1956,1,0,1
Brazil,Peru,1956,2,1,3
Argentina,Brazil,1956,0,1,1
Paraguay,Peru,1956,1,1,2
Uruguay,Chile,1956,2,1,3
Chile,Peru,1956,4,3,7
Uruguay,Brazil,1956,0,0,0
Chile,Paraguay,1956,2,0,2
Italy,France,1956,2,0,2
Uruguay,Argentina,1956,1,0,1
Turkey,Hungary,1956,3,1,4
Philippines,South Korea,1956,0,2,2
Mexico,Costa Rica,1956,1,1,2
Argentina,Peru,1956,0,0,0
Lebanon,Hungary,1956,1,4,5
Brazil,Chile,1956,2,1,3
Mexico,Peru,1956,0,2,2
Argentina,Costa Rica,1956,4,3,7
Brazil,Peru,1956,1,0,1
Chile,Costa Rica,1956,1,2,3
Haiti,Panama,1956,3,2,5
Mexico,Brazil,1956,1,2,3
Panama,Venezuela,1956,0,1,1
Haiti,Venezuela,1956,1,1,2
Argentina,Chile,1956,3,0,3
Belgium,Switzerland,1956,1,3,4
Haiti,Panama,1956,2,1,3
Brazil,Costa Rica,1956,7,1,8
Mexico,Argentina,1956,0,0,0
Germany,Netherlands,1956,1,2,3
Panama,Venezuela,1956,2,4,6
Chile,Peru,1956,2,2,4
Haiti,Venezuela,1956,3,0,3
Costa Rica,Peru,1956,4,2,6
Malaysia,Cambodia,1956,9,2,11
Argentina,Brazil,1956,2,2,4
France,Austria,1956,3,1,4
Portugal,Turkey,1956,3,1,4
Guadeloupe,Curaçao,1956,1,2,3
Martinique,Curaçao,1956,0,1,1
Belgium,Netherlands,1956,0,1,1
Portugal,Brazil,1956,0,1,1
Switzerland,Brazil,1956,1,1,2
Wales,Northern Ireland,1956,1,1,2
Scotland,England,1956,1,1,2
Austria,Brazil,1956,2,3,5
Czechoslovakia,Brazil,1956,0,0,0
South Korea,Philippines,1956,3,0,3
Yugoslavia,Romania,1956,0,1,1
Cambodia,Malaysia,1956,3,2,5
Italy,Brazil,1956,3,0,3
Martinique,Guadeloupe,1956,3,0,3
Hungary,Yugoslavia,1956,2,2,4
Saarland,Switzerland,1956,1,1,2
Turkey,Brazil,1956,0,1,1
Scotland,Austria,1956,1,1,2
Vietnam Republic,Malaysia,1956,4,0,4
England,Brazil,1956,4,2,6
Netherlands,Republic of Ireland,1956,1,4,5
Switzerland,Czechoslovakia,1956,1,6,7
Sweden,England,1956,0,0,0
Finland,England,1956,1,5,6
Guadeloupe,Martinique,1956,2,2,4
Hungary,Czechoslovakia,1956,2,4,6
Russia,Denmark,1956,5,1,6
Malaysia,Vietnam Republic,1956,3,3,6
Germany,England,1956,1,3,4
Norway,Poland,1956,0,0,0
Belgium,Hungary,1956,5,4,9
Portugal,Spain,1956,3,1,4
Netherlands,Saarland,1956,3,2,5
Portugal,Hungary,1956,2,2,4
Finland,Sweden,1956,1,3,4
Paraguay,Brazil,1956,0,2,2
Norway,Germany,1956,1,3,4
India,China PR,1956,0,1,1
Paraguay,Brazil,1956,2,5,7
Romania,Sweden,1956,0,2,2
Yugoslavia,Austria,1956,1,1,2
Argentina,Italy,1956,1,0,1
Brazil,Uruguay,1956,2,0,2
Denmark,Norway,1956,2,3,5
Myanmar,China PR,1956,2,3,5
Romania,Norway,1956,2,0,2
Finland,Iceland,1956,2,1,3
Mauritius,Réunion,1956,8,3,11
Sweden,Germany,1956,2,2,4
Brazil,Italy,1956,2,0,2
Denmark,Russia,1956,2,5,7
Uruguay,Argentina,1956,1,2,3
Madagascar,Réunion,1956,4,2,6
Argentina,Brazil,1956,0,0,0
Madagascar,Mauritius,1956,3,3,6
Hungary,Poland,1956,4,1,5
Paraguay,Uruguay,1956,2,2,4
Poland,German DR,1956,0,2,2
Belarus,Kyrgyzstan,1956,1,0,1
Estonia,Lithuania,1956,0,1,1
Brazil,Czechoslovakia,1956,0,1,1
Russia,Lithuania,1956,2,0,2
Brazil,Czechoslovakia,1956,4,1,5
Russia,Belarus,1956,5,1,6
Yugoslavia,China PR,1956,4,0,4
Estonia,Lithuania,1956,0,2,2
Russia,Belarus,1956,4,2,6
Lithuania,Moldova,1956,1,4,5
Uruguay,Czechoslovakia,1956,2,1,3
Paraguay,Argentina,1956,0,1,1
Argentina,Czechoslovakia,1956,1,0,1
Chile,Czechoslovakia,1956,3,0,3
South Korea,Taiwan,1956,2,0,2
Norway,Finland,1956,1,1,2
Poland,Bulgaria,1956,1,2,3
Hong Kong,Israel,1956,2,3,5
Hong Kong,South Korea,1956,2,2,4
Israel,South Korea,1956,1,2,3
Hong Kong,Vietnam Republic,1956,2,2,4
Yugoslavia,Indonesia,1956,4,2,6
Bulgaria,Romania,1956,2,0,2
Croatia,Indonesia,1956,5,2,7
Israel,Vietnam Republic,1956,2,1,3
Singapore,Pakistan,1956,1,1,2
Germany,Russia,1956,1,2,3
South Korea,Vietnam Republic,1956,5,3,8
Switzerland,Netherlands,1956,2,3,5
Finland,Denmark,1956,0,4,4
Norway,Sweden,1956,3,1,4
Yugoslavia,Hungary,1956,1,3,4
Hong Kong,South Korea,1956,2,4,6
German DR,Indonesia,1956,3,1,4
Russia,Hungary,1956,0,1,1
Guyana,Suriname,1956,1,1,2
Guyana,Suriname,1956,2,1,3
Austria,Luxembourg,1956,7,0,7
Guyana,Suriname,1956,1,2,3
Yugoslavia,Czechoslovakia,1956,1,2,3
Republic of Ireland,Denmark,1956,2,1,3
China PR,North Vietnam,1956,5,3,8
Nigeria,Togo,1956,1,1,2
Northern Ireland,England,1956,1,1,2
China PR,North Korea,1956,0,1,1
France,Hungary,1956,1,2,3
North Korea,North Vietnam,1956,3,0,3
Uruguay,Argentina,1956,1,2,3
Austria,Hungary,1956,0,2,2
Belgium,Netherlands,1956,2,3,5
Bulgaria,German DR,1956,3,1,4
Vietnam Republic,Thailand,1956,2,1,3
Togo,Ghana,1956,1,1,2
Wales,Scotland,1956,2,2,4
France,Russia,1956,2,1,3
Sweden,Denmark,1956,1,1,2
Vietnam Republic,Thailand,1956,3,1,4
Nigeria,Ghana,1956,3,0,3
Poland,Norway,1956,5,3,8
South Korea,United States,1956,1,0,1
Denmark,Netherlands,1956,2,2,4
Poland,Finland,1956,5,0,5
Scotland,Northern Ireland,1956,1,0,1
Philippines,United States,1956,0,4,4
Sierra Leone,Gambia,1956,1,0,1
France,Belgium,1956,6,3,9
Switzerland,Italy,1956,1,1,2
Argentina,Uruguay,1956,2,2,4
England,Wales,1956,3,1,4
Ethiopia,Sudan,1956,2,1,3
Indonesia,United States,1956,7,5,12
Turkey,Poland,1956,1,1,2
Germany,Switzerland,1956,1,3,4
Scotland,Yugoslavia,1956,2,0,2
Czechoslovakia,Turkey,1956,1,1,2
Republic of Ireland,Germany,1956,3,0,3
Tanzania,Kenya,1956,0,9,9
England,Yugoslavia,1956,3,0,3
Uganda,Zanzibar,1956,5,2,7
Tanzania,Zanzibar,1956,2,3,5
Uganda,Kenya,1956,3,2,5
England,Denmark,1956,5,2,7
Italy,Austria,1956,2,1,3
Australia,India,1956,1,7,8
Singapore,Bulgaria,1956,2,10,12
Ghana,Sierra Leone,1956,4,3,7
Germany,Belgium,1956,4,1,5
Indonesia,Yugoslavia,1956,1,5,6
India,Yugoslavia,1956,0,3,3
Portugal,Northern Ireland,1957,1,1,2
Jamaica,Trinidad and Tobago,1957,2,0,2
Jamaica,Trinidad and Tobago,1957,1,0,1
Jamaica,Trinidad and Tobago,1957,2,1,3
Spain,Netherlands,1957,5,1,6
Singapore,India,1957,2,3,5
Guatemala,Costa Rica,1957,2,6,8
Sudan,Egypt,1957,1,2,3
Egypt,Ethiopia,1957,4,0,4
Malaysia,India,1957,2,3,5
Costa Rica,Guatemala,1957,3,1,4
Sudan,Egypt,1957,3,4,7
Malta,Austria,1957,2,3,5
Costa Rica,Curaçao,1957,4,0,4
Ecuador,Uruguay,1957,2,5,7
Sudan,Syria,1957,1,0,1
Austria,Germany,1957,2,3,5
German DR,Luxembourg,1957,3,0,3
Guatemala,Curaçao,1957,1,3,4
Peru,Ecuador,1957,2,1,3
Spain,Switzerland,1957,2,2,4
Argentina,Colombia,1957,8,2,10
Brazil,Chile,1957,4,2,6
Peru,Chile,1957,1,0,1
Argentina,Ecuador,1957,3,0,3
Colombia,Uruguay,1957,1,0,1
Argentina,Uruguay,1957,4,0,4
Netherlands,Luxembourg,1957,4,1,5
Brazil,Ecuador,1957,7,1,8
Chile,Colombia,1957,3,2,5
Peru,Uruguay,1957,3,5,8
Brazil,Colombia,1957,9,0,9
Chile,Ecuador,1957,2,2,4
Peru,Colombia,1957,4,1,5
Argentina,Chile,1957,6,2,8
Brazil,Uruguay,1957,2,3,5
Belgium,Spain,1957,0,5,5
Peru,Brazil,1957,0,1,1
Chile,Uruguay,1957,0,2,2
Colombia,Ecuador,1957,4,1,5
Argentina,Brazil,1957,3,0,3
Netherlands,Germany,1957,1,2,3
England,Scotland,1957,2,1,3
Peru,Argentina,1957,2,1,3
Mexico,United States,1957,6,0,6
Peru,Argentina,1957,1,4,5
Northern Ireland,Wales,1957,0,0,0
Peru,Brazil,1957,1,1,2
Austria,Switzerland,1957,4,0,4
Mauritius,Réunion,1957,1,0,1
Martinique,Guadeloupe,1957,6,1,7
Brazil,Peru,1957,1,0,1
Italy,Northern Ireland,1957,1,0,1
Netherlands,Belgium,1957,1,1,2
United States,Mexico,1957,2,7,9
Northern Ireland,Portugal,1957,3,0,3
Wales,Czechoslovakia,1957,1,0,1
Austria,Sweden,1957,1,0,1
Greece,Yugoslavia,1957,0,0,0
England,Republic of Ireland,1957,5,1,6
Scotland,Spain,1957,4,2,6
Indonesia,China PR,1957,2,0,2
Yugoslavia,Italy,1957,6,1,7
Denmark,England,1957,1,4,5
Guadeloupe,Martinique,1957,5,2,7
Czechoslovakia,Yugoslavia,1957,1,0,1
German DR,Wales,1957,2,1,3
Republic of Ireland,England,1957,1,1,2
Poland,Turkey,1957,0,1,1
Switzerland,Scotland,1957,1,2,3
Germany,Scotland,1957,1,3,4
Norway,Bulgaria,1957,1,2,3
Uruguay,Argentina,1957,0,0,0
Syria,Sudan,1957,1,1,2
Austria,Netherlands,1957,3,2,5
Belgium,Romania,1957,1,0,1
Czechoslovakia,Wales,1957,2,0,2
Denmark,Bulgaria,1957,1,1,2
Portugal,Italy,1957,3,0,3
Spain,Scotland,1957,4,1,5
Russia,Romania,1957,1,1,2
China PR,Indonesia,1957,4,3,7
France,Iceland,1957,8,0,8
Tunisia,Libya,1957,4,2,6
Argentina,Uruguay,1957,1,1,2
Belgium,Iceland,1957,8,3,11
Paraguay,Bolivia,1957,5,2,7
Brazil,Portugal,1957,2,1,3
Norway,Hungary,1957,2,1,3
Paraguay,Bolivia,1957,0,1,1
Brazil,Portugal,1957,3,0,3
Colombia,Uruguay,1957,1,1,2
Czechoslovakia,German DR,1957,3,1,4
Greece,Romania,1957,1,2,3
Sweden,Hungary,1957,0,0,0
Finland,Denmark,1957,2,0,2
Norway,Sweden,1957,0,0,0
Denmark,Norway,1957,2,0,2
Finland,Sweden,1957,1,5,6
Colombia,Paraguay,1957,2,3,5
Canada,United States,1957,5,1,6
China PR,Indonesia,1957,0,0,0
Colombia,Paraguay,1957,1,2,3
Hungary,Bulgaria,1957,4,1,5
Russia,Poland,1957,3,0,3
Myanmar,China PR,1957,2,1,3
Denmark,Sweden,1957,1,2,3
Mexico,Canada,1957,3,0,3
Uruguay,Colombia,1957,1,0,1
Mexico,Canada,1957,2,0,2
Finland,Poland,1957,1,3,4
United States,Canada,1957,2,3,5
Brazil,Argentina,1957,1,2,3
Paraguay,Colombia,1957,3,0,3
Iceland,Norway,1957,0,3,3
Brazil,Argentina,1957,2,0,2
Iceland,Denmark,1957,2,6,8
Denmark,Norway,1957,1,3,4
Paraguay,Uruguay,1957,5,0,5
Bulgaria,Russia,1957,0,4,4
China PR,Sudan,1957,4,1,5
Russia,Finland,1957,2,1,3
Uruguay,Paraguay,1957,2,0,2
Curaçao,Costa Rica,1957,1,2,3
Curaçao,Haiti,1957,1,3,4
Cuba,Panama,1957,0,1,1
Finland,Russia,1957,0,10,10
Bolivia,Paraguay,1957,3,3,6
Curaçao,Cuba,1957,2,0,2
Bolivia,Paraguay,1957,2,1,3
Cuba,Honduras,1957,0,2,2
Curaçao,Panama,1957,3,0,3
Cuba,Haiti,1957,1,6,7
Sierra Leone,Ghana,1957,2,3,5
Curaçao,Honduras,1957,1,1,2
Aruba,Panama,1957,2,2,4
Malawi,Zambia,1957,0,5,5
Indonesia,Thailand,1957,4,0,4
Singapore,Vietnam Republic,1957,5,5,10
Cambodia,Thailand,1957,0,3,3
Finland,Norway,1957,0,4,4
Iceland,France,1957,1,5,6
Malaysia,Myanmar,1957,5,2,7
Singapore,Vietnam Republic,1957,1,2,3
Myanmar,Cambodia,1957,2,0,2
Malaysia,Vietnam Republic,1957,1,4,5
Singapore,Thailand,1957,6,0,6
Tanzania,Uganda,1957,2,4,6
Iceland,Belgium,1957,2,5,7
Zanzibar,Kenya,1957,1,5,6
Myanmar,Thailand,1957,5,2,7
Cambodia,Singapore,1957,1,1,2
Indonesia,Vietnam Republic,1957,3,1,4
Zanzibar,Tanzania,1957,3,3,6
Myanmar,Singapore,1957,2,3,5
Malaysia,Indonesia,1957,4,2,6
Kenya,Uganda,1957,1,2,3
Tahiti,Vanuatu,1957,2,1,3
Singapore,Myanmar,1957,2,1,3
Netherlands,Luxembourg,1957,5,2,7
Bulgaria,Hungary,1957,1,2,3
Chile,Brazil,1957,1,0,1
China PR,Albania,1957,3,2,5
New Caledonia,Tahiti,1957,2,4,6
Yugoslavia,Austria,1957,3,3,6
Chile,Brazil,1957,1,1,2
New Caledonia,Tahiti,1957,2,1,3
Chile,Bolivia,1957,2,1,3
Hungary,Russia,1957,1,2,3
Norway,Denmark,1957,2,2,4
Sweden,Finland,1957,5,1,6
Netherlands,Austria,1957,1,1,2
Wales,German DR,1957,4,1,5
New Caledonia,Tahiti,1957,2,0,2
Bolivia,Chile,1957,3,0,3
Bulgaria,Poland,1957,1,1,2
Luxembourg,Austria,1957,0,3,3
Romania,Yugoslavia,1957,1,1,2
Denmark,Republic of Ireland,1957,0,2,2
Northern Ireland,Scotland,1957,1,1,2
Bolivia,Argentina,1957,2,0,2
Hungary,France,1957,2,0,2
Austria,Czechoslovakia,1957,2,2,4
Chile,Argentina,1957,0,2,2
Denmark,Finland,1957,3,0,3
Sweden,Norway,1957,5,2,7
Wales,England,1957,0,4,4
Argentina,Chile,1957,4,0,4
Madagascar,Réunion,1957,0,1,1
Mexico,Costa Rica,1957,2,0,2
Poland,Russia,1957,2,1,3
Mauritius,Madagascar,1957,4,0,4
Argentina,Bolivia,1957,4,0,4
Belgium,France,1957,0,0,0
Costa Rica,Mexico,1957,1,1,2
German DR,Czechoslovakia,1957,1,4,5
Ghana,Nigeria,1957,3,3,6
Mauritius,Réunion,1957,1,0,1
Cambodia,Malaysia,1957,1,3,4
Bulgaria,Norway,1957,7,0,7
Poland,Finland,1957,4,0,4
Romania,Greece,1957,3,0,3
England,Northern Ireland,1957,2,3,5
Scotland,Switzerland,1957,3,2,5
Hungary,Norway,1957,5,0,5
Yugoslavia,Greece,1957,4,1,5
Scotland,Wales,1957,1,1,2
Netherlands,Belgium,1957,5,2,7
Yugoslavia,Romania,1957,2,0,2
Germany,Sweden,1957,1,0,1
Poland,Russia,1957,0,2,2
Switzerland,Spain,1957,1,4,5
England,France,1957,4,0,4
Northern Ireland,Italy,1957,2,2,4
Turkey,Belgium,1957,1,1,2
Egypt,Czechoslovakia,1957,1,2,3
Germany,Hungary,1957,1,0,1
Italy,Portugal,1957,3,0,3
France,Bulgaria,1957,2,2,4
Israel,Wales,1958,0,2,2
Northern Ireland,Italy,1958,2,1,3
Malta,Denmark,1958,3,0,3
Wales,Israel,1958,2,0,2
Hong Kong,South Korea,1958,3,2,5
Ghana,Togo,1958,5,2,7
Hong Kong,South Korea,1958,1,1,2
Malaysia,Singapore,1958,5,2,7
Belgium,Germany,1958,0,2,2
Malaysia,Singapore,1958,3,1,4
France,Spain,1958,2,2,4
Germany,Spain,1958,2,0,2
Austria,Italy,1958,3,2,5
Czechoslovakia,Germany,1958,3,2,5
Morocco,Libya,1958,3,1,4
Uruguay,Argentina,1958,1,0,1
Belgium,Netherlands,1958,2,7,9
Spain,Portugal,1958,1,0,1
Martinique,Guadeloupe,1958,1,1,2
France,Switzerland,1958,0,0,0
Wales,Northern Ireland,1958,1,1,2
Scotland,England,1958,0,4,4
Hungary,Yugoslavia,1958,2,0,2
Paraguay,Argentina,1958,1,0,1
Zimbabwe,Zambia,1958,0,2,2
Netherlands,Curaçao,1958,8,1,9
Argentina,Paraguay,1958,2,0,2
Argentina,Uruguay,1958,2,0,2
Singapore,Malaysia,1958,3,3,6
Albania,German DR,1958,1,1,2
Brazil,Paraguay,1958,5,1,6
Netherlands,Turkey,1958,1,2,3
Singapore,Malaysia,1958,0,3,3
Trinidad and Tobago,Jamaica,1958,1,0,1
Brazil,Paraguay,1958,0,0,0
England,Portugal,1958,2,1,3
Scotland,Hungary,1958,1,1,2
Sweden,Switzerland,1958,3,2,5
Philippines,Indonesia,1958,1,2,3
Tunisia,Libya,1958,4,1,5
Poland,Republic of Ireland,1958,2,2,4
Trinidad and Tobago,Jamaica,1958,4,0,4
Yugoslavia,England,1958,5,0,5
Philippines,Indonesia,1958,0,3,3
Trinidad and Tobago,Jamaica,1958,0,1,1
Austria,Republic of Ireland,1958,3,1,4
Brazil,Bulgaria,1958,4,0,4
Hong Kong,Taiwan,1958,2,1,3
Malaysia,Pakistan,1958,4,2,6
Denmark,Curaçao,1958,3,2,5
Singapore,Pakistan,1958,4,4,8
Brazil,Bulgaria,1958,3,1,4
Russia,England,1958,1,1,2
Denmark,Poland,1958,3,2,5
Switzerland,Belgium,1958,0,2,2
Norway,Netherlands,1958,0,0,0
Poland,Scotland,1958,1,2,3
Hong Kong,Malaysia,1958,2,2,4
Argentina,Germany,1958,1,3,4
Austria,Brazil,1958,0,3,3
Czechoslovakia,Northern Ireland,1958,0,1,1
England,Russia,1958,2,2,4
France,Paraguay,1958,7,3,10
Hungary,Wales,1958,1,1,2
Scotland,Yugoslavia,1958,1,1,2
Sweden,Mexico,1958,3,0,3
Argentina,Northern Ireland,1958,3,1,4
Austria,Russia,1958,0,2,2
Brazil,England,1958,0,0,0
Czechoslovakia,Germany,1958,2,2,4
France,Yugoslavia,1958,2,3,5
Mexico,Wales,1958,1,1,2
Paraguay,Scotland,1958,3,2,5
Sweden,Hungary,1958,2,1,3
Argentina,Czechoslovakia,1958,1,6,7
Austria,England,1958,2,2,4
Brazil,Russia,1958,2,0,2
France,Scotland,1958,2,1,3
Germany,Northern Ireland,1958,2,2,4
Hungary,Mexico,1958,4,0,4
Norway,Finland,1958,2,0,2
Paraguay,Yugoslavia,1958,3,3,6
Sweden,Wales,1958,0,0,0
Czechoslovakia,Northern Ireland,1958,1,2,3
England,Russia,1958,0,1,1
Hungary,Wales,1958,1,2,3
Brazil,Wales,1958,1,0,1
France,Northern Ireland,1958,4,0,4
Germany,Yugoslavia,1958,1,0,1
Sweden,Russia,1958,2,0,2
Brazil,France,1958,5,2,7
Sweden,Germany,1958,3,1,4
France,Germany,1958,6,3,9
German DR,Poland,1958,1,1,2
Denmark,Norway,1958,1,2,3
Sweden,Brazil,1958,2,5,7
Singapore,Indonesia,1958,0,5,5
Malaysia,Indonesia,1958,2,4,6
Norway,German DR,1958,6,5,11
New Zealand,Australia,1958,2,3,5
Finland,Sweden,1958,1,7,8
New Zealand,Australia,1958,2,2,4
Czechoslovakia,Russia,1958,1,2,3
Singapore,Vietnam Republic,1958,4,4,8
Malaysia,Indonesia,1958,3,2,5
Indonesia,Singapore,1958,2,0,2
New Caledonia,New Zealand,1958,1,2,3
Indonesia,Vietnam Republic,1958,4,1,5
Malaysia,Singapore,1958,0,0,0
Malaysia,Vietnam Republic,1958,2,0,2
New Caledonia,New Zealand,1958,1,5,6
Zimbabwe,Zambia,1958,4,2,6
Austria,Yugoslavia,1958,3,4,7
Finland,Denmark,1958,1,4,5
German DR,Romania,1958,3,2,5
New Caledonia,New Zealand,1958,1,2,3
Norway,Sweden,1958,0,2,2
Poland,Hungary,1958,1,3,4
Czechoslovakia,Switzerland,1958,2,1,3
Denmark,Germany,1958,1,1,2
Belgium,Netherlands,1958,2,3,5
Russia,Hungary,1958,3,1,4
France,Greece,1958,7,1,8
Northern Ireland,England,1958,3,3,6
Uganda,Zanzibar,1958,1,1,2
Austria,France,1958,1,2,3
German DR,Bulgaria,1958,1,1,2
Republic of Ireland,Poland,1958,2,2,4
Kenya,Tanzania,1958,3,1,4
Yugoslavia,Hungary,1958,4,4,8
Uganda,Tanzania,1958,2,0,2
Kenya,Zanzibar,1958,4,0,4
Tanzania,Zanzibar,1958,3,2,5
Kenya,Uganda,1958,2,0,2
Czechoslovakia,Bulgaria,1958,0,1,1
Netherlands,Denmark,1958,5,1,6
Spain,Northern Ireland,1958,6,2,8
Réunion,Mauritius,1958,0,2,2
Wales,Scotland,1958,0,3,3
Réunion,Madagascar,1958,1,3,4
England,Russia,1958,5,0,5
Madagascar,Mauritius,1958,3,2,5
Nigeria,Ghana,1958,3,2,5
Belgium,Turkey,1958,1,1,2
France,Germany,1958,2,2,4
Romania,Hungary,1958,1,2,3
Sweden,Denmark,1958,4,4,8
German DR,Norway,1958,4,1,5
Netherlands,Switzerland,1958,2,0,2
Romania,Turkey,1958,3,0,3
Scotland,Northern Ireland,1958,2,2,4
France,Italy,1958,2,2,4
Netherlands,South Africa,1958,9,3,12
Germany,Austria,1958,2,2,4
Hungary,Belgium,1958,3,1,4
England,Wales,1958,2,2,4
Greece,France,1958,1,1,2
Turkey,Bulgaria,1958,0,0,0
Italy,Czechoslovakia,1958,1,1,2
Turkey,Czechoslovakia,1958,1,0,1
Germany,Bulgaria,1958,3,0,3
Hong Kong,Japan,1958,5,2,7
Egypt,Germany,1958,2,1,3
Malaysia,Japan,1958,6,2,8
Malaysia,Japan,1959,1,3,4
Singapore,Japan,1959,3,4,7
Singapore,Japan,1959,3,2,5
Indonesia,German DR,1959,2,2,4
Italy,Spain,1959,1,1,2
France,Belgium,1959,2,2,4
Guyana,Jamaica,1959,2,2,4
Mexico,Costa Rica,1959,3,1,4
Trinidad and Tobago,Barbados,1959,2,0,2
Barbados,Jamaica,1959,1,3,4
Trinidad and Tobago,Guyana,1959,2,1,3
Argentina,Chile,1959,6,1,7
Bolivia,Uruguay,1959,0,7,7
Costa Rica,Mexico,1959,1,2,3
Tunisia,Malta,1959,0,0,0
Barbados,Guyana,1959,2,1,3
Brazil,Peru,1959,2,2,4
Trinidad and Tobago,Jamaica,1959,2,1,3
Argentina,Bolivia,1959,2,0,2
Chile,Paraguay,1959,1,2,3
Martinique,Guadeloupe,1959,3,0,3
Peru,Uruguay,1959,5,3,8
Bolivia,Paraguay,1959,0,5,5
Brazil,Chile,1959,3,0,3
Argentina,Peru,1959,3,1,4
Paraguay,Uruguay,1959,1,3,4
Bolivia,Brazil,1959,2,4,6
Chile,Peru,1959,1,1,2
Argentina,Paraguay,1959,3,1,4
Bolivia,Chile,1959,2,5,7
Brazil,Uruguay,1959,3,1,4
Bolivia,Peru,1959,0,0,0
Brazil,Paraguay,1959,4,1,5
Philippines,Hong Kong,1959,0,7,7
Argentina,Uruguay,1959,4,1,5
Philippines,Taiwan,1959,4,7,11
Chile,Uruguay,1959,1,0,1
Paraguay,Peru,1959,2,1,3
Argentina,Brazil,1959,1,1,2
Republic of Ireland,Czechoslovakia,1959,2,0,2
England,Scotland,1959,1,0,1
Kenya,Réunion,1959,1,0,1
Hungary,Yugoslavia,1959,4,0,4
Netherlands,Belgium,1959,2,2,4
Northern Ireland,Wales,1959,4,1,5
Switzerland,Yugoslavia,1959,1,5,6
Turkey,Romania,1959,2,0,2
German DR,Hungary,1959,0,1,1
Uruguay,Paraguay,1959,1,3,4
England,Italy,1959,2,2,4
Scotland,Germany,1959,3,2,5
Singapore,Vietnam Republic,1959,1,4,5
Czechoslovakia,Republic of Ireland,1959,4,0,4
Turkey,Netherlands,1959,0,0,0
Singapore,Malaysia,1959,2,5,7
Brazil,England,1959,2,0,2
Bulgaria,Netherlands,1959,3,2,5
Malaysia,Vietnam Republic,1959,0,1,1
Switzerland,Portugal,1959,4,3,7
Peru,England,1959,4,1,5
Germany,Poland,1959,1,1,2
Norway,Austria,1959,0,1,1
Martinique,Guadeloupe,1959,1,2,3
Sweden,Portugal,1959,2,0,2
Egypt,Ethiopia,1959,4,0,4
Belgium,Austria,1959,0,2,2
Mexico,England,1959,2,1,3
Ethiopia,Sudan,1959,0,1,1
Netherlands,Scotland,1959,1,2,3
United States,England,1959,1,8,9
Egypt,Sudan,1959,2,1,3
Martinique,Suriname,1959,3,1,4
Martinique,Suriname,1959,3,0,3
Yugoslavia,Bulgaria,1959,2,0,2
Portugal,Scotland,1959,1,0,1
Guadeloupe,Suriname,1959,3,3,6
Guadeloupe,Suriname,1959,3,1,4
Austria,Belgium,1959,4,2,6
Norway,Luxembourg,1959,1,0,1
Denmark,Sweden,1959,0,6,6
German DR,Portugal,1959,0,2,2
Poland,Israel,1959,7,2,9
Finland,Norway,1959,2,4,6
Hungary,Sweden,1959,3,2,5
Poland,Spain,1959,2,4,6
Portugal,German DR,1959,3,2,5
Tahiti,New Caledonia,1959,2,4,6
Tahiti,New Caledonia,1959,3,1,4
Sweden,Finland,1959,3,1,4
German DR,Czechoslovakia,1959,2,1,3
Hong Kong,Taiwan,1959,1,3,4
South Korea,Vietnam Republic,1959,2,3,5
Poland,Romania,1959,2,3,5
India,Singapore,1959,2,0,2
South Korea,Singapore,1959,4,1,5
Malaysia,Vietnam Republic,1959,4,3,7
Japan,Singapore,1959,4,1,5
Malaysia,India,1959,1,1,2
Japan,South Korea,1959,0,0,0
Finland,German DR,1959,3,2,5
India,Vietnam Republic,1959,2,2,4
Japan,South Korea,1959,1,3,4
Russia,Czechoslovakia,1959,3,1,4
Malaysia,South Korea,1959,2,4,6
India,South Korea,1959,1,1,2
Hong Kong,South Korea,1959,2,3,5
India,Vietnam Republic,1959,1,5,6
Singapore,India,1959,2,3,5
Singapore,South Korea,1959,0,4,4
Brazil,Chile,1959,7,0,7
Brazil,Chile,1959,1,0,1
Suriname,Martinique,1959,1,0,1
Austria,Norway,1959,5,2,7
Denmark,Czechoslovakia,1959,2,2,4
Suriname,Martinique,1959,4,1,5
Hungary,Russia,1959,0,1,1
China PR,Russia,1959,0,1,1
Northern Ireland,Scotland,1959,0,4,4
Tanzania,Zanzibar,1959,2,2,4
Denmark,Finland,1959,4,0,4
Kenya,Uganda,1959,0,0,0
Netherlands,Belgium,1959,9,1,10
Switzerland,Germany,1959,0,4,4
Tanzania,Uganda,1959,2,2,4
Kenya,Zanzibar,1959,5,0,5
Zanzibar,Uganda,1959,1,0,1
Tanzania,Kenya,1959,0,2,2
Bulgaria,France,1959,1,0,1
Yugoslavia,Hungary,1959,2,4,6
Spain,Poland,1959,3,0,3
Wales,England,1959,1,1,2
Czechoslovakia,Denmark,1959,5,1,6
Sweden,Norway,1959,6,2,8
Germany,Netherlands,1959,7,0,7
North Korea,North Vietnam,1959,5,0,5
Bulgaria,Yugoslavia,1959,1,1,2
Hungary,Switzerland,1959,8,0,8
North Korea,China PR,1959,1,0,1
China PR,North Vietnam,1959,2,0,2
England,Sweden,1959,2,3,5
Czechoslovakia,Italy,1959,2,1,3
Republic of Ireland,Sweden,1959,3,2,5
Netherlands,Norway,1959,7,1,8
Benin,Nigeria,1959,0,1,1
Hungary,Germany,1959,4,3,7
France,Portugal,1959,5,3,8
Chile,Argentina,1959,4,2,6
England,Northern Ireland,1959,2,1,3
Ghana,Nigeria,1959,5,2,7
Spain,Austria,1959,6,3,9
Nigeria,Benin,1959,10,1,11
Israel,Poland,1959,1,1,2
Italy,Hungary,1959,1,1,2
Greece,Denmark,1959,1,3,4
Brazil,Paraguay,1959,3,2,5
Iran,Israel,1959,3,0,3
Bulgaria,Denmark,1959,2,1,3
Ecuador,Uruguay,1959,0,4,4
India,Pakistan,1959,1,0,1
India,Israel,1959,1,3,4
Argentina,Paraguay,1959,4,2,6
Israel,Pakistan,1959,2,0,2
Brazil,Uruguay,1959,0,3,3
Ecuador,Argentina,1959,1,1,2
Israel,Iran,1959,1,1,2
El Salvador,Honduras,1959,1,0,1
France,Austria,1959,5,2,7
Costa Rica,Honduras,1959,6,1,7
Argentina,Uruguay,1959,0,5,5
France,Spain,1959,4,3,7
Pakistan,Israel,1959,2,2,4
Ecuador,Brazil,1959,1,3,4
Gambia,Cape Verde,1959,3,2,5
Germany,Yugoslavia,1959,1,1,2
Argentina,Brazil,1959,4,1,5
Paraguay,Uruguay,1959,1,1,2
Ecuador,Paraguay,1959,3,1,4
Ecuador,Brazil,1959,1,2,3
Morocco,Yugoslavia,1960,0,5,5
Tunisia,Yugoslavia,1960,1,5,6
Italy,Switzerland,1960,3,0,3
Egypt,Yugoslavia,1960,0,1,1
Guinea-Bissau,Gambia,1960,3,2,5
Guinea-Bissau,Sierra Leone,1960,3,4,7
Ghana,Sierra Leone,1960,6,2,8
Costa Rica,Curaçao,1960,1,1,2
Honduras,Curaçao,1960,3,3,6
Martinique,Guadeloupe,1960,2,2,4
Cuba,Curaçao,1960,3,4,7
Curaçao,Suriname,1960,1,0,1
Belgium,France,1960,1,0,1
Costa Rica,Curaçao,1960,4,0,4
Brazil,Mexico,1960,2,2,4
Costa Rica,Argentina,1960,0,0,0
Argentina,Mexico,1960,3,2,5
Costa Rica,Brazil,1960,3,0,3
Argentina,Brazil,1960,2,1,3
Spain,Italy,1960,3,1,4
Brazil,Mexico,1960,2,1,3
Costa Rica,Argentina,1960,0,2,2
France,Chile,1960,6,0,6
Argentina,Mexico,1960,2,0,2
Costa Rica,Brazil,1960,0,4,4
Argentina,Brazil,1960,0,1,1
Germany,Chile,1960,2,1,3
Austria,France,1960,2,4,6
Belgium,Switzerland,1960,3,1,4
Republic of Ireland,Chile,1960,2,0,2
Netherlands,Bulgaria,1960,4,2,6
Switzerland,Chile,1960,4,2,6
Wales,Northern Ireland,1960,3,2,5
Scotland,England,1960,1,1,2
Belgium,Chile,1960,1,1,2
Cameroon,Djibouti,1960,9,2,11
Central African Republic,Mali,1960,3,4,7
Gabon,Burkina Faso,1960,4,5,9
Ivory Coast,Benin,1960,3,2,5
Cameroon,Mali,1960,3,2,5
Congo,Ivory Coast,1960,3,2,5
Madagascar,Burkina Faso,1960,6,1,7
Congo,Cameroon,1960,4,5,9
Indonesia,Malaysia,1960,5,0,5
Belgium,Netherlands,1960,2,1,3
Togo,Nigeria,1960,1,1,2
Cameroon,Nigeria,1960,0,0,0
Germany,Portugal,1960,2,1,3
Egypt,Brazil,1960,0,5,5
Czechoslovakia,Austria,1960,4,0,4
Egypt,Brazil,1960,1,3,4
Togo,Ghana,1960,2,3,5
Scotland,Poland,1960,2,3,5
Singapore,India,1960,3,0,3
Egypt,Brazil,1960,0,3,3
Malaysia,India,1960,0,0,0
Portugal,Yugoslavia,1960,2,1,3
Denmark,Brazil,1960,3,4,7
England,Yugoslavia,1960,3,3,6
Germany,Republic of Ireland,1960,0,1,1
Spain,England,1960,3,0,3
Sweden,Republic of Ireland,1960,4,1,5
Switzerland,Netherlands,1960,3,1,4
Russia,Poland,1960,7,1,8
Bulgaria,Belgium,1960,4,1,5
Hungary,England,1960,2,0,2
Romania,Czechoslovakia,1960,0,2,2
Yugoslavia,Portugal,1960,5,1,6
Argentina,Brazil,1960,4,2,6
Denmark,Norway,1960,3,0,3
Argentina,Brazil,1960,1,4,5
Austria,Scotland,1960,4,1,5
Czechoslovakia,Romania,1960,3,0,3
Chile,Uruguay,1960,2,3,5
Mali,Nigeria,1960,3,2,5
Hungary,Scotland,1960,3,3,6
Tunisia,Iraq,1960,2,1,3
Uruguay,Chile,1960,2,2,4
Turkey,Scotland,1960,4,2,6
Norway,Iceland,1960,4,0,4
Martinique,Guadeloupe,1960,1,0,1
Finland,Sweden,1960,0,3,3
Norway,Austria,1960,1,2,3
Mexico,Netherlands,1960,3,1,4
Poland,Bulgaria,1960,4,0,4
Brazil,Chile,1960,4,0,4
Curaçao,Netherlands,1960,0,0,0
Denmark,Greece,1960,7,2,9
Ghana,Egypt,1960,2,2,4
Paraguay,Brazil,1960,1,2,3
Suriname,Netherlands,1960,3,4,7
Czechoslovakia,Russia,1960,0,3,3
France,Yugoslavia,1960,4,5,9
Argentina,Paraguay,1960,1,0,1
France,Czechoslovakia,1960,0,2,2
Uruguay,Brazil,1960,1,0,1
Bulgaria,German DR,1960,2,0,2
Mali,Sierra Leone,1960,1,0,1
Peru,Spain,1960,1,3,4
Russia,Yugoslavia,1960,2,1,3
Brazil,Argentina,1960,5,1,6
Uruguay,Paraguay,1960,2,1,3
Chile,Spain,1960,0,4,4
Chile,Spain,1960,1,4,5
Argentina,Spain,1960,2,0,2
Iceland,Germany,1960,0,5,5
Malaysia,Japan,1960,3,0,3
Pakistan,Thailand,1960,7,0,7
South Korea,Indonesia,1960,2,0,2
Yugoslavia,Tunisia,1960,7,0,7
Malaysia,Thailand,1960,8,2,10
Vietnam Republic,Singapore,1960,2,1,3
Indonesia,Singapore,1960,8,3,11
Denmark,Finland,1960,2,1,3
Vietnam Republic,South Korea,1960,0,0,0
Pakistan,Japan,1960,3,1,4
South Korea,Singapore,1960,3,3,6
Japan,Thailand,1960,3,1,4
Malaysia,Pakistan,1960,1,0,1
Indonesia,Vietnam Republic,1960,5,3,8
Indonesia,Pakistan,1960,4,0,4
Malaysia,South Korea,1960,0,0,0
Argentina,Uruguay,1960,4,0,4
German DR,Russia,1960,0,1,1
Indonesia,Vietnam Republic,1960,1,1,2
Pakistan,Vietnam Republic,1960,2,2,4
Singapore,Pakistan,1960,4,1,5
Costa Rica,Guatemala,1960,3,2,5
India,Tunisia,1960,2,2,4
Indonesia,Pakistan,1960,5,2,7
Ghana,Nigeria,1960,4,1,5
Guatemala,Costa Rica,1960,4,4,8
Norway,Finland,1960,6,3,9
Austria,Russia,1960,3,1,4
Honduras,Costa Rica,1960,2,1,3
Tahiti,New Zealand,1960,1,5,6
Nigeria,Ghana,1960,2,2,4
Costa Rica,Honduras,1960,5,0,5
Tahiti,New Zealand,1960,1,2,3
Norway,Sweden,1960,3,1,4
Trinidad and Tobago,Martinique,1960,1,1,2
Trinidad and Tobago,Martinique,1960,1,1,2
Trinidad and Tobago,Martinique,1960,3,1,4
Trinidad and Tobago,Martinique,1960,0,0,0
Finland,France,1960,1,2,3
Honduras,Guatemala,1960,1,1,2
Republic of Ireland,Wales,1960,2,3,5
Poland,France,1960,2,2,4
Belgium,Netherlands,1960,1,4,5
Ghana,Mali,1960,5,1,6
Nigeria,Guinea-Bissau,1960,4,1,5
Suriname,Curaçao,1960,1,2,3
North Vietnam,Mongolia,1960,3,1,4
China PR,North Korea,1960,1,0,1
Nigeria,Mali,1960,2,3,5
China PR,Mongolia,1960,6,1,7
North Vietnam,North Korea,1960,1,3,4
Northern Ireland,England,1960,2,5,7
Uganda,Tanzania,1960,1,0,1
Hungary,Yugoslavia,1960,1,1,2
Nigeria,Ghana,1960,0,3,3
Kenya,Zanzibar,1960,4,1,5
Mongolia,North Korea,1960,1,10,11
North Vietnam,China PR,1960,3,4,7
Uganda,Zanzibar,1960,3,0,3
Kenya,Tanzania,1960,5,0,5
Switzerland,France,1960,6,2,8
South Korea,Vietnam Republic,1960,5,1,6
Tanzania,Zanzibar,1960,4,2,6
Uganda,Kenya,1960,1,1,2
Taiwan,Vietnam Republic,1960,2,0,2
South Korea,Israel,1960,3,0,3
Israel,Vietnam Republic,1960,5,1,6
Luxembourg,England,1960,0,9,9
Sweden,Belgium,1960,2,0,2
South Korea,Taiwan,1960,1,0,1
Wales,Scotland,1960,2,0,2
Sweden,Denmark,1960,2,0,2
Israel,Taiwan,1960,1,0,1
England,Spain,1960,4,2,6
Northern Ireland,Germany,1960,3,4,7
Nigeria,Ghana,1960,1,1,2
Austria,Spain,1960,3,0,3
Belgium,Hungary,1960,2,1,3
Czechoslovakia,Netherlands,1960,4,0,4
German DR,Finland,1960,5,1,6
Morocco,Tunisia,1960,2,1,3
Sweden,France,1960,1,0,1
Republic of Ireland,Norway,1960,3,1,4
South Korea,Japan,1960,2,1,3
United States,Mexico,1960,3,3,6
Scotland,Northern Ireland,1960,5,2,7
Cyprus,Israel,1960,1,1,2
Hungary,Poland,1960,4,1,5
Mexico,United States,1960,3,0,3
Tunisia,Morocco,1960,2,1,3
Belgium,Switzerland,1960,2,4,6
Greece,Germany,1960,0,3,3
Hungary,Austria,1960,2,0,2
Bulgaria,Germany,1960,2,1,3
England,Wales,1960,5,1,6
Bulgaria,Turkey,1960,2,1,3
Curaçao,Suriname,1960,0,0,0
Israel,Cyprus,1960,6,1,7
Ecuador,Argentina,1960,3,6,9
Tunisia,German DR,1960,0,3,3
Malta,Tunisia,1960,1,0,1
Italy,Austria,1960,1,2,3
France,Bulgaria,1960,3,0,3
Morocco,German DR,1960,2,3,5
Argentina,Ecuador,1960,5,0,5
Chile,Paraguay,1960,4,1,5
Chile,Paraguay,1960,3,1,4
Iraq,Tunisia,1960,3,2,5
Costa Rica,Honduras,1961,1,0,1
Saint Lucia,Dominica,1961,4,1,5
Grenada,Saint Vincent and the Grenadines,1961,3,6,9
Saint Lucia,Grenada,1961,0,4,4
Dominica,Saint Vincent and the Grenadines,1961,1,1,2
Dominica,Grenada,1961,1,8,9
Saint Lucia,Saint Vincent and the Grenadines,1961,2,2,4
Colombia,United States,1961,2,0,2
Egypt,Hungary,1961,0,2,2
Morocco,Tunisia,1961,1,1,2
Costa Rica,Cuba,1961,4,1,5
Ghana,Mali,1961,3,0,3
Curaçao,El Salvador,1961,0,0,0
Cuba,Haiti,1961,1,2,3
Germany,Belgium,1961,1,0,1
Guatemala,Haiti,1961,1,3,4
Cuba,Panama,1961,0,1,1
Curaçao,Honduras,1961,2,4,6
Cuba,Guatemala,1961,0,2,2
Curaçao,Nicaragua,1961,2,1,3
Haiti,Panama,1961,3,1,4
Israel,Ethiopia,1961,1,0,1
France,Belgium,1961,1,1,2
Haiti,Honduras,1961,0,2,2
Chile,Peru,1961,5,2,7
Israel,Ethiopia,1961,3,2,5
Panama,Paraguay,1961,0,0,0
Portugal,Luxembourg,1961,6,0,6
Costa Rica,Mexico,1961,1,0,1
Netherlands,Belgium,1961,6,2,8
Panama,Haiti,1961,0,3,3
Panama,Haiti,1961,0,2,2
Chile,Germany,1961,3,1,4
Czechoslovakia,Sweden,1961,2,1,3
Costa Rica,Curaçao,1961,6,0,6
Ghana,Morocco,1961,0,0,0
Spain,France,1961,2,0,2
Mexico,Curaçao,1961,7,0,7
Nigeria,Ghana,1961,0,0,0
Martinique,Guadeloupe,1961,2,2,4
Mexico,Costa Rica,1961,4,1,5
Northern Ireland,Wales,1961,1,5,6
England,Scotland,1961,9,3,12
Hungary,German DR,1961,2,0,2
Netherlands,Mexico,1961,1,2,3
Wales,Spain,1961,1,2,3
Sierra Leone,Nigeria,1961,1,4,5
Curaçao,Costa Rica,1961,2,0,2
Italy,Northern Ireland,1961,3,2,5
Czechoslovakia,Mexico,1961,2,1,3
Colombia,Peru,1961,1,0,1
Ghana,Nigeria,1961,2,2,4
Netherlands,Hungary,1961,0,3,3
Paraguay,Brazil,1961,0,2,2
Greece,Northern Ireland,1961,2,1,3
Paraguay,Brazil,1961,2,3,5
Scotland,Republic of Ireland,1961,4,1,5
Chile,Brazil,1961,1,2,3
Republic of Ireland,Scotland,1961,0,3,3
Peru,Colombia,1961,1,1,2
Yugoslavia,Hungary,1961,2,4,6
England,Mexico,1961,8,0,8
Germany,Northern Ireland,1961,2,1,3
Chile,Brazil,1961,0,1,1
Czechoslovakia,Scotland,1961,4,0,4
German DR,Netherlands,1961,1,1,2
Turkey,Romania,1961,0,1,1
Norway,Mexico,1961,1,1,2
Paraguay,Argentina,1961,0,0,0
Spain,Wales,1961,1,1,2
Switzerland,Belgium,1961,2,1,3
Curaçao,Mexico,1961,0,0,0
Poland,Russia,1961,1,0,1
Portugal,England,1961,1,1,2
Italy,England,1961,2,3,5
Austria,England,1961,3,1,4
Denmark,German DR,1961,1,1,2
Hungary,Wales,1961,3,2,5
Japan,Malaysia,1961,3,2,5
Morocco,Ghana,1961,1,0,1
Sweden,Switzerland,1961,4,0,4
Ghana,Nigeria,1961,3,0,3
Norway,Turkey,1961,0,1,1
Portugal,Argentina,1961,0,2,2
Yugoslavia,Poland,1961,2,1,3
Hungary,Austria,1961,1,2,3
Japan,South Korea,1961,0,2,2
Spain,Argentina,1961,2,0,2
Italy,Argentina,1961,4,1,5
Finland,Bulgaria,1961,0,2,2
Denmark,Sweden,1961,1,2,3
Russia,Turkey,1961,1,0,1
Yugoslavia,Morocco,1961,3,2,5
Czechoslovakia,Argentina,1961,3,3,6
German DR,Morocco,1961,1,2,3
Russia,Argentina,1961,0,0,0
Poland,Yugoslavia,1961,1,1,2
Finland,Norway,1961,4,1,5
Brazil,Paraguay,1961,3,2,5
Russia,Norway,1961,5,2,7
Bolivia,Uruguay,1961,1,1,2
Uruguay,Bolivia,1961,2,1,3
Indonesia,Singapore,1961,1,0,1
Malaysia,Japan,1961,3,2,5
India,Vietnam Republic,1961,1,2,3
Kenya,Uganda,1961,0,1,1
Malaysia,Vietnam Republic,1961,3,1,4
Hong Kong,Thailand,1961,2,1,3
India,Japan,1961,1,3,4
Indonesia,Thailand,1961,2,1,3
Malaysia,India,1961,1,2,3
Sweden,Finland,1961,4,0,4
Japan,Vietnam Republic,1961,2,3,5
Singapore,Thailand,1961,5,3,8
Malaysia,Indonesia,1961,1,2,3
Singapore,Vietnam Republic,1961,1,2,3
Indonesia,Japan,1961,2,0,2
Thailand,Vietnam Republic,1961,1,2,3
India,Vietnam Republic,1961,1,3,4
Norway,Russia,1961,0,3,3
New Caledonia,Tahiti,1961,2,2,4
New Caledonia,Tahiti,1961,3,0,3
German DR,Hungary,1961,2,3,5
Russia,Austria,1961,0,1,1
Norway,Denmark,1961,0,4,4
Germany,Denmark,1961,5,1,6
New Caledonia,Tahiti,1961,2,1,3
Uganda,Kenya,1961,0,1,1
Scotland,Czechoslovakia,1961,3,2,5
England,Luxembourg,1961,4,1,5
France,Finland,1961,5,1,6
Uganda,Zanzibar,1961,2,1,3
Kenya,Tanzania,1961,0,0,0
Tanzania,Uganda,1961,3,1,4
Belgium,Sweden,1961,0,2,2
Kenya,Zanzibar,1961,10,0,10
Tanzania,Zanzibar,1961,3,0,3
Kenya,Uganda,1961,2,1,3
Northern Ireland,Scotland,1961,1,6,7
Austria,Hungary,1961,2,1,3
Republic of Ireland,Czechoslovakia,1961,1,3,4
Luxembourg,Portugal,1961,4,2,6
Poland,Germany,1961,0,2,2
Romania,Turkey,1961,4,0,4
Yugoslavia,South Korea,1961,5,1,6
Argentina,Paraguay,1961,5,1,6
Chile,Uruguay,1961,2,3,5
Wales,England,1961,1,1,2
Denmark,Finland,1961,9,1,10
Israel,Italy,1961,2,4,6
Northern Ireland,Greece,1961,2,0,2
Belgium,France,1961,3,0,3
Turkey,South Korea,1961,1,0,1
Vietnam Republic,Indonesia,1961,4,1,5
Germany,Greece,1961,2,1,3
Hungary,Netherlands,1961,3,3,6
Israel,South Korea,1961,1,1,2
Poland,German DR,1961,3,1,4
Sweden,Norway,1961,2,0,2
Indonesia,Malaysia,1961,1,3,4
England,Portugal,1961,2,0,2
Vietnam Republic,Malaysia,1961,1,0,1
Myanmar,South Korea,1961,3,0,3
Bulgaria,Finland,1961,3,1,4
Czechoslovakia,Republic of Ireland,1961,7,1,8
Mexico,Paraguay,1961,1,0,1
Switzerland,Sweden,1961,3,2,5
Turkey,Norway,1961,2,1,3
Uganda,Kenya,1961,2,0,2
Italy,Israel,1961,6,0,6
Malta,Norway,1961,1,1,2
Paraguay,Mexico,1961,0,0,0
Poland,Denmark,1961,5,0,5
Scotland,Wales,1961,2,0,2
Bulgaria,France,1961,1,0,1
Morocco,Spain,1961,0,1,1
Netherlands,Belgium,1961,0,4,4
Switzerland,Sweden,1961,2,1,3
Turkey,Russia,1961,1,2,3
Argentina,Russia,1961,1,2,3
Yugoslavia,Austria,1961,2,1,3
Chile,Russia,1961,0,1,1
England,Northern Ireland,1961,1,1,2
Spain,Morocco,1961,3,2,5
Nigeria,Tunisia,1961,2,1,3
South Korea,Yugoslavia,1961,1,3,4
Czechoslovakia,Scotland,1961,4,2,6
Uruguay,Russia,1961,1,2,3
Hong Kong,Yugoslavia,1961,1,2,3
Kenya,Zanzibar,1961,4,0,4
Panama,Venezuela,1961,2,6,8
Senegal,Gambia,1961,2,3,5
Uganda,Zanzibar,1961,2,0,2
Indonesia,Yugoslavia,1961,1,5,6
Kenya,Uganda,1961,4,1,5
Chile,Hungary,1961,5,1,6
Tanzania,Kenya,1961,1,3,4
France,Spain,1961,1,1,2
Morocco,German DR,1961,2,0,2
Panama,Venezuela,1961,0,3,3
Chile,Hungary,1961,0,0,0
Israel,Yugoslavia,1961,0,2,2
Bulgaria,France,1961,1,0,1
Ghana,Nigeria,1961,5,1,6
Uruguay,Hungary,1961,1,1,2
Belgium,Bulgaria,1961,4,0,4
Ethiopia,Kenya,1961,4,3,7
Egypt,Austria,1962,1,0,1
Ethiopia,Kenya,1962,6,1,7
Ethiopia,Tunisia,1962,4,2,6
Egypt,Uganda,1962,2,1,3
Tunisia,Uganda,1962,3,0,3
Ethiopia,Egypt,1962,4,2,6
Mali,Ivory Coast,1962,4,0,4
Mali,Ivory Coast,1962,0,2,2
Mali,Ghana,1962,0,1,1
Indonesia,Vietnam Republic,1962,1,2,3
Libya,Tunisia,1962,6,3,9
Uruguay,Argentina,1962,1,1,2
Ghana,Mali,1962,0,0,0
Curaçao,Suriname,1962,1,0,1
Argentina,Mexico,1962,1,0,1
Belgium,Netherlands,1962,3,1,4
Colombia,Mexico,1962,0,1,1
Colombia,Mexico,1962,2,2,4
England,Austria,1962,3,1,4
Sweden,Czechoslovakia,1962,3,1,4
Republic of Ireland,Austria,1962,2,3,5
France,Poland,1962,1,3,4
Germany,Uruguay,1962,3,0,3
Luxembourg,Russia,1962,1,3,4
Wales,Northern Ireland,1962,4,0,4
Scotland,England,1962,2,0,2
Morocco,Poland,1962,1,3,4
Hungary,Uruguay,1962,1,1,2
Sweden,Russia,1962,0,2,2
Guadeloupe,Martinique,1962,1,0,1
Brazil,Paraguay,1962,6,0,6
Czechoslovakia,Uruguay,1962,3,1,4
Brazil,Paraguay,1962,4,0,4
Mexico,Colombia,1962,1,0,1
Russia,Uruguay,1962,5,0,5
Hungary,Turkey,1962,2,1,3
Scotland,Uruguay,1962,2,3,5
Russia,German DR,1962,2,1,3
Italy,France,1962,2,1,3
Austria,Bulgaria,1962,2,0,2
Brazil,Portugal,1962,2,1,3
Brazil,Portugal,1962,1,0,1
England,Switzerland,1962,3,1,4
Netherlands,Northern Ireland,1962,4,0,4
Togo,Guinea,1962,2,1,3
Brazil,Wales,1962,3,1,4
Belgium,Italy,1962,1,3,4
Brazil,Wales,1962,3,1,4
Norway,Netherlands,1962,2,1,3
Turkey,Israel,1962,1,0,1
Yugoslavia,German DR,1962,3,1,4
Portugal,Belgium,1962,1,2,3
Jamaica,Haiti,1962,3,4,7
Peru,England,1962,0,4,4
Jamaica,Haiti,1962,1,3,4
Mexico,Wales,1962,2,1,3
German DR,Denmark,1962,4,1,5
Jamaica,Haiti,1962,2,5,7
Poland,Belgium,1962,2,0,2
Argentina,Bulgaria,1962,1,0,1
Brazil,Mexico,1962,2,0,2
Chile,Switzerland,1962,3,1,4
Colombia,Uruguay,1962,1,2,3
Czechoslovakia,Spain,1962,1,0,1
England,Hungary,1962,1,2,3
Germany,Italy,1962,0,0,0
Russia,Yugoslavia,1962,2,0,2
Argentina,England,1962,1,3,4
Brazil,Czechoslovakia,1962,0,0,0
Chile,Italy,1962,2,0,2
New Zealand,New Caledonia,1962,4,1,5
Uruguay,Yugoslavia,1962,1,3,4
Bulgaria,Hungary,1962,1,6,7
Colombia,Russia,1962,4,4,8
Germany,Switzerland,1962,2,1,3
Mexico,Spain,1962,0,1,1
Tunisia,Libya,1962,2,2,4
New Zealand,New Caledonia,1962,4,2,6
Argentina,Hungary,1962,0,0,0
Brazil,Spain,1962,2,1,3
Chile,Germany,1962,0,2,2
Russia,Uruguay,1962,2,1,3
Bulgaria,England,1962,0,0,0
Colombia,Yugoslavia,1962,0,5,5
Czechoslovakia,Mexico,1962,1,3,4
Italy,Switzerland,1962,3,0,3
Singapore,Hong Kong,1962,2,6,8
Brazil,England,1962,3,1,4
Chile,Russia,1962,2,1,3
Czechoslovakia,Hungary,1962,1,0,1
Germany,Yugoslavia,1962,0,1,1
Denmark,Norway,1962,6,1,7
Chile,Brazil,1962,2,4,6
Czechoslovakia,Yugoslavia,1962,3,1,4
Chile,Yugoslavia,1962,1,0,1
Brazil,Czechoslovakia,1962,3,1,4
Finland,Sweden,1962,0,3,3
Norway,Sweden,1962,0,2,2
Austria,Hungary,1962,1,2,3
Denmark,Malta,1962,6,1,7
Norway,Malta,1962,5,0,5
Kenya,Zanzibar,1962,5,0,5
Jamaica,Curaçao,1962,4,4,8
Iceland,Norway,1962,1,3,4
Jamaica,Curaçao,1962,2,1,3
Jamaica,Curaçao,1962,1,2,3
Singapore,Indonesia,1962,1,2,3
Gabon,Congo,1962,3,1,4
Vietnam Republic,Taiwan,1962,1,1,2
Thailand,Taiwan,1962,4,0,4
Singapore,Taiwan,1962,2,2,4
Kenya,Tanzania,1962,4,3,7
Bolivia,Paraguay,1962,3,1,4
Bolivia,Paraguay,1962,3,2,5
Republic of Ireland,Iceland,1962,4,2,6
Argentina,Uruguay,1962,3,1,4
Gabon,Cameroon,1962,1,1,2
Norway,Finland,1962,2,1,3
Suriname,Guadeloupe,1962,3,1,4
Uganda,Kenya,1962,3,1,4
Iceland,Republic of Ireland,1962,1,1,2
Poland,Hungary,1962,0,2,2
Netherlands,Curaçao,1962,8,0,8
Malaysia,Japan,1962,2,2,4
Myanmar,Pakistan,1962,0,1,1
Denmark,Curaçao,1962,3,1,4
Indonesia,Singapore,1962,2,0,2
Indonesia,Philippines,1962,9,0,9
Japan,Pakistan,1962,1,1,2
Malaysia,Myanmar,1962,3,2,5
Philippines,Singapore,1962,0,5,5
Indonesia,Vietnam Republic,1962,2,1,3
Myanmar,Japan,1962,3,1,4
Austria,Czechoslovakia,1962,0,6,6
Congo,Gabon,1962,3,1,4
Finland,Denmark,1962,1,6,7
German DR,Yugoslavia,1962,2,2,4
Malaysia,Pakistan,1962,0,0,0
Norway,Sweden,1962,2,1,3
Philippines,Vietnam Republic,1962,0,6,6
Trinidad and Tobago,Suriname,1962,1,1,2
Singapore,Vietnam Republic,1962,2,2,4
Trinidad and Tobago,Suriname,1962,1,0,1
Indonesia,Pakistan,1962,2,1,3
Yugoslavia,Ethiopia,1962,5,2,7
Trinidad and Tobago,Suriname,1962,1,1,2
Singapore,Japan,1962,2,1,3
Trinidad and Tobago,Suriname,1962,1,1,2
Denmark,Netherlands,1962,4,1,5
Ghana,Kenya,1962,6,3,9
Bulgaria,Poland,1962,2,1,3
Romania,Morocco,1962,4,0,4
Yugoslavia,Germany,1962,2,3,5
England,France,1962,1,1,2
Poland,Northern Ireland,1962,0,2,2
Turkey,Ethiopia,1962,3,0,3
Uganda,Ghana,1962,1,4,5
Poland,Morocco,1962,1,1,2
Kenya,Ghana,1962,0,4,4
South Korea,Indonesia,1962,2,0,2
Suriname,Guadeloupe,1962,3,3,6
Belgium,Netherlands,1962,2,0,2
German DR,Romania,1962,3,2,5
Hungary,Yugoslavia,1962,0,1,1
South Korea,Indonesia,1962,2,0,2
Malawi,Ghana,1962,0,12,12
Suriname,French Guiana,1962,4,2,6
Israel,Austria,1962,1,1,2
Greece,Ethiopia,1962,3,2,5
Tanzania,Ghana,1962,2,6,8
Northern Ireland,England,1962,1,3,4
Wales,Scotland,1962,2,3,5
Germany,France,1962,2,2,4
Vietnam Republic,Indonesia,1962,4,0,4
Malaysia,Thailand,1962,4,2,6
Czechoslovakia,Poland,1962,2,1,3
Hungary,Austria,1962,2,0,2
Indonesia,Malaysia,1962,2,1,3
Sweden,Denmark,1962,4,2,6
Vietnam Republic,Thailand,1962,0,1,1
Indonesia,Thailand,1962,7,0,7
Vietnam Republic,Malaysia,1962,2,0,2
Vietnam Republic,Indonesia,1962,2,0,2
Spain,Romania,1962,6,0,6
Sweden,Norway,1962,1,1,2
Tanzania,Uganda,1962,3,1,4
Yugoslavia,Belgium,1962,3,2,5
Kenya,Uganda,1962,4,1,5
Bulgaria,Portugal,1962,3,1,4
Chile,Argentina,1962,1,1,2
Hungary,Wales,1962,3,1,4
Scotland,Northern Ireland,1962,5,1,6
Nigeria,Ghana,1962,0,0,0
Austria,Italy,1962,1,2,3
France,Hungary,1962,2,3,5
Guadeloupe,Martinique,1962,3,1,4
Netherlands,Switzerland,1962,3,1,4
Thailand,Sweden,1962,1,2,3
Puerto Rico,Martinique,1962,1,6,7
Argentina,Chile,1962,1,0,1
England,Wales,1962,4,0,4
German DR,Czechoslovakia,1962,2,1,3
Malaysia,Sweden,1962,0,1,1
Grenada,Saint Vincent and the Grenadines,1962,2,1,3
Puerto Rico,Guadeloupe,1962,0,3,3
Bulgaria,Austria,1962,1,1,2
Israel,Turkey,1962,0,2,2
Romania,Spain,1962,3,1,4
Indonesia,Sweden,1962,0,3,3
Northern Ireland,Poland,1962,2,0,2
Senegal,Ivory Coast,1962,1,1,2
Belgium,Spain,1962,1,1,2
Italy,Turkey,1962,6,0,6
Malta,Denmark,1962,1,3,4
Nigeria,Cameroon,1962,3,1,4
Tanzania,Malawi,1962,6,2,8
Mali,German DR,1962,1,2,3
Turkey,Denmark,1962,1,1,2
Tanzania,Zanzibar,1962,6,0,6
Ethiopia,Turkey,1962,0,0,0
Guinea,German DR,1962,2,3,5
Portugal,Bulgaria,1962,3,1,4
Germany,Switzerland,1962,5,1,6
Morocco,Romania,1962,3,1,4
Central African Republic,Cameroon,1962,1,4,5
Congo,Madagascar,1962,6,1,7
Cameroon,Congo,1962,0,3,3
Central African Republic,Madagascar,1962,4,1,5
Cameroon,Nigeria,1963,1,2,3
Algeria,Bulgaria,1963,2,1,3
Kuwait,Jordan,1963,2,1,3
Spain,France,1963,0,0,0
Morocco,Switzerland,1963,1,0,1
Myanmar,China PR,1963,0,3,3
Uganda,Zanzibar,1963,8,0,8
Myanmar,China PR,1963,2,1,3
Bulgaria,Portugal,1963,1,0,1
Pakistan,China PR,1963,0,0,0
Benin,Nigeria,1963,1,1,2
Pakistan,China PR,1963,3,2,5
Mali,Burkina Faso,1963,1,0,1
Nigeria,Benin,1963,4,1,5
Pakistan,China PR,1963,1,1,2
Pakistan,China PR,1963,0,2,2
Paraguay,Bolivia,1963,3,0,3
Paraguay,Bolivia,1963,5,1,6
Jamaica,Haiti,1963,3,2,5
Mali,Senegal,1963,3,1,4
France,England,1963,5,2,7
Jamaica,Curaçao,1963,1,2,3
Nigeria,Senegal,1963,4,0,4
Guatemala,Honduras,1963,1,2,3
Haiti,Curaçao,1963,0,1,1
Ghana,Mali,1963,4,0,4
Netherlands,Belgium,1963,0,1,1
Paraguay,Brazil,1963,2,2,4
Tunisia,Kuwait,1963,2,1,3
Jamaica,Curaçao,1963,1,2,3
Jamaica,Haiti,1963,0,3,3
Argentina,Colombia,1963,4,2,6
Bolivia,Ecuador,1963,4,4,8
Brazil,Peru,1963,1,0,1
Guatemala,Honduras,1963,2,1,3
Ivory Coast,Tunisia,1963,3,0,3
Argentina,Peru,1963,1,2,3
Brazil,Colombia,1963,5,1,6
Ecuador,Paraguay,1963,1,3,4
Bolivia,Colombia,1963,2,1,3
Brazil,Paraguay,1963,0,2,2
Ecuador,Peru,1963,1,2,3
Argentina,Ecuador,1963,4,2,6
Colombia,Paraguay,1963,2,3,5
Wales,Hungary,1963,1,1,2
Bolivia,Peru,1963,3,2,5
Guatemala,Panama,1963,2,2,4
El Salvador,Nicaragua,1963,6,1,7
Uruguay,Chile,1963,3,2,5
Argentina,Brazil,1963,3,0,3
Bolivia,Paraguay,1963,2,0,2
Colombia,Peru,1963,1,1,2
Costa Rica,Jamaica,1963,6,0,6
Mexico,Curaçao,1963,1,2,3
Uganda,Ethiopia,1963,1,7,8
Honduras,Nicaragua,1963,1,0,1
El Salvador,Panama,1963,1,1,2
Brazil,Ecuador,1963,2,2,4
Guatemala,Nicaragua,1963,3,1,4
El Salvador,Honduras,1963,2,2,4
Paraguay,Peru,1963,4,1,5
Turkey,Italy,1963,0,1,1
Bolivia,Argentina,1963,3,2,5
Costa Rica,Curaçao,1963,1,0,1
Jamaica,Mexico,1963,0,8,8
Guatemala,Honduras,1963,1,2,3
Nicaragua,Panama,1963,0,5,5
Costa Rica,Mexico,1963,0,0,0
Jamaica,Curaçao,1963,1,2,3
Panama,Honduras,1963,1,0,1
El Salvador,Guatemala,1963,1,1,2
Argentina,Paraguay,1963,1,1,2
Belgium,Yugoslavia,1963,0,1,1
Bolivia,Brazil,1963,5,4,9
Colombia,Ecuador,1963,3,4,7
Czechoslovakia,German DR,1963,1,1,2
Lebanon,Kuwait,1963,6,0,6
Syria,Jordan,1963,4,0,4
Suriname,Trinidad and Tobago,1963,3,1,4
Switzerland,Netherlands,1963,1,1,2
Suriname,Trinidad and Tobago,1963,1,2,3
Syria,Tunisia,1963,0,1,1
Kuwait,Jordan,1963,4,0,4
Honduras,Curaçao,1963,1,4,5
El Salvador,Costa Rica,1963,1,4,5
Northern Ireland,Wales,1963,1,4,5
Jordan,Tunisia,1963,0,4,4
Lebanon,Syria,1963,2,3,5
Suriname,Trinidad and Tobago,1963,4,3,7
Costa Rica,Curaçao,1963,1,0,1
El Salvador,Honduras,1963,3,0,3
England,Scotland,1963,1,2,3
Kuwait,Tunisia,1963,1,5,6
Lebanon,Jordan,1963,5,0,5
El Salvador,Curaçao,1963,3,2,5
Costa Rica,Honduras,1963,2,1,3
Kuwait,Syria,1963,0,4,4
Lebanon,Tunisia,1963,0,1,1
Brazil,Argentina,1963,2,3,5
Brazil,Argentina,1963,5,2,7
Guadeloupe,Martinique,1963,3,0,3
Netherlands,France,1963,1,0,1
Guadeloupe,Puerto Rico,1963,3,0,3
Portugal,Brazil,1963,1,0,1
Austria,Czechoslovakia,1963,3,1,4
Belgium,Brazil,1963,5,1,6
China PR,North Vietnam,1963,1,0,1
Cambodia,North Vietnam,1963,2,3,5
Indonesia,Egypt,1963,1,3,4
Cambodia,China PR,1963,0,6,6
Indonesia,Egypt,1963,2,2,4
Bulgaria,Czechoslovakia,1963,1,0,1
France,Brazil,1963,2,3,5
Egypt,China PR,1963,2,0,2
Indonesia,North Vietnam,1963,3,1,4
Netherlands,Brazil,1963,1,0,1
Tanzania,Ethiopia,1963,0,2,2
Germany,Brazil,1963,1,2,3
Sweden,Hungary,1963,2,1,3
England,Brazil,1963,1,1,2
Scotland,Austria,1963,4,1,5
Italy,Brazil,1963,3,0,3
Romania,German DR,1963,3,2,5
Norway,Poland,1963,2,5,7
Egypt,Brazil,1963,0,1,1
Hungary,Denmark,1963,6,0,6
Indonesia,China PR,1963,1,2,3
Israel,Brazil,1963,0,5,5
Poland,Greece,1963,4,0,4
Russia,Sweden,1963,0,1,1
Zanzibar,Ethiopia,1963,0,4,4
Czechoslovakia,England,1963,2,4,6
Spain,Northern Ireland,1963,1,1,2
Kenya,Sudan,1963,0,1,1
Czechoslovakia,Hungary,1963,2,2,4
German DR,England,1963,1,2,3
Poland,Romania,1963,1,1,2
Denmark,Finland,1963,1,1,2
Kenya,Ethiopia,1963,1,2,3
Norway,Scotland,1963,4,3,7
Switzerland,England,1963,1,8,9
Austria,Italy,1963,0,1,1
Republic of Ireland,Scotland,1963,1,0,1
Tunisia,Lebanon,1963,2,0,2
Spain,Scotland,1963,2,6,8
Ethiopia,Sudan,1963,4,0,4
Tunisia,Morocco,1963,4,1,5
Yugoslavia,Sweden,1963,0,0,0
Finland,Norway,1963,2,0,2
Denmark,Albania,1963,4,0,4
Sudan,Kenya,1963,5,0,5
Morocco,Tunisia,1963,4,2,6
Zambia,Malawi,1963,5,1,6
Algeria,Egypt,1963,2,2,4
Chile,Uruguay,1963,0,0,0
Nigeria,Guinea,1963,2,2,4
Jamaica,El Salvador,1963,0,1,1
Jamaica,El Salvador,1963,0,0,0
Malaysia,Japan,1963,3,4,7
Taiwan,Vietnam Republic,1963,1,1,2
Jamaica,El Salvador,1963,1,1,2
Thailand,Japan,1963,1,4,5
South Korea,Thailand,1963,5,1,6
Malaysia,Vietnam Republic,1963,0,5,5
Malaysia,Taiwan,1963,2,3,5
Vietnam Republic,Japan,1963,1,5,6
South Korea,Japan,1963,1,1,2
South Korea,Vietnam Republic,1963,3,1,4
Malaysia,Thailand,1963,2,2,4
Sweden,Finland,1963,0,0,0
Sweden,Norway,1963,0,0,0
Taiwan,Japan,1963,2,0,2
Taiwan,Thailand,1963,2,2,4
Malaysia,South Korea,1963,3,0,3
Thailand,Vietnam Republic,1963,2,3,5
Taiwan,South Korea,1963,1,0,1
Fiji,Papua New Guinea,1963,3,1,4
Solomon Islands,Vanuatu,1963,6,3,9
Colombia,Costa Rica,1963,4,5,9
Fiji,Solomon Islands,1963,5,0,5
New Caledonia,Tahiti,1963,2,1,3
China PR,Myanmar,1963,4,0,4
Colombia,Costa Rica,1963,1,0,1
German DR,Bulgaria,1963,1,1,2
Poland,Norway,1963,9,0,9
Solomon Islands,Tahiti,1963,0,18,18
Fiji,New Caledonia,1963,2,8,10
Mauritius,Réunion,1963,0,2,2
Netherlands,Luxembourg,1963,1,1,2
Madagascar,Réunion,1963,6,1,7
Norway,Denmark,1963,0,4,4
Bulgaria,Sudan,1963,1,1,2
Sweden,Yugoslavia,1963,3,2,5
Poland,Turkey,1963,0,0,0
Russia,Hungary,1963,1,1,2
Austria,Republic of Ireland,1963,0,0,0
Martinique,Puerto Rico,1963,6,0,6
Germany,Turkey,1963,3,0,3
Kenya,Tanzania,1963,4,1,5
Bulgaria,France,1963,1,0,1
Uganda,Zanzibar,1963,2,0,2
Kenya,Zanzibar,1963,1,0,1
Tanzania,Uganda,1963,1,1,2
Tanzania,Zanzibar,1963,2,1,3
Kenya,Uganda,1963,1,2,3
Denmark,Sweden,1963,2,2,4
Yugoslavia,Hungary,1963,2,0,2
Liberia,Nigeria,1963,2,2,4
Turkey,Romania,1963,0,0,0
Japan,Vietnam Republic,1963,2,1,3
Northern Ireland,Scotland,1963,2,1,3
Wales,England,1963,0,4,4
Republic of Ireland,Austria,1963,3,2,5
Russia,Italy,1963,2,0,2
Paraguay,Argentina,1963,0,4,4
Suriname,Curaçao,1963,2,3,5
Greece,Poland,1963,3,1,4
German DR,Hungary,1963,1,2,3
Zambia,Kenya,1963,0,1,1
Netherlands,Belgium,1963,1,1,2
France,Bulgaria,1963,3,1,4
Nigeria,Liberia,1963,3,0,3
Hungary,Austria,1963,2,1,3
Romania,Yugoslavia,1963,2,1,3
Argentina,Paraguay,1963,2,3,5
Albania,Denmark,1963,1,0,1
Netherlands,Luxembourg,1963,1,2,3
Northern Ireland,Spain,1963,0,1,1
Cameroon,Togo,1963,2,1,3
Hungary,German DR,1963,3,3,6
Sweden,Germany,1963,2,1,3
Switzerland,Norway,1963,0,2,2
Yugoslavia,Czechoslovakia,1963,2,0,2
Scotland,Norway,1963,6,1,7
Italy,Russia,1963,1,1,2
France,Switzerland,1963,2,2,4
North Korea,Somalia,1963,14,0,14
China PR,Mali,1963,3,1,4
Egypt,North Vietnam,1963,4,1,5
Laos,North Vietnam,1963,1,9,10
Indonesia,Mali,1963,3,2,5
Egypt,Laos,1963,15,0,15
Indonesia,China PR,1963,1,1,2
Egypt,Saudi Arabia,1963,7,0,7
Indonesia,North Korea,1963,1,5,6
North Korea,North Vietnam,1963,2,0,2
England,Northern Ireland,1963,8,3,11
Hong Kong,Singapore,1963,3,4,7
Scotland,Wales,1963,2,1,3
Senegal,Ethiopia,1963,1,2,3
Egypt,North Korea,1963,1,1,2
Egypt,Nigeria,1963,6,3,9
Ghana,Tunisia,1963,1,1,2
Egypt,Sudan,1963,2,2,4
Ghana,Ethiopia,1963,2,0,2
Cyprus,Greece,1963,3,1,4
Ethiopia,Tunisia,1963,4,2,6
Nigeria,Sudan,1963,0,4,4
Egypt,Ethiopia,1963,3,0,3
Ghana,Sudan,1963,3,0,3
Morocco,Russia,1963,1,1,2
Spain,Belgium,1963,1,2,3
Luxembourg,Denmark,1963,3,3,6
Hong Kong,Thailand,1963,3,3,6
Kenya,Tanzania,1963,6,2,8
Vietnam Republic,Malaysia,1963,5,3,8
Denmark,Luxembourg,1963,2,2,4
Kenya,Uganda,1963,1,1,2
Malaysia,Thailand,1963,3,1,4
Vietnam Republic,Hong Kong,1963,1,4,5
Tanzania,Uganda,1963,0,5,5
Hong Kong,Malaysia,1963,4,3,7
Italy,Austria,1963,1,0,1
Vietnam Republic,Thailand,1963,3,0,3
Senegal,Guinea,1963,1,1,2
Tunisia,Algeria,1963,0,0,0
Philippines,Taiwan,1963,0,7,7
Myanmar,German DR,1963,1,5,6
Denmark,Luxembourg,1963,1,0,1
France,Belgium,1963,1,2,3
Morocco,Germany,1963,1,4,5
Cameroon,Guinea,1963,1,5,6
Algeria,Germany,1964,2,0,2
Hong Kong,Israel,1964,0,3,3
Saint Lucia,Saint Vincent and the Grenadines,1964,2,2,4
Dominica,Saint Vincent and the Grenadines,1964,2,2,4
Saint Lucia,Dominica,1964,4,2,6
Saint Lucia,Saint Vincent and the Grenadines,1964,0,0,0
Dominica,Saint Vincent and the Grenadines,1964,1,1,2
Sri Lanka,German DR,1964,1,12,13
Saint Lucia,Dominica,1964,5,0,5
Cameroon,Benin,1964,2,4,6
Cameroon,Congo,1964,7,1,8
Congo,Cameroon,1964,4,4,8
Ghana,German DR,1964,3,0,3
Sri Lanka,Indonesia,1964,3,9,12
Congo,DR Congo,1964,0,0,0
Sri Lanka,Indonesia,1964,1,4,5
Singapore,Japan,1964,1,2,3
Libya,Lebanon,1964,0,1,1
Spain,Republic of Ireland,1964,5,1,6
Ivory Coast,Mali,1964,1,1,2
Libya,Malta,1964,2,2,4
Bulgaria,Yugoslavia,1964,0,1,1
Egypt,Algeria,1964,1,0,1
Belgium,Netherlands,1964,0,0,0
Congo,Chad,1964,11,0,11
Yugoslavia,Bulgaria,1964,1,0,1
Guyana,Trinidad and Tobago,1964,1,2,3
Republic of Ireland,Spain,1964,0,2,2
Guyana,Trinidad and Tobago,1964,1,6,7
Italy,Czechoslovakia,1964,0,0,0
Scotland,England,1964,1,0,1
Guyana,Trinidad and Tobago,1964,1,4,5
Netherlands,Austria,1964,1,1,2
Switzerland,Belgium,1964,2,0,2
Wales,Northern Ireland,1964,2,3,5
Cameroon,DR Congo,1964,2,2,4
France,Hungary,1964,1,3,4
Germany,Czechoslovakia,1964,3,4,7
Netherlands,Sweden,1964,0,1,1
Northern Ireland,Uruguay,1964,3,0,3
Switzerland,Portugal,1964,2,3,5
Austria,Hungary,1964,1,0,1
Belgium,Portugal,1964,1,2,3
England,Uruguay,1964,2,1,3
Poland,Republic of Ireland,1964,3,1,4
Switzerland,Italy,1964,1,3,4
Germany,Scotland,1964,2,2,4
Greece,Ethiopia,1964,3,1,4
Norway,Republic of Ireland,1964,1,4,5
Sweden,Russia,1964,1,1,2
Austria,Uruguay,1964,0,2,2
Czechoslovakia,Yugoslavia,1964,2,3,5
Portugal,England,1964,3,4,7
Tunisia,Ethiopia,1964,3,2,5
Russia,Uruguay,1964,1,0,1
Hungary,France,1964,2,1,3
Republic of Ireland,England,1964,1,3,4
Netherlands,Albania,1964,2,0,2
Israel,Hong Kong,1964,1,0,1
India,South Korea,1964,2,0,2
Russia,Sweden,1964,3,1,4
United States,England,1964,0,10,10
Israel,India,1964,2,0,2
Brazil,England,1964,5,1,6
Hong Kong,South Korea,1964,0,1,1
Argentina,Portugal,1964,2,0,2
Hong Kong,India,1964,1,3,4
Brazil,Argentina,1964,0,3,3
Israel,South Korea,1964,2,1,3
England,Portugal,1964,1,1,2
French Guiana,Suriname,1964,3,1,4
French Guiana,Suriname,1964,3,3,6
Argentina,England,1964,1,0,1
Brazil,Portugal,1964,4,1,5
Finland,Germany,1964,1,4,5
Denmark,Russia,1964,0,3,3
Spain,Hungary,1964,2,1,3
Yugoslavia,Romania,1964,1,2,3
Congo,Guinea,1964,1,2,3
Hungary,Denmark,1964,3,1,4
Spain,Russia,1964,2,1,3
Sweden,Denmark,1964,4,1,5
Vietnam Republic,South Korea,1964,1,2,3
Norway,Switzerland,1964,3,2,5
Zambia,Tanzania,1964,3,0,3
Malawi,Zambia,1964,0,5,5
Singapore,Hong Kong,1964,1,1,2
Singapore,Hong Kong,1964,2,1,3
Cameroon,DR Congo,1964,1,1,2
Cameroon,Central African Republic,1964,2,1,3
Cameroon,Congo,1964,3,1,4
Cameroon,DR Congo,1964,2,1,3
Finland,Sweden,1964,1,0,1
Iceland,Bermuda,1964,4,3,7
Congo,Mali,1964,1,0,1
Norway,Finland,1964,2,0,2
Malaysia,Thailand,1964,3,0,3
Cambodia,Taiwan,1964,0,4,4
Iceland,Finland,1964,0,2,2
Malaysia,India,1964,1,1,2
Cambodia,India,1964,0,4,4
Taiwan,Vietnam Republic,1964,0,0,0
Malaysia,Myanmar,1964,0,3,3
India,Thailand,1964,2,1,3
Myanmar,Taiwan,1964,2,4,6
Malaysia,Vietnam Republic,1964,1,2,3
Cambodia,Thailand,1964,0,1,1
Myanmar,Vietnam Republic,1964,1,0,1
Malaysia,Taiwan,1964,5,2,7
Guyana,Trinidad and Tobago,1964,1,1,2
Guyana,Trinidad and Tobago,1964,1,2,3
Malaysia,Thailand,1964,1,1,2
Myanmar,India,1964,1,0,1
Finland,Denmark,1964,2,1,3
India,Taiwan,1964,6,4,10
Kenya,Zanzibar,1964,5,1,6
Tahiti,New Caledonia,1964,0,2,2
Poland,Czechoslovakia,1964,2,1,3
Martinique,Puerto Rico,1964,4,0,4
Martinique,Guadeloupe,1964,1,0,1
Norway,Sweden,1964,1,1,2
Yugoslavia,Luxembourg,1964,3,1,4
Guadeloupe,Puerto Rico,1964,4,0,4
Argentina,Chile,1964,5,0,5
Tanzania,Kenya,1964,1,0,1
Austria,Yugoslavia,1964,3,2,5
Tahiti,New Caledonia,1964,4,1,5
Turkey,Poland,1964,2,3,5
Uganda,Zanzibar,1964,2,3,5
Tanzania,Zanzibar,1964,3,1,4
Belgium,Netherlands,1964,1,0,1
Kenya,Uganda,1964,0,1,1
Northern Ireland,England,1964,3,4,7
Tanzania,Uganda,1964,3,0,3
Wales,Scotland,1964,3,2,5
Luxembourg,France,1964,0,2,2
Switzerland,Hungary,1964,0,2,2
Zanzibar,Uganda,1964,3,4,7
Sweden,Poland,1964,3,3,6
Uganda,Burundi,1964,7,5,12
Austria,Russia,1964,1,0,1
Denmark,Norway,1964,2,0,2
Hungary,Czechoslovakia,1964,2,2,4
Chile,Argentina,1964,1,1,2
Northern Ireland,Switzerland,1964,1,0,1
Uganda,Kenya,1964,3,2,5
Zambia,Uganda,1964,0,2,2
Denmark,Wales,1964,1,0,1
England,Belgium,1964,2,2,4
Ghana,Kenya,1964,7,1,8
Scotland,Finland,1964,3,1,4
Ghana,Uganda,1964,2,0,2
Zambia,Kenya,1964,2,3,5
Albania,Netherlands,1964,0,2,2
Hungary,Yugoslavia,1964,2,1,3
Republic of Ireland,Poland,1964,3,2,5
Zambia,Ghana,1964,3,4,7
Israel,Yugoslavia,1964,2,0,2
Turkey,Tunisia,1964,4,1,5
Algeria,Russia,1964,2,2,4
Germany,Sweden,1964,1,1,2
Italy,Finland,1964,6,1,7
Luxembourg,Norway,1964,0,2,2
France,Norway,1964,1,0,1
Jordan,Lebanon,1964,0,0,0
Kuwait,Iraq,1964,0,1,1
Switzerland,Northern Ireland,1964,2,1,3
Libya,Lebanon,1964,2,1,3
Kuwait,Jordan,1964,2,0,2
Portugal,Spain,1964,2,1,3
Iraq,Lebanon,1964,1,0,1
Jordan,Libya,1964,2,5,7
Kuwait,Lebanon,1964,2,3,5
Iraq,Libya,1964,1,1,2
England,Wales,1964,2,1,3
Kuwait,Libya,1964,1,1,2
Yugoslavia,Russia,1964,1,1,2
Paraguay,Argentina,1964,3,0,3
Scotland,Northern Ireland,1964,3,2,5
Bulgaria,Russia,1964,0,0,0
Greece,Denmark,1964,4,2,6
Israel,Denmark,1964,0,1,1
Belgium,France,1964,3,0,3
Italy,Denmark,1964,3,1,4
Argentina,Paraguay,1964,8,1,9
Greece,Wales,1964,2,0,2
Netherlands,England,1964,1,1,2
Kenya,Zambia,1964,4,2,6
Kenya,Zambia,1964,2,8,10
Turkey,Bulgaria,1964,0,0,0
Uruguay,German DR,1965,0,2,2
Togo,DR Congo,1965,0,3,3
Jamaica,Cuba,1965,2,0,2
Ivory Coast,DR Congo,1965,2,0,2
Cuba,Curaçao,1965,1,1,2
Jamaica,Curaçao,1965,2,0,2
Portugal,Turkey,1965,5,1,6
Israel,Netherlands,1965,0,1,1
Cuba,Curaçao,1965,0,1,1
Congo,DR Congo,1965,0,3,3
Curaçao,Jamaica,1965,0,0,0
Cuba,Jamaica,1965,2,1,3
Trinidad and Tobago,Suriname,1965,4,1,5
Costa Rica,Suriname,1965,1,0,1
Costa Rica,Trinidad and Tobago,1965,4,0,4
Uganda,Ethiopia,1965,1,2,3
Costa Rica,Trinidad and Tobago,1965,1,0,1
Senegal,Guinea,1965,2,0,2
Honduras,Mexico,1965,0,1,1
Suriname,Costa Rica,1965,1,3,4
Tunisia,Morocco,1965,0,0,0
Mexico,Honduras,1965,3,0,3
Trinidad and Tobago,Costa Rica,1965,0,1,1
United States,Mexico,1965,2,2,4
Curaçao,Costa Rica,1965,1,2,3
El Salvador,Nicaragua,1965,4,0,4
Guatemala,Paraguay,1965,1,4,5
Hong Kong,Japan,1965,1,4,5
Honduras,Nicaragua,1965,0,2,2
Kuwait,Morocco,1965,0,2,2
Mexico,United States,1965,2,0,2
Germany,Italy,1965,1,1,2
El Salvador,Honduras,1965,3,1,4
Guatemala,Paraguay,1965,0,3,3
Libya,Kuwait,1965,4,1,5
Suriname,Trinidad and Tobago,1965,6,1,7
Hong Kong,Japan,1965,1,2,3
Costa Rica,Paraguay,1965,1,0,1
Honduras,United States,1965,0,1,1
Israel,Switzerland,1965,0,0,0
Northern Ireland,Netherlands,1965,2,1,3
Wales,Greece,1965,4,1,5
Costa Rica,Paraguay,1965,0,0,0
Libya,Morocco,1965,1,0,1
Cyprus,Lebanon,1965,2,0,2
Honduras,United States,1965,1,1,2
Myanmar,Japan,1965,1,1,2
France,Austria,1965,1,2,3
Republic of Ireland,Belgium,1965,0,2,2
Singapore,Japan,1965,1,4,5
Malaysia,Japan,1965,1,1,2
Sudan,Ethiopia,1965,2,1,3
Costa Rica,Curaçao,1965,6,0,6
El Salvador,Mexico,1965,0,2,2
Guatemala,Haiti,1965,3,0,3
El Salvador,Curaçao,1965,1,1,2
Costa Rica,Haiti,1965,3,1,4
Guinea,Senegal,1965,3,1,4
Northern Ireland,Wales,1965,0,5,5
Mexico,Curaçao,1965,5,0,5
Guatemala,Costa Rica,1965,0,0,0
Peru,Paraguay,1965,0,1,1
Guatemala,El Salvador,1965,4,1,5
Haiti,Mexico,1965,0,3,3
Costa Rica,Mexico,1965,1,1,2
Guatemala,Curaçao,1965,3,2,5
Belgium,Poland,1965,0,0,0
Netherlands,Northern Ireland,1965,0,0,0
Costa Rica,El Salvador,1965,1,2,3
Haiti,Curaçao,1965,1,1,2
England,Scotland,1965,2,2,4
Albania,Switzerland,1965,0,2,2
Guatemala,Mexico,1965,1,2,3
El Salvador,Haiti,1965,3,1,4
Ghana,DR Congo,1965,4,1,5
Chile,Peru,1965,4,1,5
Ethiopia,Uganda,1965,2,0,2
Ethiopia,Sudan,1965,1,0,1
Mali,Senegal,1965,0,2,2
Poland,Italy,1965,0,0,0
Yugoslavia,France,1965,1,0,1
Turkey,Portugal,1965,0,1,1
Germany,Cyprus,1965,5,0,5
Austria,German DR,1965,1,1,2
Costa Rica,Mexico,1965,0,0,0
Czechoslovakia,Portugal,1965,0,1,1
Paraguay,Uruguay,1965,2,1,3
Peru,Chile,1965,0,1,1
Indonesia,Sri Lanka,1965,5,0,5
Italy,Wales,1965,4,1,5
Uganda,Sudan,1965,1,3,4
Uruguay,Paraguay,1965,4,0,4
Morocco,Tunisia,1965,0,1,1
Romania,Turkey,1965,3,0,3
Switzerland,Albania,1965,1,0,1
Jamaica,Mexico,1965,2,3,5
Mali,Congo,1965,1,1,2
England,Hungary,1965,1,0,1
Republic of Ireland,Spain,1965,1,0,1
Senegal,Mali,1965,3,1,4
Sweden,Cyprus,1965,3,0,3
Mexico,Jamaica,1965,8,0,8
Northern Ireland,Albania,1965,4,1,5
Scotland,Spain,1965,0,0,0
Belgium,Israel,1965,1,0,1
Bulgaria,Turkey,1965,4,1,5
Chile,Uruguay,1965,0,0,0
Yugoslavia,England,1965,1,1,2
Costa Rica,Jamaica,1965,7,0,7
Germany,England,1965,0,1,1
Mexico,Costa Rica,1965,1,0,1
Peru,Venezuela,1965,1,0,1
Poland,Bulgaria,1965,1,1,2
Russia,Austria,1965,0,0,0
Sweden,England,1965,1,2,3
Uruguay,Chile,1965,1,1,2
Norway,Thailand,1965,7,0,7
Iran,Turkey,1965,1,2,3
Jamaica,Costa Rica,1965,1,1,2
German DR,Hungary,1965,1,1,2
Mali,Guinea,1965,2,1,3
Poland,Scotland,1965,1,1,2
Russia,Greece,1965,3,1,4
Uruguay,Venezuela,1965,5,0,5
Iran,Turkey,1965,2,1,3
Switzerland,Germany,1965,0,1,1
Finland,Scotland,1965,1,2,3
Norway,Luxembourg,1965,4,2,6
Liberia,Ivory Coast,1965,0,1,1
Romania,Czechoslovakia,1965,1,0,1
Russia,Wales,1965,2,1,3
Venezuela,Uruguay,1965,1,3,4
Brazil,Belgium,1965,5,0,5
Venezuela,Peru,1965,3,6,9
France,Argentina,1965,0,0,0
Brazil,Germany,1965,2,0,2
Guinea,Mali,1965,2,1,3
Peru,Uruguay,1965,0,1,1
Brazil,Argentina,1965,0,0,0
Denmark,Finland,1965,3,1,4
Austria,Hungary,1965,0,1,1
Bulgaria,Israel,1965,4,0,4
Portugal,Romania,1965,2,1,3
Uruguay,Peru,1965,2,1,3
Norway,Yugoslavia,1965,3,0,3
Sweden,Italy,1965,2,2,4
Algeria,Brazil,1965,0,3,3
Denmark,Sweden,1965,2,1,3
Finland,Italy,1965,0,2,2
Portugal,Brazil,1965,0,0,0
Congo,Benin,1965,1,6,7
Hungary,Italy,1965,2,1,3
Russia,Denmark,1965,6,0,6
Sweden,Brazil,1965,1,2,3
Russia,Brazil,1965,0,3,3
Iceland,Denmark,1965,1,3,4
Honduras,Costa Rica,1965,1,1,2
Argentina,Chile,1965,1,0,1
Colombia,Ecuador,1965,0,1,1
Chile,Argentina,1965,1,1,2
Pakistan,Turkey,1965,1,3,4
Iran,Pakistan,1965,4,1,5
Ecuador,Colombia,1965,2,0,2
Iran,Turkey,1965,0,0,0
Paraguay,Bolivia,1965,2,0,2
Suriname,French Guiana,1965,7,0,7
Suriname,French Guiana,1965,5,0,5
Jordan,Iraq,1965,0,0,0
Argentina,Paraguay,1965,3,0,3
Chile,Colombia,1965,7,2,9
China PR,Indonesia,1965,3,0,3
North Korea,North Vietnam,1965,1,0,1
Cambodia,North Vietnam,1965,1,1,2
Guinea,Indonesia,1965,3,1,4
North Korea,China PR,1965,3,0,3
Jamaica,Trinidad and Tobago,1965,4,0,4
Cambodia,Indonesia,1965,0,0,0
Guinea,North Vietnam,1965,1,2,3
Cambodia,China PR,1965,1,3,4
Colombia,Chile,1965,2,0,2
North Korea,Guinea,1965,3,0,3
Finland,Norway,1965,4,0,4
North Korea,Indonesia,1965,3,0,3
Paraguay,Argentina,1965,0,0,0
China PR,North Vietnam,1965,3,3,6
China PR,Guinea,1965,2,0,2
North Korea,Cambodia,1965,4,0,4
Indonesia,North Vietnam,1965,2,1,3
South Korea,Thailand,1965,2,3,5
Malaysia,Japan,1965,2,2,4
Liberia,DR Congo,1965,2,1,3
Myanmar,Hong Kong,1965,4,2,6
Vietnam Republic,Taiwan,1965,5,2,7
India,Japan,1965,1,1,2
Ecuador,Chile,1965,2,2,4
Argentina,Bolivia,1965,4,1,5
Hong Kong,Vietnam Republic,1965,1,2,3
Malaysia,South Korea,1965,0,2,2
Japan,Taiwan,1965,0,4,4
Hong Kong,India,1965,2,2,4
Malaysia,Vietnam Republic,1965,3,3,6
Thailand,Taiwan,1965,2,3,5
Japan,Myanmar,1965,3,1,4
South Korea,Vietnam Republic,1965,0,0,0
Malaysia,India,1965,0,3,3
Bolivia,Paraguay,1965,2,1,3
Myanmar,Thailand,1965,1,1,2
Chile,Ecuador,1965,3,1,4
Sudan,Uganda,1965,4,1,5
Sweden,Finland,1965,2,2,4
India,South Korea,1965,0,1,1
Malaysia,Hong Kong,1965,1,3,4
Myanmar,Taiwan,1965,3,1,4
Japan,Thailand,1965,0,0,0
Hong Kong,South Korea,1965,0,1,1
India,Vietnam Republic,1965,2,0,2
Myanmar,India,1965,1,1,2
Hong Kong,Thailand,1965,1,1,2
Gabon,Nigeria,1965,2,2,4
Japan,Vietnam Republic,1965,2,1,3
South Korea,Taiwan,1965,1,1,2
Bolivia,Argentina,1965,1,2,3
Gabon,Nigeria,1965,1,4,5
Singapore,India,1965,1,2,3
Bulgaria,German DR,1965,3,2,5
Russia,Yugoslavia,1965,0,0,0
DR Congo,Ivory Coast,1965,4,2,6
Hungary,Austria,1965,3,0,3
Brazil,Uruguay,1965,3,0,3
New Caledonia,Tahiti,1965,4,1,5
Zambia,Kenya,1965,3,3,6
New Caledonia,Tahiti,1965,2,1,3
Zambia,Kenya,1965,2,3,5
Norway,France,1965,0,1,1
Uganda,Zambia,1965,2,2,4
Czechoslovakia,Romania,1965,3,1,4
Luxembourg,Yugoslavia,1965,2,5,7
Zambia,Kenya,1965,3,2,5
DR Congo,Liberia,1965,3,2,5
Ivory Coast,Liberia,1965,4,0,4
Uganda,Zanzibar,1965,4,1,5
Bulgaria,Belgium,1965,3,0,3
Kenya,Tanzania,1965,0,2,2
Norway,Denmark,1965,2,2,4
Sweden,Germany,1965,1,2,3
Uganda,Kenya,1965,2,2,4
Finland,Poland,1965,2,0,2
Tanzania,Zanzibar,1965,3,0,3
Kenya,Zanzibar,1965,5,1,6
Northern Ireland,Scotland,1965,3,2,5
Uganda,Tanzania,1965,1,1,2
Wales,England,1965,0,0,0
Greece,Russia,1965,1,4,5
France,Yugoslavia,1965,1,0,1
Germany,Austria,1965,4,1,5
Hungary,German DR,1965,3,2,5
Turkey,Czechoslovakia,1965,0,6,6
Chile,Ecuador,1965,2,1,3
Scotland,Poland,1965,1,2,3
Ghana,Congo,1965,5,0,5
Congo,Ghana,1965,2,1,3
Denmark,Russia,1965,1,3,4
Netherlands,Switzerland,1965,0,0,0
England,Austria,1965,2,3,5
Congo,Ghana,1965,1,2,3
Kenya,Tanzania,1965,4,2,6
Turkey,Romania,1965,2,1,3
Poland,Finland,1965,7,0,7
Belgium,Bulgaria,1965,5,0,5
Denmark,Greece,1965,1,1,2
Spain,Republic of Ireland,1965,4,1,5
Wales,Russia,1965,2,1,3
Nigeria,Ghana,1965,0,4,4
Algeria,Morocco,1965,0,0,0
German DR,Austria,1965,1,0,1
Portugal,Czechoslovakia,1965,0,0,0
Sweden,Norway,1965,0,0,0
Italy,Poland,1965,6,1,7
France,Luxembourg,1965,4,1,5
Cyprus,Sweden,1965,0,5,5
Ghana,Nigeria,1965,3,0,3
Yugoslavia,Norway,1965,1,1,2
Scotland,Italy,1965,1,0,1
England,Northern Ireland,1965,2,1,3
Republic of Ireland,Spain,1965,0,1,1
Israel,Belgium,1965,0,5,5
DR Congo,Ghana,1965,2,5,7
Tunisia,Ethiopia,1965,4,0,4
Vietnam Republic,Thailand,1965,4,0,4
DR Congo,Ivory Coast,1965,0,3,3
Cyprus,Germany,1965,0,6,6
Switzerland,Netherlands,1965,2,1,3
Tunisia,Senegal,1965,0,0,0
Vietnam Republic,Malaysia,1965,2,2,4
Ethiopia,Senegal,1965,1,5,6
Ghana,Ivory Coast,1965,4,1,5
Brazil,Russia,1965,2,2,4
Brazil,Hungary,1965,5,3,8
Czechoslovakia,Turkey,1965,3,1,4
Dominica,Grenada,1965,2,0,2
Israel,Bulgaria,1965,1,2,3
Ivory Coast,Senegal,1965,1,0,1
North Korea,Australia,1965,6,1,7
Romania,Portugal,1965,2,0,2
Tunisia,Ghana,1965,2,3,5
Saint Vincent and the Grenadines,Saint Lucia,1965,1,2,3
Congo,Ivory Coast,1965,0,1,1
Dominica,Saint Lucia,1965,1,0,1
Albania,Northern Ireland,1965,1,1,2
Australia,North Korea,1965,1,3,4
Scotland,Wales,1965,4,1,5
Ivory Coast,Mali,1965,1,3,4
Cambodia,Australia,1965,0,0,0
Saint Vincent and the Grenadines,Dominica,1965,3,1,4
Hong Kong,Australia,1965,1,0,1
Argentina,Russia,1965,1,1,2
Wales,Denmark,1965,4,2,6
Australia,Taiwan,1965,3,1,4
Uruguay,Russia,1965,1,3,4
Hong Kong,Singapore,1965,0,0,0
Hong Kong,Singapore,1965,1,2,3
Italy,Scotland,1965,3,0,3
Malaysia,Australia,1965,0,1,1
Malaysia,Australia,1965,0,3,3
Spain,England,1965,0,2,2
Kenya,Ghana,1965,2,13,15
Nigeria,Benin,1965,0,1,1
Kenya,Ghana,1965,3,3,6
Bermuda,Jamaica,1965,0,3,3
Belgium,Bulgaria,1965,1,2,3
England,Poland,1966,1,1,2
Panama,Nicaragua,1966,3,1,4
Malta,Libya,1966,1,0,1
Chile,Russia,1966,0,2,2
England,Germany,1966,1,0,1
Egypt,Bulgaria,1966,2,2,4
Benin,Nigeria,1966,1,2,3
Niger,DR Congo,1966,2,1,3
Panama,Guatemala,1966,0,1,1
Uganda,Kenya,1966,2,3,5
Guinea,Senegal,1966,5,0,5
Morocco,Algeria,1966,1,0,1
Togo,Nigeria,1966,2,2,4
Libya,Morocco,1966,4,0,4
Libya,Iraq,1966,0,2,2
Iran,Turkey,1966,0,0,0
Iraq,Morocco,1966,0,1,1
France,Italy,1966,0,0,0
Iraq,Morocco,1966,1,2,3
Netherlands,Germany,1966,2,4,6
Panama,El Salvador,1966,1,0,1
Libya,Malta,1966,0,1,1
Wales,Northern Ireland,1966,1,4,5
Montenegro,Russia,1966,0,1,1
Libya,Palestine,1966,0,0,0
Iraq,Kuwait,1966,3,1,4
Scotland,England,1966,3,4,7
Syria,Yemen,1966,4,1,5
Iraq,Jordan,1966,2,1,3
Lebanon,Bahrain,1966,6,1,7
Libya,Oman,1966,21,0,21
Kenya,Uganda,1966,3,3,6
Kuwait,Lebanon,1966,1,2,3
Libya,Syria,1966,0,0,0
Palestine,Yemen,1966,7,0,7
Jordan,Lebanon,1966,1,2,3
Iraq,Bahrain,1966,10,1,11
Bahrain,Kuwait,1966,4,4,8
Israel,Finland,1966,7,1,8
Libya,Yemen,1966,13,0,13
Palestine,Syria,1966,1,3,4
Iraq,Lebanon,1966,0,0,0
Bahrain,Jordan,1966,1,5,6
Jordan,Kuwait,1966,0,4,4
Iraq,Libya,1966,3,1,4
Lebanon,Syria,1966,0,1,1
Nigeria,Togo,1966,1,1,2
Benin,Ghana,1966,2,5,7
Iraq,Syria,1966,2,1,3
Libya,Lebanon,1966,6,1,7
Chile,Brazil,1966,0,1,1
Netherlands,Belgium,1966,3,1,4
Chile,Brazil,1966,2,1,3
France,Belgium,1966,0,3,3
Switzerland,Russia,1966,2,2,4
Austria,Russia,1966,0,1,1
Mexico,Paraguay,1966,7,0,7
Togo,Benin,1966,1,0,1
German DR,Sweden,1966,4,1,5
Poland,Hungary,1966,1,1,2
England,Yugoslavia,1966,2,0,2
Republic of Ireland,Germany,1966,0,4,4
Northern Ireland,Germany,1966,0,2,2
Finland,Israel,1966,0,3,3
Yugoslavia,Hungary,1966,2,0,2
Mexico,Chile,1966,1,0,1
Scotland,Netherlands,1966,0,3,3
Brazil,Wales,1966,3,1,4
Brazil,Chile,1966,1,1,2
Paraguay,Uruguay,1966,2,2,4
Brazil,Wales,1966,1,0,1
Czechoslovakia,Russia,1966,1,2,3
Poland,Sweden,1966,1,1,2
Uruguay,Paraguay,1966,3,1,4
Brazil,Chile,1966,1,0,1
Austria,Republic of Ireland,1966,1,0,1
Belgium,Russia,1966,0,1,1
Chile,Wales,1966,2,0,2
Belgium,Republic of Ireland,1966,2,3,5
Lithuania,Libya,1966,6,0,6
Benin,Togo,1966,2,2,4
Chile,Mexico,1966,0,1,1
Denmark,Turkey,1966,0,0,0
Germany,Romania,1966,1,0,1
Yugoslavia,Bulgaria,1966,0,2,2
Brazil,Peru,1966,4,0,4
Finland,Sweden,1966,1,0,1
Brazil,Poland,1966,4,1,5
Hungary,Switzerland,1966,3,1,4
Russia,France,1966,3,3,6
Brazil,Poland,1966,2,1,3
Brazil,Peru,1966,3,1,4
Curaçao,Jamaica,1966,0,0,0
Trinidad and Tobago,Suriname,1966,3,2,5
Argentina,Poland,1966,1,1,2
Haiti,Guadeloupe,1966,3,0,3
Brazil,Czechoslovakia,1966,2,1,3
Portugal,Norway,1966,4,0,4
Trinidad and Tobago,Curaçao,1966,1,0,1
Haiti,Suriname,1966,1,4,5
Jamaica,Guadeloupe,1966,0,0,0
Italy,Bulgaria,1966,6,1,7
Brazil,Czechoslovakia,1966,2,2,4
Guadeloupe,Suriname,1966,0,4,4
Israel,Uruguay,1966,1,2,3
Trinidad and Tobago,Jamaica,1966,4,1,5
Haiti,Curaçao,1966,3,0,3
Jamaica,Suriname,1966,3,5,8
Guadeloupe,Curaçao,1966,0,4,4
Haiti,Trinidad and Tobago,1966,1,0,1
Italy,Austria,1966,1,0,1
Scotland,Portugal,1966,0,1,1
Romania,Uruguay,1966,1,0,1
Switzerland,Mexico,1966,1,1,2
Curaçao,Suriname,1966,1,1,2
Trinidad and Tobago,Guadeloupe,1966,1,2,3
Denmark,Portugal,1966,1,3,4
Haiti,Jamaica,1966,3,0,3
Italy,Argentina,1966,3,0,3
Northern Ireland,Mexico,1966,4,1,5
Germany,Yugoslavia,1966,2,0,2
Spain,Uruguay,1966,1,1,2
Scotland,Brazil,1966,1,1,2
Denmark,Norway,1966,0,1,1
Finland,England,1966,0,3,3
Portugal,Uruguay,1966,3,0,3
Sweden,Yugoslavia,1966,1,1,2
China PR,Tanzania,1966,10,4,14
Italy,Mexico,1966,5,0,5
Norway,England,1966,1,6,7
DR Congo,Ghana,1966,0,3,3
Sweden,Brazil,1966,2,3,5
Zambia,Malawi,1966,4,1,5
German DR,Chile,1966,5,2,7
Denmark,England,1966,0,2,2
Portugal,Romania,1966,1,0,1
Malawi,Zambia,1966,0,3,3
Madagascar,Zambia,1966,0,3,3
Poland,England,1966,0,1,1
Malawi,Zambia,1966,0,6,6
Ethiopia,Uganda,1966,5,0,5
Malawi,Zambia,1966,1,5,6
Malawi,Madagascar,1966,1,6,7
Ethiopia,Sudan,1966,1,1,2
England,Uruguay,1966,0,0,0
Brazil,Bulgaria,1966,2,0,2
Germany,Switzerland,1966,5,0,5
North Korea,Russia,1966,0,3,3
Argentina,Spain,1966,2,1,3
Chile,Italy,1966,0,2,2
France,Mexico,1966,1,1,2
Hungary,Portugal,1966,1,3,4
Brazil,Hungary,1966,1,3,4
Chile,North Korea,1966,1,1,2
France,Uruguay,1966,1,2,3
Spain,Switzerland,1966,2,1,3
Argentina,Germany,1966,0,0,0
Bulgaria,Portugal,1966,0,3,3
England,Mexico,1966,2,0,2
Italy,Russia,1966,0,1,1
Sudan,Uganda,1966,2,1,3
Argentina,Switzerland,1966,2,0,2
Brazil,Portugal,1966,1,3,4
Italy,North Korea,1966,0,1,1
Mexico,Uruguay,1966,0,0,0
Bulgaria,Hungary,1966,1,3,4
Chile,Russia,1966,1,2,3
England,France,1966,2,0,2
Germany,Spain,1966,2,1,3
China PR,Syria,1966,6,0,6
England,Argentina,1966,1,0,1
Germany,Uruguay,1966,4,0,4
Hungary,Russia,1966,1,2,3
North Korea,Portugal,1966,3,5,8
Germany,Russia,1966,2,1,3
England,Portugal,1966,2,1,3
Portugal,Russia,1966,2,1,3
England,Germany,1966,4,2,6
Cameroon,Congo,1966,2,3,5
DR Congo,Central African Republic,1966,5,0,5
Myanmar,Singapore,1966,2,2,4
Malaysia,Vietnam Republic,1966,5,2,7
Hong Kong,India,1966,0,2,2
South Korea,Japan,1966,2,0,2
Norway,Finland,1966,1,1,2
Taiwan,Thailand,1966,2,1,3
Togo,Ivory Coast,1966,1,2,3
Myanmar,Thailand,1966,3,0,3
Taiwan,Vietnam Republic,1966,0,3,3
India,Japan,1966,3,0,3
Togo,Ghana,1966,1,1,2
Hong Kong,South Korea,1966,0,1,1
Malaysia,Thailand,1966,0,0,0
Singapore,Taiwan,1966,4,1,5
Japan,Taiwan,1966,5,2,7
Singapore,Vietnam Republic,1966,1,2,3
Ghana,Togo,1966,6,2,8
South Korea,Thailand,1966,2,1,3
Hong Kong,Myanmar,1966,0,2,2
India,Singapore,1966,0,1,1
Japan,Vietnam Republic,1966,0,2,2
Myanmar,South Korea,1966,2,0,2
Hong Kong,Thailand,1966,2,2,4
India,Taiwan,1966,1,0,1
Malaysia,Myanmar,1966,0,0,0
Malaysia,Hong Kong,1966,1,0,1
Singapore,Japan,1966,0,1,1
India,Vietnam Republic,1966,1,0,1
Malaysia,South Korea,1966,1,2,3
Myanmar,Vietnam Republic,1966,0,1,1
China PR,Mali,1966,4,0,4
Guinea,Cameroon,1966,2,2,4
India,South Korea,1966,1,0,1
Singapore,Vietnam Republic,1966,2,2,4
Guinea,Mali,1966,5,0,5
Singapore,South Korea,1966,1,3,4
German DR,Egypt,1966,6,0,6
Zambia,Kenya,1966,0,1,1
Netherlands,Hungary,1966,2,2,4
Zambia,Kenya,1966,2,1,3
German DR,Poland,1966,2,0,2
Zambia,Kenya,1966,5,4,9
Austria,Netherlands,1966,2,1,3
Finland,Denmark,1966,2,1,3
Norway,Sweden,1966,2,4,6
Yugoslavia,Russia,1966,1,2,3
German DR,Romania,1966,2,0,2
Hungary,Denmark,1966,6,0,6
Zanzibar,Kenya,1966,1,3,4
Tanzania,Uganda,1966,0,3,3
Kenya,Uganda,1966,0,0,0
Hungary,France,1966,4,2,6
Zanzibar,Tanzania,1966,0,4,4
Tanzania,Kenya,1966,2,3,5
Zanzibar,Uganda,1966,0,0,0
Finland,Austria,1966,0,0,0
Poland,Luxembourg,1966,4,0,4
Sweden,Austria,1966,4,1,5
Israel,Yugoslavia,1966,1,3,4
Turkey,Germany,1966,0,2,2
French Guiana,Suriname,1966,3,3,6
French Guiana,Suriname,1966,0,3,3
Greece,Finland,1966,2,1,3
Russia,Turkey,1966,0,2,2
Yugoslavia,Czechoslovakia,1966,1,0,1
Belgium,Switzerland,1966,1,0,1
France,Poland,1966,2,1,3
Northern Ireland,England,1966,0,2,2
Wales,Scotland,1966,1,1,2
Republic of Ireland,Spain,1966,0,0,0
Russia,German DR,1966,2,2,4
Denmark,Israel,1966,3,1,4
Hungary,Austria,1966,3,1,4
Cameroon,Togo,1966,2,0,2
Italy,Russia,1966,1,0,1
Ivory Coast,Ghana,1966,1,1,2
Vietnam Republic,Malaysia,1966,3,2,5
England,Czechoslovakia,1966,0,0,0
Romania,Switzerland,1966,4,2,6
Malaysia,Thailand,1966,1,1,2
Dominica,Saint Vincent and the Grenadines,1966,0,1,1
Nigeria,DR Congo,1966,3,2,5
Vietnam Republic,Thailand,1966,4,1,5
Bulgaria,Yugoslavia,1966,6,1,7
Grenada,Saint Lucia,1966,7,1,8
Netherlands,Czechoslovakia,1966,1,2,3
Sweden,Denmark,1966,2,1,3
Grenada,Dominica,1966,3,3,6
Saint Lucia,Saint Vincent and the Grenadines,1966,1,2,3
Dominica,Saint Lucia,1966,5,3,8
Belgium,France,1966,2,1,3
Grenada,Saint Vincent and the Grenadines,1966,1,3,4
Sierra Leone,Liberia,1966,1,1,2
Bulgaria,Norway,1966,4,2,6
Portugal,Sweden,1966,1,2,3
England,Wales,1966,5,1,6
Republic of Ireland,Turkey,1966,2,1,3
Scotland,Northern Ireland,1966,2,1,3
Romania,Poland,1966,4,3,7
Germany,Norway,1966,3,0,3
Liberia,Sierra Leone,1966,2,0,2
Mali,Guinea,1966,1,0,1
Algeria,Morocco,1966,2,2,4
DR Congo,Nigeria,1966,1,0,1
Palestine,Yemen,1966,5,3,8
Cambodia,North Korea,1966,0,2,2
China PR,Palestine,1966,7,0,7
Italy,Romania,1966,3,1,4
Luxembourg,France,1966,0,3,3
North Vietnam,Yemen,1966,9,0,9
Cambodia,China PR,1966,0,4,4
Palestine,North Vietnam,1966,0,4,4
Cambodia,Yemen,1966,8,0,8
Palestine,North Korea,1966,1,5,6
Cambodia,North Vietnam,1966,2,2,4
Chile,Colombia,1966,5,2,7
China PR,North Vietnam,1966,2,0,2
North Korea,Yemen,1966,14,0,14
Netherlands,Denmark,1966,2,0,2
Uganda,Kenya,1966,1,2,3
DR Congo,Gabon,1966,4,3,7
Central African Republic,DR Congo,1966,1,4,5
China PR,North Korea,1966,1,2,3
Cyprus,Romania,1966,1,5,6
Israel,Poland,1966,0,0,0
China PR,Yemen,1966,6,0,6
North Korea,North Vietnam,1966,3,1,4
Israel,Romania,1966,1,2,3
Spain,Republic of Ireland,1966,2,0,2
Libya,Egypt,1966,2,2,4
Papua New Guinea,Tahiti,1966,3,4,7
Kenya,Sudan,1966,0,1,1
Colombia,Chile,1966,0,0,0
Tahiti,Wallis Islands and Futuna,1966,5,0,5
Kenya,Sudan,1966,3,2,5
New Caledonia,Vanuatu,1966,5,0,5
New Caledonia,Solomon Islands,1966,8,0,8
Papua New Guinea,Wallis Islands and Futuna,1966,9,1,10
Solomon Islands,Vanuatu,1966,4,4,8
New Caledonia,Papua New Guinea,1966,4,0,4
Tahiti,Vanuatu,1966,3,0,3
New Caledonia,Tahiti,1966,0,2,2
Papua New Guinea,Vanuatu,1966,2,5,7
Ecuador,Paraguay,1966,2,2,4
Paraguay,Ecuador,1966,3,1,4
Gabon,DR Congo,1967,1,0,1
Uruguay,Romania,1967,1,1,2
Mexico,Switzerland,1967,3,0,3
Mexico,Switzerland,1967,0,2,2
Jamaica,Curaçao,1967,1,1,2
Cuba,Haiti,1967,1,1,2
Curaçao,Trinidad and Tobago,1967,1,2,3
Jamaica,Cuba,1967,2,1,3
Haiti,Trinidad and Tobago,1967,4,2,6
Uruguay,Bolivia,1967,4,0,4
Curaçao,Cuba,1967,2,2,4
Egypt,German DR,1967,1,2,3
Argentina,Paraguay,1967,4,1,5
Chile,Venezuela,1967,2,0,2
Guatemala,Honduras,1967,3,1,4
Jamaica,Trinidad and Tobago,1967,1,1,2
Curaçao,Haiti,1967,0,1,1
Cuba,Trinidad and Tobago,1967,1,2,3
Egypt,German DR,1967,0,3,3
Jamaica,Haiti,1967,0,1,1
Martinique,Guadeloupe,1967,2,1,3
Uruguay,Venezuela,1967,4,0,4
Bolivia,Argentina,1967,0,1,1
Chile,Paraguay,1967,4,2,6
DR Congo,Congo,1967,4,1,5
Honduras,Guatemala,1967,1,1,2
Tunisia,Turkey,1967,0,0,0
Martinique,French Guiana,1967,2,1,3
Egypt,German DR,1967,2,2,4
Argentina,Venezuela,1967,5,1,6
Paraguay,Bolivia,1967,1,0,1
Uruguay,Chile,1967,2,2,4
Liberia,Guinea,1967,2,2,4
Argentina,Chile,1967,2,0,2
Bolivia,Venezuela,1967,0,3,3
Nigeria,Ghana,1967,2,2,4
Burkina Faso,Niger,1967,3,2,5
Sudan,German DR,1967,1,2,3
Uruguay,Paraguay,1967,2,0,2
Niger,Congo,1967,1,3,4
Bolivia,Chile,1967,0,0,0
Turkey,Spain,1967,0,0,0
Venezuela,Paraguay,1967,3,5,8
Uruguay,Argentina,1967,1,0,1
Mali,Congo,1967,1,0,1
Mali,Algeria,1967,0,3,3
Tunisia,Cameroon,1967,4,0,4
Nicaragua,Panama,1967,3,1,4
Burkina Faso,Algeria,1967,1,2,3
Ghana,Nigeria,1967,2,0,2
Iraq,German DR,1967,1,1,2
Guatemala,Panama,1967,3,1,4
Guatemala,Nicaragua,1967,3,1,4
Greece,Libya,1967,4,0,4
Togo,DR Congo,1967,2,4,6
Ethiopia,Kenya,1967,2,0,2
Ghana,Ivory Coast,1967,2,2,4
Tunisia,Congo,1967,1,1,2
Sudan,Tanzania,1967,1,0,1
Germany,Morocco,1967,5,1,6
Turkey,Republic of Ireland,1967,2,1,3
Kenya,Tanzania,1967,2,0,2
Sudan,Ethiopia,1967,1,1,2
Uganda,DR Congo,1967,0,5,5
Guinea,Senegal,1967,3,0,3
Cameroon,Congo,1967,1,1,2
Sudan,Ethiopia,1967,5,3,8
Ethiopia,Sudan,1967,2,1,3
France,Corsica,1967,0,2,2
Benin,Congo,1967,1,1,2
Ivory Coast,Liberia,1967,1,1,2
Honduras,Trinidad and Tobago,1967,1,0,1
Uganda,Kenya,1967,2,1,3
Haiti,Guatemala,1967,1,2,3
Mexico,Nicaragua,1967,4,0,4
Libya,Sudan,1967,1,1,2
Greece,Romania,1967,1,2,3
Haiti,Trinidad and Tobago,1967,2,3,5
Honduras,Guatemala,1967,1,1,2
Guatemala,Mexico,1967,1,0,1
Haiti,Nicaragua,1967,2,1,3
Iraq,Sudan,1967,2,2,4
Libya,Iraq,1967,0,1,1
Kenya,Uganda,1967,3,3,6
Honduras,Guatemala,1967,0,0,0
Mexico,Trinidad and Tobago,1967,4,0,4
Algeria,Mali,1967,1,0,1
Nigeria,Ivory Coast,1967,0,0,0
Haiti,Mexico,1967,0,1,1
Trinidad and Tobago,Guatemala,1967,0,2,2
Nicaragua,Trinidad and Tobago,1967,1,3,4
Honduras,Haiti,1967,2,0,2
DR Congo,Sudan,1967,3,2,5
Congo,Ghana,1967,3,1,4
Honduras,Mexico,1967,0,1,1
Guatemala,Nicaragua,1967,2,0,2
Luxembourg,Belgium,1967,0,5,5
Senegal,Guinea,1967,4,1,5
Algeria,Hungary,1967,0,1,1
Cyprus,Italy,1967,0,2,2
France,Romania,1967,1,2,3
Germany,Bulgaria,1967,1,0,1
Hong Kong,Vietnam Republic,1967,2,0,2
Egypt,Libya,1967,3,2,5
Thailand,Vietnam Republic,1967,0,1,1
Italy,Portugal,1967,1,1,2
Gabon,Ivory Coast,1967,0,3,3
Vietnam Republic,Malaysia,1967,0,2,2
Guinea,Liberia,1967,3,0,3
Sudan,DR Congo,1967,1,0,1
Togo,Niger,1967,1,0,1
Vietnam Republic,Singapore,1967,3,0,3
German DR,Netherlands,1967,4,3,7
Germany,Albania,1967,6,0,6
Algeria,Burkina Faso,1967,3,1,4
Liberia,Senegal,1967,1,1,2
Northern Ireland,Wales,1967,0,0,0
England,Scotland,1967,2,3,5
Nigeria,Togo,1967,4,2,6
Belgium,Netherlands,1967,1,0,1
Luxembourg,Poland,1967,0,0,0
Congo,DR Congo,1967,3,1,4
Hungary,Yugoslavia,1967,1,0,1
Romania,Cyprus,1967,7,0,7
Ivory Coast,Togo,1967,3,0,3
Switzerland,Czechoslovakia,1967,1,2,3
Yugoslavia,Germany,1967,1,0,1
Ivory Coast,Nigeria,1967,2,0,2
Finland,Greece,1967,1,1,2
Hungary,Netherlands,1967,2,1,3
Scotland,Russia,1967,0,2,2
Albania,Yugoslavia,1967,0,2,2
Suriname,French Guiana,1967,6,1,7
Suriname,French Guiana,1967,3,0,3
Israel,Scotland,1967,1,2,3
Congo,Tanzania,1967,6,1,7
Sweden,German DR,1967,0,1,1
Congo,Cameroon,1967,2,1,3
Republic of Ireland,Czechoslovakia,1967,0,2,2
Poland,Belgium,1967,3,1,4
Denmark,Hungary,1967,0,2,2
England,Spain,1967,2,0,2
Ghana,DR Congo,1967,2,0,2
Switzerland,Romania,1967,7,1,8
Austria,England,1967,0,1,1
Russia,Mexico,1967,2,0,2
Spain,Turkey,1967,2,0,2
Finland,Norway,1967,0,2,2
Russia,Mexico,1967,0,1,1
Sweden,Portugal,1967,1,1,2
France,Russia,1967,2,4,6
Belarus,Mexico,1967,2,1,3
Denmark,German DR,1967,1,1,2
Uganda,Egypt,1967,0,1,1
Norway,Portugal,1967,1,2,3
Russia,Austria,1967,4,3,7
Sweden,Bulgaria,1967,0,2,2
Czechoslovakia,Turkey,1967,3,0,3
Uganda,Zambia,1967,1,3,4
Denmark,Sweden,1967,1,1,2
Romania,Italy,1967,0,1,1
Uruguay,Brazil,1967,0,0,0
Uruguay,Brazil,1967,2,2,4
Norway,Bulgaria,1967,0,0,0
Uruguay,Brazil,1967,1,1,2
Senegal,Liberia,1967,4,1,5
Tanzania,Zambia,1967,2,2,4
Benin,Ghana,1967,2,1,3
Tanzania,Zambia,1967,2,1,3
Russia,Greece,1967,4,0,4
Peru,Uruguay,1967,0,1,1
South Korea,Indonesia,1967,1,1,2
Guyana,Suriname,1967,2,2,4
Peru,Uruguay,1967,1,2,3
Guyana,Suriname,1967,0,1,1
Japan,South Korea,1967,2,1,3
Mauritania,Tanzania,1967,1,1,2
Niger,Burkina Faso,1967,2,3,5
DR Congo,Ethiopia,1967,1,0,1
Guyana,Suriname,1967,0,2,2
Tanzania,Mauritius,1967,1,0,1
Japan,Philippines,1967,2,0,2
Japan,Indonesia,1967,2,1,3
South Korea,Philippines,1967,7,0,7
Indonesia,Philippines,1967,6,0,6
DR Congo,Mali,1967,2,2,4
Hong Kong,Thailand,1967,1,0,1
Malaysia,Western Australia,1967,3,2,5
Sweden,Finland,1967,2,0,2
Indonesia,South Korea,1967,1,3,4
Singapore,Taiwan,1967,3,3,6
Hong Kong,Vietnam Republic,1967,0,5,5
India,Thailand,1967,1,1,2
Myanmar,South Korea,1967,0,1,1
DR Congo,Sudan,1967,2,1,3
India,Western Australia,1967,3,1,4
Indonesia,Singapore,1967,4,1,5
Malaysia,Hong Kong,1967,3,0,3
Myanmar,Singapore,1967,3,0,3
Chile,Argentina,1967,1,0,1
Indonesia,Taiwan,1967,2,1,3
Malaysia,Vietnam Republic,1967,1,1,2
Thailand,Western Australia,1967,1,3,4
Hong Kong,India,1967,0,4,4
Mauritius,Tanzania,1967,1,1,2
Togo,Ivory Coast,1967,0,2,2
Vietnam Republic,Western Australia,1967,3,0,3
Hong Kong,Western Australia,1967,3,2,5
South Korea,Taiwan,1967,2,1,3
Myanmar,Indonesia,1967,5,0,5
Kenya,DR Congo,1967,5,4,9
Malaysia,India,1967,0,0,0
Thailand,Vietnam Republic,1967,2,5,7
Myanmar,Taiwan,1967,1,2,3
Malaysia,Thailand,1967,1,0,1
India,Vietnam Republic,1967,0,1,1
Kenya,DR Congo,1967,1,1,2
South Korea,Singapore,1967,3,0,3
Myanmar,Vietnam Republic,1967,3,0,3
India,Taiwan,1967,1,1,2
Mexico,Argentina,1967,2,1,3
Denmark,Iceland,1967,14,2,16
Hong Kong,Indonesia,1967,2,1,3
Malaysia,South Korea,1967,1,3,4
Singapore,Western Australia,1967,3,5,8
Hong Kong,Taiwan,1967,2,4,6
Malaysia,Vietnam Republic,1967,1,2,3
Myanmar,South Korea,1967,0,0,0
India,Indonesia,1967,0,3,3
Singapore,Vietnam Republic,1967,1,0,1
Russia,Finland,1967,2,0,2
DR Congo,Ghana,1967,0,2,2
Norway,Sweden,1967,3,1,4
Austria,Hungary,1967,1,3,4
Finland,Russia,1967,2,5,7
Netherlands,German DR,1967,1,0,1
DR Congo,Tanzania,1967,1,0,1
Poland,France,1967,1,4,5
Chile,Brazil,1967,0,1,1
Austria,Finland,1967,2,1,3
Norway,Denmark,1967,0,5,5
Germany,France,1967,5,1,6
Hungary,German DR,1967,3,1,4
Mali,Burkina Faso,1967,4,0,4
Ghana,Nigeria,1967,1,1,2
Kenya,Uganda,1967,3,1,4
Czechoslovakia,Spain,1967,1,0,1
Ghana,Burkina Faso,1967,5,2,7
Russia,Switzerland,1967,2,2,4
Tanzania,Uganda,1967,1,2,3
Denmark,Netherlands,1967,3,2,5
Greece,Austria,1967,4,1,5
Kenya,Zanzibar,1967,6,0,6
Trinidad and Tobago,Martinique,1967,2,2,4
Uganda,Zanzibar,1967,2,0,2
Germany,Yugoslavia,1967,3,1,4
Singapore,Hong Kong,1967,4,0,4
Belgium,Poland,1967,2,4,6
Bulgaria,Russia,1967,1,2,3
Kenya,Tanzania,1967,5,3,8
El Salvador,Haiti,1967,2,0,2
Tanzania,Zanzibar,1967,0,3,3
German DR,Denmark,1967,3,2,5
Paraguay,Argentina,1967,1,1,2
Tanzania,DR Congo,1967,0,1,1
Sierra Leone,Nigeria,1967,1,1,2
Austria,Russia,1967,1,0,1
Liberia,DR Congo,1967,1,4,5
Ghana,Nigeria,1967,2,1,3
Northern Ireland,Scotland,1967,1,0,1
Wales,England,1967,0,3,3
Denmark,Finland,1967,3,0,3
Guatemala,El Salvador,1967,1,0,1
Spain,Czechoslovakia,1967,2,1,3
Trinidad and Tobago,Martinique,1967,3,2,5
France,Belgium,1967,1,1,2
El Salvador,Costa Rica,1967,3,1,4
German DR,Hungary,1967,1,0,1
Poland,Romania,1967,0,0,0
Uganda,Ethiopia,1967,2,3,5
Greece,Russia,1967,0,1,1
Italy,Cyprus,1967,5,0,5
Netherlands,Yugoslavia,1967,1,2,3
Malaysia,Thailand,1967,3,2,5
Vietnam Republic,Singapore,1967,2,0,2
Australia,New Zealand,1967,5,3,8
Austria,Greece,1967,1,1,2
El Salvador,Guatemala,1967,1,3,4
Hong Kong,South Korea,1967,0,1,1
Puerto Rico,Martinique,1967,3,6,9
Sweden,Norway,1967,5,2,7
South Korea,Thailand,1967,3,1,4
Vietnam Republic,Australia,1967,0,1,1
Chile,Argentina,1967,3,1,4
Hong Kong,Malaysia,1967,0,2,2
New Caledonia,New Zealand,1967,4,0,4
New Zealand,Singapore,1967,3,1,4
Puerto Rico,Guadeloupe,1967,2,4,6
Switzerland,Cyprus,1967,5,0,5
Hong Kong,Thailand,1967,1,5,6
Vietnam Republic,New Zealand,1967,5,1,6
Australia,Singapore,1967,5,1,6
Guadeloupe,Martinique,1967,0,1,1
South Korea,Malaysia,1967,2,1,3
Australia,Malaysia,1967,1,0,1
Bulgaria,Sweden,1967,3,0,3
Myanmar,India,1967,2,0,2
Portugal,Norway,1967,2,1,3
Vietnam Republic,South Korea,1967,0,3,3
Yugoslavia,Albania,1967,4,0,4
Zimbabwe,Malawi,1967,1,0,1
Australia,South Korea,1967,3,2,5
Vietnam Republic,Malaysia,1967,4,1,5
Burkina Faso,Mali,1967,0,1,1
India,Pakistan,1967,1,1,2
Turkey,Czechoslovakia,1967,0,0,0
Myanmar,Cambodia,1967,1,0,1
Malaysia,New Zealand,1967,2,8,10
Switzerland,Italy,1967,2,2,4
Myanmar,Pakistan,1967,2,0,2
Belgium,Luxembourg,1967,3,0,3
Czechoslovakia,Republic of Ireland,1967,1,2,3
England,Northern Ireland,1967,2,0,2
Romania,Germany,1967,1,0,1
Scotland,Wales,1967,3,2,5
Senegal,Guinea,1967,2,1,3
Benin,DR Congo,1967,2,5,7
Zimbabwe,Mauritius,1967,1,2,3
Bulgaria,Portugal,1967,1,0,1
Burkina Faso,Ivory Coast,1967,3,2,5
Grenada,Saint Vincent and the Grenadines,1967,1,1,2
Iran,Turkey,1967,0,1,1
Trinidad and Tobago,Jamaica,1967,1,0,1
Zimbabwe,Mauritius,1967,2,3,5
Dominica,Saint Lucia,1967,2,4,6
Pakistan,Turkey,1967,4,7,11
Netherlands,Russia,1967,3,1,4
Saint Lucia,Saint Vincent and the Grenadines,1967,4,3,7
Dominica,Grenada,1967,2,4,6
Grenada,Saint Lucia,1967,2,1,3
Sierra Leone,Guinea,1967,2,1,3
Trinidad and Tobago,Jamaica,1967,1,0,1
Dominica,Saint Vincent and the Grenadines,1967,1,2,3
Mali,Congo,1967,1,1,2
England,Russia,1967,2,2,4
Mauritius,Ethiopia,1967,0,2,2
Mexico,Hungary,1967,2,1,3
Mexico,Hungary,1967,0,2,2
Saudi Arabia,Tunisia,1967,4,0,4
Chile,Hungary,1967,4,5,9
Chile,Russia,1967,1,4,5
Albania,Germany,1967,0,0,0
Kenya,Zambia,1967,1,5,6
Portugal,Bulgaria,1967,0,0,0
France,Luxembourg,1967,3,1,4
Italy,Switzerland,1967,4,0,4
Nigeria,Ghana,1967,2,2,4
DR Congo,Romania,1967,1,1,2
Ethiopia,Kenya,1967,2,0,2
Israel,Belgium,1968,0,2,2
Algeria,Ivory Coast,1968,0,3,3
Congo,DR Congo,1968,0,3,3
Ethiopia,Uganda,1968,2,1,3
Ghana,Senegal,1968,2,2,4
Algeria,Uganda,1968,4,0,4
Congo,Senegal,1968,1,2,3
DR Congo,Ghana,1968,1,2,3
Ethiopia,Ivory Coast,1968,1,0,1
Congo,Ghana,1968,1,3,4
DR Congo,Senegal,1968,2,1,3
Ethiopia,Algeria,1968,3,1,4
Ivory Coast,Uganda,1968,2,1,3
Ethiopia,DR Congo,1968,2,3,5
Ghana,Ivory Coast,1968,4,3,7
DR Congo,Ghana,1968,1,0,1
Ethiopia,Ivory Coast,1968,0,1,1
Nigeria,Sierra Leone,1968,4,1,5
Israel,Switzerland,1968,2,1,3
Cyprus,Switzerland,1968,2,1,3
Israel,Sweden,1968,0,3,3
Scotland,England,1968,1,1,2
Burkina Faso,Guinea,1968,2,0,2
Spain,Sweden,1968,3,1,4
Wales,Northern Ireland,1968,2,0,2
Mexico,Russia,1968,0,0,0
Belgium,Germany,1968,1,3,4
Guinea,DR Congo,1968,1,0,1
Mexico,Russia,1968,1,1,2
Mexico,Russia,1968,0,0,0
Turkey,Tunisia,1968,0,0,0
Morocco,Algeria,1968,0,0,0
Mexico,Japan,1968,4,0,4
Australia,Japan,1968,2,2,4
Australia,Japan,1968,3,1,4
Guinea,Burkina Faso,1968,3,1,4
Guinea,Burkina Faso,1968,1,3,4
England,Spain,1968,1,0,1
Australia,Japan,1968,1,3,4
Barbados,Suriname,1968,0,2,2
Bulgaria,Italy,1968,3,2,5
France,Yugoslavia,1968,1,1,2
Netherlands,Belgium,1968,1,2,3
Togo,Guinea,1968,1,1,2
Barbados,Suriname,1968,0,0,0
Benin,Guinea,1968,2,5,7
Martinique,Suriname,1968,1,3,4
Martinique,Suriname,1968,3,2,5
Switzerland,Germany,1968,0,0,0
Italy,Bulgaria,1968,2,0,2
Poland,Turkey,1968,8,0,8
Russia,Belgium,1968,1,0,1
Yugoslavia,France,1968,5,1,6
Czechoslovakia,Yugoslavia,1968,3,0,3
Austria,Romania,1968,1,1,2
Poland,Netherlands,1968,0,0,0
Eswatini,Malawi,1968,2,0,2
Sweden,Spain,1968,1,1,2
Hungary,Russia,1968,2,0,2
El Salvador,Guatemala,1968,3,0,3
Kenya,Nigeria,1968,1,2,3
Spain,England,1968,1,2,3
Wales,Germany,1968,1,1,2
Iran,Hong Kong,1968,2,0,2
Myanmar,Taiwan,1968,1,1,2
Russia,Hungary,1968,3,0,3
Hong Kong,Israel,1968,1,6,7
Iran,Taiwan,1968,4,0,4
Myanmar,Israel,1968,1,0,1
Hong Kong,Taiwan,1968,1,1,2
Republic of Ireland,Poland,1968,2,2,4
Paraguay,Argentina,1968,2,0,2
Iran,Myanmar,1968,3,1,4
Israel,Taiwan,1968,4,1,5
Myanmar,Hong Kong,1968,2,0,2
Austria,Cyprus,1968,7,1,8
Ghana,Ivory Coast,1968,2,1,3
Iran,Israel,1968,2,1,3
Mexico,Uruguay,1968,3,3,6
England,Sweden,1968,3,1,4
Mexico,Uruguay,1968,2,2,4
Netherlands,Scotland,1968,0,0,0
Germany,England,1968,1,0,1
Paraguay,Uruguay,1968,0,0,0
Finland,Denmark,1968,1,3,4
Argentina,Uruguay,1968,2,0,2
England,Yugoslavia,1968,0,1,1
Italy,Russia,1968,0,0,0
Romania,Netherlands,1968,0,0,0
England,Russia,1968,2,0,2
Italy,Yugoslavia,1968,1,1,2
Brazil,Uruguay,1968,2,0,2
Norway,Poland,1968,1,6,7
Italy,Yugoslavia,1968,2,0,2
Brazil,Uruguay,1968,4,0,4
Germany,Brazil,1968,2,1,3
Russia,Austria,1968,3,1,4
Finland,Belgium,1968,1,2,3
Poland,Brazil,1968,3,6,9
Uruguay,Argentina,1968,2,1,3
Czechoslovakia,Brazil,1968,3,2,5
Denmark,Norway,1968,5,1,6
Yugoslavia,Brazil,1968,0,2,2
Sweden,Denmark,1968,2,1,3
Zambia,Uganda,1968,2,1,3
Portugal,Brazil,1968,0,2,2
Zambia,Uganda,1968,1,1,2
Zambia,Uganda,1968,2,1,3
Zambia,Uganda,1968,2,2,4
Malawi,Kenya,1968,2,2,4
Mexico,Brazil,1968,0,2,2
Mexico,Brazil,1968,2,1,3
Malawi,Botswana,1968,8,1,9
Peru,Brazil,1968,3,4,7
Honduras,El Salvador,1968,0,0,0
Peru,Brazil,1968,0,4,4
Iceland,Norway,1968,0,4,4
Eswatini,Malawi,1968,2,0,2
Paraguay,Brazil,1968,0,4,4
Paraguay,Brazil,1968,1,0,1
El Salvador,Honduras,1968,2,1,3
Sweden,Russia,1968,2,2,4
Brazil,Argentina,1968,4,1,5
Malaysia,Hong Kong,1968,1,1,2
Myanmar,Vietnam Republic,1968,3,0,3
South Korea,Western Australia,1968,0,3,3
Brazil,Argentina,1968,3,2,5
Hong Kong,Thailand,1968,0,0,0
Singapore,Taiwan,1968,0,2,2
Malaysia,India,1968,2,1,3
Myanmar,Hong Kong,1968,3,0,3
India,Vietnam Republic,1968,3,2,5
Indonesia,Western Australia,1968,4,5,9
South Korea,Singapore,1968,3,2,5
Myanmar,Thailand,1968,0,0,0
South Korea,Taiwan,1968,2,1,3
Malaysia,Vietnam Republic,1968,4,0,4
El Salvador,Guatemala,1968,1,0,1
Hong Kong,India,1968,1,1,2
Western Australia,Taiwan,1968,3,2,5
Indonesia,Singapore,1968,4,0,4
Thailand,Vietnam Republic,1968,2,3,5
Malaysia,Thailand,1968,4,1,5
Myanmar,India,1968,1,3,4
Indonesia,South Korea,1968,4,2,6
Hong Kong,Vietnam Republic,1968,1,3,4
Malaysia,Myanmar,1968,1,1,2
Norway,Finland,1968,4,1,5
Peru,Chile,1968,1,2,3
Singapore,Western Australia,1968,4,4,8
India,Thailand,1968,0,1,1
Indonesia,Taiwan,1968,10,1,11
Myanmar,Indonesia,1968,2,1,3
South Korea,Thailand,1968,2,1,3
Peru,Chile,1968,0,0,0
Malaysia,Western Australia,1968,4,3,7
India,South Korea,1968,0,1,1
Indonesia,Western Australia,1968,1,3,4
Malaysia,Myanmar,1968,3,0,3
Singapore,South Korea,1968,4,3,7
Singapore,Vietnam Republic,1968,1,0,1
India,Indonesia,1968,1,3,4
Peru,Argentina,1968,2,2,4
India,Vietnam Republic,1968,0,2,2
Singapore,Indonesia,1968,1,0,1
Peru,Argentina,1968,1,1,2
Suriname,French Guiana,1968,2,1,3
Netherlands,Luxembourg,1968,2,0,2
Israel,Northern Ireland,1968,2,3,5
El Salvador,Costa Rica,1968,1,1,2
Finland,Sweden,1968,0,3,3
Norway,Sweden,1968,1,1,2
United States,Israel,1968,3,3,6
New Zealand,Fiji,1968,5,0,5
New Caledonia,Fiji,1968,2,1,3
Ghana,Benin,1968,3,0,3
Switzerland,Austria,1968,1,0,1
Denmark,Czechoslovakia,1968,0,3,3
France,Germany,1968,1,1,2
United States,Israel,1968,0,4,4
Yugoslavia,Finland,1968,9,1,10
Tanzania,Uganda,1968,0,2,2
Kenya,Zanzibar,1968,3,0,3
Mexico,Ethiopia,1968,3,0,3
Tanzania,Kenya,1968,3,3,6
Uganda,Zanzibar,1968,2,0,2
Curaçao,Costa Rica,1968,1,1,2
Kenya,Uganda,1968,1,1,2
Tanzania,Zanzibar,1968,3,0,3
Canada,Bermuda,1968,4,0,4
Suriname,Martinique,1968,7,0,7
New Zealand,New Caledonia,1968,1,3,4
Suriname,Martinique,1968,0,0,0
Belgium,Finland,1968,6,1,7
Sweden,Norway,1968,5,0,5
Turkey,Bulgaria,1968,0,2,2
Uganda,Zambia,1968,2,3,5
Switzerland,Greece,1968,1,0,1
Uganda,Zambia,1968,1,1,2
Austria,Germany,1968,0,2,2
Canada,United States,1968,4,2,6
Kenya,Zambia,1968,2,1,3
Ethiopia,Thailand,1968,6,0,6
Belgium,Yugoslavia,1968,3,0,3
Colombia,Mexico,1968,0,1,1
Denmark,Scotland,1968,0,1,1
France,Spain,1968,1,3,4
Bermuda,Canada,1968,0,0,0
Czechoslovakia,Denmark,1968,1,0,1
Haiti,United States,1968,3,6,9
Peru,Mexico,1968,3,3,6
Poland,German DR,1968,1,1,2
Haiti,United States,1968,5,2,7
Zambia,Tanzania,1968,7,1,8
Chile,Mexico,1968,3,1,4
Haiti,United States,1968,1,0,1
Northern Ireland,Turkey,1968,4,1,5
Wales,Italy,1968,0,1,1
Zambia,Tanzania,1968,2,1,3
Uruguay,Mexico,1968,0,2,2
Bulgaria,Netherlands,1968,2,0,2
Portugal,Romania,1968,3,0,3
Yugoslavia,Spain,1968,0,0,0
Zambia,Sudan,1968,4,2,6
Nigeria,Thailand,1968,7,2,9
Poland,Republic of Ireland,1968,1,0,1
Brazil,Mexico,1968,1,2,3
United States,Canada,1968,1,0,1
Brazil,Mexico,1968,2,1,3
Morocco,Senegal,1968,1,0,1
United States,Bermuda,1968,6,2,8
France,Norway,1968,0,1,1
Romania,England,1968,0,0,0
Scotland,Austria,1968,2,1,3
Sudan,Zambia,1968,4,2,6
Republic of Ireland,Austria,1968,2,2,4
Bermuda,United States,1968,0,2,2
Guadeloupe,Martinique,1968,3,1,4
Costa Rica,El Salvador,1968,3,0,3
Guadeloupe,Puerto Rico,1968,2,0,2
Martinique,Puerto Rico,1968,7,0,7
Sierra Leone,Gambia,1968,2,1,3
Algeria,Tunisia,1968,1,2,3
Guatemala,Trinidad and Tobago,1968,4,0,4
Zambia,Mauritius,1968,2,2,4
Saint Lucia,Dominica,1968,4,0,4
Myanmar,Laos,1968,3,0,3
Denmark,Luxembourg,1968,5,1,6
Dominica,Grenada,1968,2,6,8
Guatemala,Trinidad and Tobago,1968,0,0,0
Thailand,Singapore,1968,3,0,3
Indonesia,Malaysia,1968,1,0,1
Myanmar,Singapore,1968,2,0,2
Thailand,Laos,1968,1,0,1
Cyprus,Germany,1968,0,1,1
Dominica,Saint Vincent and the Grenadines,1968,1,1,2
Haiti,Trinidad and Tobago,1968,4,0,4
Romania,Switzerland,1968,2,0,2
Myanmar,Indonesia,1968,1,3,4
DR Congo,Tunisia,1968,1,0,1
Laos,Malaysia,1968,0,5,5
Suriname,Curaçao,1968,6,0,6
Haiti,Trinidad and Tobago,1968,2,4,6
Indonesia,Singapore,1968,7,0,7
Argentina,Chile,1968,4,0,4
Costa Rica,Jamaica,1968,3,0,3
Indonesia,Malaysia,1968,6,1,7
Thailand,Myanmar,1968,1,2,3
Cameroon,Tunisia,1968,4,2,6
Costa Rica,Jamaica,1968,3,1,4
El Salvador,Suriname,1968,6,0,6
Ghana,Senegal,1968,2,0,2
Thailand,Malaysia,1968,6,0,6
Myanmar,Indonesia,1968,0,1,1
Chile,Argentina,1968,2,1,3
Republic of Ireland,Denmark,1968,1,1,2
Curaçao,Suriname,1968,2,0,2
Honduras,Jamaica,1968,3,1,4
Nigeria,Cameroon,1968,1,1,2
Haiti,Guatemala,1968,2,0,2
Honduras,Jamaica,1968,2,0,2
Mauritius,Zambia,1968,2,3,5
New Caledonia,Tahiti,1968,0,1,1
Cyprus,Scotland,1968,0,5,5
England,Bulgaria,1968,1,1,2
Greece,Portugal,1968,4,2,6
Spain,Belgium,1968,1,1,2
Turkey,Northern Ireland,1968,0,3,3
El Salvador,Curaçao,1968,1,0,1
Kenya,Sudan,1968,1,1,2
Brazil,Germany,1968,2,2,4
Sierra Leone,Guinea,1968,1,1,2
El Salvador,Curaçao,1968,2,1,3
New Caledonia,Tahiti,1968,1,1,2
Argentina,Poland,1968,1,0,1
Brazil,Yugoslavia,1968,3,3,6
Chile,Germany,1968,2,1,3
Brazil,Yugoslavia,1968,3,2,5
Argentina,Yugoslavia,1968,1,1,2
Cameroon,Nigeria,1968,2,3,5
Honduras,Costa Rica,1968,1,0,1
Mexico,Germany,1968,0,0,0
Suriname,El Salvador,1968,4,1,5
Costa Rica,Honduras,1968,1,1,2
Tunisia,Algeria,1968,0,0,0
Mexico,Italy,1969,2,3,5
Ethiopia,Somalia,1969,7,0,7
Mexico,Italy,1969,1,1,2
Senegal,Morocco,1969,2,1,3
Kenya,Tanzania,1969,2,1,3
Somalia,Uganda,1969,1,7,8
Kenya,Sudan,1969,0,1,1
Sudan,Tanzania,1969,3,0,3
Ethiopia,Uganda,1969,4,0,4
Bermuda,Denmark,1969,1,5,6
Ethiopia,Sudan,1969,0,1,1
England,Romania,1969,1,1,2
Suriname,Denmark,1969,2,1,3
Saudi Arabia,Turkey,1969,1,2,3
Benin,Niger,1969,1,1,2
Congo,Senegal,1969,1,0,1
Mexico,Denmark,1969,3,0,3
Senegal,Cameroon,1969,3,2,5
DR Congo,Senegal,1969,4,0,4
Libya,Ethiopia,1969,2,0,2
DR Congo,Cameroon,1969,2,1,3
Malawi,Zimbabwe,1969,2,2,4
Guinea,Sierra Leone,1969,1,1,2
Uganda,Cameroon,1969,2,1,3
Cameroon,Uganda,1969,2,0,2
Mexico,Colombia,1969,1,0,1
Haiti,Jamaica,1969,1,2,3
Haiti,Jamaica,1969,3,0,3
Zimbabwe,Malawi,1969,4,0,4
Ethiopia,Libya,1969,5,1,6
Morocco,Hungary,1969,1,4,5
Zimbabwe,Malawi,1969,1,1,2
France,Hungary,1969,2,2,4
Morocco,Senegal,1969,2,0,2
Kenya,Tanzania,1969,0,1,1
Colombia,Russia,1969,1,3,4
Belgium,Spain,1969,2,1,3
Guatemala,Haiti,1969,1,1,2
Yugoslavia,Sweden,1969,2,1,3
Tanzania,Kenya,1969,1,1,2
Iran,Iraq,1969,2,1,3
Algeria,Morocco,1969,2,0,2
Iraq,Pakistan,1969,1,2,3
England,France,1969,5,0,5
Iran,Pakistan,1969,9,1,10
Israel,Greece,1969,3,3,6
Argentina,Paraguay,1969,1,1,2
Morocco,Algeria,1969,2,0,2
Greece,Cyprus,1969,1,0,1
Germany,Wales,1969,1,1,2
Netherlands,Luxembourg,1969,4,0,4
Spain,Switzerland,1969,1,0,1
German DR,Italy,1969,2,2,4
Portugal,Mexico,1969,0,0,0
Brazil,Peru,1969,2,1,3
Brazil,Peru,1969,3,2,5
Paraguay,Argentina,1969,0,0,0
Luxembourg,Mexico,1969,2,1,3
Belgium,Mexico,1969,2,0,2
German DR,Wales,1969,2,1,3
Greece,Romania,1969,2,2,4
Netherlands,Czechoslovakia,1969,2,0,2
Portugal,Switzerland,1969,0,2,2
Scotland,Germany,1969,1,1,2
Cyprus,Austria,1969,1,2,3
Haiti,United States,1969,2,0,2
Poland,Luxembourg,1969,8,1,9
Bulgaria,Luxembourg,1969,2,1,3
Israel,Austria,1969,1,1,2
Spain,Mexico,1969,0,0,0
French Guiana,Suriname,1969,1,2,3
Malta,Austria,1969,1,3,4
Tunisia,Morocco,1969,0,0,0
France,Romania,1969,1,0,1
Spain,Yugoslavia,1969,2,1,3
Turkey,Poland,1969,1,3,4
Sweden,Mexico,1969,1,0,1
Northern Ireland,England,1969,1,3,4
Wales,Scotland,1969,3,5,8
Ethiopia,Sudan,1969,1,1,2
Republic of Ireland,Czechoslovakia,1969,1,2,3
Portugal,Greece,1969,2,2,4
Denmark,Mexico,1969,3,1,4
Scotland,Northern Ireland,1969,1,1,2
England,Wales,1969,2,1,3
Netherlands,Poland,1969,1,0,1
Colombia,Peru,1969,1,3,4
Norway,Mexico,1969,0,2,2
England,Scotland,1969,4,1,5
Germany,Austria,1969,1,0,1
Nigeria,Ghana,1969,2,1,3
Northern Ireland,Wales,1969,0,0,0
Sudan,Ethiopia,1969,3,1,4
United States,Haiti,1969,0,1,1
El Salvador,Peru,1969,1,4,5
Switzerland,Romania,1969,0,1,1
Scotland,Cyprus,1969,8,0,8
Ghana,Nigeria,1969,1,1,2
Morocco,Tunisia,1969,0,0,0
Mexico,Peru,1969,0,1,1
Germany,Cyprus,1969,12,0,12
Guinea,Gambia,1969,6,2,8
Mexico,Peru,1969,3,0,3
Sweden,Finland,1969,4,0,4
Italy,Bulgaria,1969,0,0,0
Ethiopia,Tanzania,1969,7,0,7
Hungary,Czechoslovakia,1969,2,0,2
Denmark,Republic of Ireland,1969,2,0,2
Chile,Argentina,1969,1,1,2
Tanzania,Ethiopia,1969,1,2,3
Mexico,England,1969,0,0,0
Sweden,Norway,1969,4,2,6
Mexico,England,1969,0,4,4
Finland,Yugoslavia,1969,1,5,6
Honduras,El Salvador,1969,1,0,1
Republic of Ireland,Hungary,1969,1,2,3
Paraguay,Chile,1969,0,1,1
Uruguay,England,1969,1,2,3
Argentina,Chile,1969,2,1,3
Brazil,England,1969,2,1,3
Tunisia,Morocco,1969,2,2,4
Bulgaria,Poland,1969,4,1,5
Colombia,Chile,1969,3,3,6
Denmark,Hungary,1969,3,2,5
El Salvador,Honduras,1969,3,0,3
Peru,Colombia,1969,1,1,2
Norway,Sweden,1969,2,5,7
Ecuador,Colombia,1969,4,1,5
German DR,Chile,1969,0,1,1
Iceland,Bermuda,1969,2,1,3
Denmark,Sweden,1969,0,1,1
Finland,Spain,1969,2,0,2
German DR,Chile,1969,2,1,3
Honduras,El Salvador,1969,2,3,5
Peru,Uruguay,1969,1,0,1
Zambia,Cameroon,1969,2,2,4
Cameroon,Zambia,1969,2,1,3
Denmark,Bermuda,1969,6,0,6
Madagascar,Malawi,1969,3,0,3
Colombia,Uruguay,1969,0,1,1
Norway,Bermuda,1969,3,0,3
Chile,Paraguay,1969,0,0,0
Ecuador,Uruguay,1969,0,2,2
Malawi,Eswatini,1969,3,0,3
German DR,Egypt,1969,7,0,7
Peru,Paraguay,1969,2,1,3
Chile,Uruguay,1969,0,0,0
Peru,Paraguay,1969,2,1,3
Uruguay,Ecuador,1969,1,0,1
Congo,Tunisia,1969,4,1,5
Norway,Iceland,1969,2,1,3
Australia,Greece,1969,2,2,4
Finland,Iceland,1969,3,1,4
German DR,Russia,1969,2,2,4
New Caledonia,New Zealand,1969,0,0,0
Bolivia,Argentina,1969,3,1,4
Chile,Ecuador,1969,4,1,5
Colombia,Venezuela,1969,3,0,3
New Caledonia,New Zealand,1969,2,0,2
New Caledonia,New Zealand,1969,3,2,5
Venezuela,Colombia,1969,1,1,2
Ecuador,Chile,1969,1,1,2
Peru,Argentina,1969,1,0,1
Colombia,Brazil,1969,0,2,2
Russia,Sweden,1969,0,1,1
Venezuela,Paraguay,1969,0,2,2
Bolivia,Peru,1969,2,1,3
Colombia,Paraguay,1969,0,1,1
Uruguay,Chile,1969,2,0,2
Venezuela,Brazil,1969,0,5,5
Guinea,Togo,1969,4,0,4
Fiji,Solomon Islands,1969,5,1,6
Tahiti,Vanuatu,1969,3,3,6
Papua New Guinea,New Caledonia,1969,1,4,5
Congo,Ivory Coast,1969,1,1,2
New Caledonia,Solomon Islands,1969,1,1,2
Papua New Guinea,Tahiti,1969,1,3,4
Fiji,Vanuatu,1969,5,2,7
Fiji,Tahiti,1969,0,2,2
Papua New Guinea,Solomon Islands,1969,4,0,4
New Caledonia,Vanuatu,1969,2,0,2
Ghana,Niger,1969,6,0,6
Paraguay,Brazil,1969,0,3,3
Peru,Bolivia,1969,3,0,3
Fiji,New Caledonia,1969,0,11,11
Solomon Islands,Tahiti,1969,0,7,7
Papua New Guinea,Vanuatu,1969,2,1,3
Vanuatu,Solomon Islands,1969,7,2,9
Papua New Guinea,Fiji,1969,1,1,2
Brazil,Colombia,1969,6,2,8
Paraguay,Venezuela,1969,1,0,1
New Caledonia,Tahiti,1969,2,1,3
Papua New Guinea,Fiji,1969,2,1,3
Argentina,Bolivia,1969,1,0,1
Benin,Gabon,1969,1,0,1
Togo,Guinea,1969,1,1,2
Brazil,Venezuela,1969,6,0,6
Finland,Norway,1969,2,2,4
Paraguay,Colombia,1969,2,1,3
Sweden,Israel,1969,3,1,4
Poland,Norway,1969,6,1,7
Zambia,Malawi,1969,4,0,4
Argentina,Peru,1969,2,2,4
Brazil,Paraguay,1969,1,0,1
Zambia,Malawi,1969,5,0,5
Zambia,Malawi,1969,7,0,7
Yugoslavia,Romania,1969,1,1,2
Poland,Netherlands,1969,2,1,3
Denmark,Finland,1969,5,2,7
Northern Ireland,Russia,1969,0,0,0
Norway,France,1969,1,3,4
Turkey,Pakistan,1969,4,2,6
Iran,Pakistan,1969,4,2,6
Nigeria,Sudan,1969,2,2,4
Czechoslovakia,Hungary,1969,3,3,6
El Salvador,Costa Rica,1969,2,1,3
Singapore,New Zealand,1969,0,2,2
Turkey,Iran,1969,4,0,4
Egypt,Algeria,1969,1,0,1
Austria,Germany,1969,1,1,2
Haiti,El Salvador,1969,1,2,3
Republic of Ireland,Scotland,1969,1,1,2
Morocco,Nigeria,1969,2,1,3
Niger,Ghana,1969,1,9,10
Norway,Denmark,1969,2,0,2
Bulgaria,Germany,1969,0,1,1
Sweden,Hungary,1969,2,0,2
Turkey,Switzerland,1969,3,0,3
Yugoslavia,Russia,1969,1,3,4
Uganda,Tanzania,1969,3,0,3
Algeria,Egypt,1969,1,1,2
El Salvador,Haiti,1969,0,3,3
Israel,New Zealand,1969,4,0,4
Kenya,Zanzibar,1969,2,1,3
Uganda,Zanzibar,1969,7,0,7
Israel,New Zealand,1969,2,0,2
Kenya,Tanzania,1969,0,3,3
Sudan,Nigeria,1969,3,3,6
Tanzania,Zanzibar,1969,3,0,3
Uganda,Kenya,1969,1,0,1
Suriname,French Guiana,1969,1,1,2
Czechoslovakia,Republic of Ireland,1969,3,0,3
Haiti,El Salvador,1969,0,1,1
Uganda,Ethiopia,1969,4,0,4
Japan,Australia,1969,1,3,4
Sudan,Morocco,1969,0,0,0
South Korea,Japan,1969,2,2,4
Luxembourg,Poland,1969,1,5,6
Mali,Ivory Coast,1969,0,0,0
Guinea,Senegal,1969,4,3,7
Romania,Portugal,1969,1,0,1
Dominica,Suriname,1969,1,3,4
South Korea,Australia,1969,1,2,3
Greece,Switzerland,1969,4,1,5
Republic of Ireland,Denmark,1969,1,1,2
Russia,Turkey,1969,3,0,3
Spain,Finland,1969,6,0,6
Sweden,France,1969,2,0,2
Tunisia,Palestine,1969,1,1,2
Australia,Japan,1969,1,1,2
Dominica,Suriname,1969,1,9,10
South Korea,Japan,1969,2,0,2
Yugoslavia,Belgium,1969,4,0,4
South Korea,Australia,1969,1,1,2
Mexico,Bermuda,1969,3,0,3
Germany,Scotland,1969,3,2,5
Hungary,Denmark,1969,3,0,3
Netherlands,Bulgaria,1969,1,1,2
Russia,Northern Ireland,1969,2,0,2
Wales,German DR,1969,1,3,4
Algeria,Palestine,1969,2,0,2
French Guiana,Martinique,1969,0,0,0
Senegal,Guinea,1969,1,1,2
Ivory Coast,Mali,1969,4,0,4
Morocco,Sudan,1969,3,0,3
Algeria,Morocco,1969,1,0,1
Malaysia,Thailand,1969,1,0,1
Myanmar,Singapore,1969,3,1,4
India,Western Australia,1969,0,1,1
France,Sweden,1969,3,0,3
Indonesia,Thailand,1969,4,0,4
Indonesia,South Korea,1969,3,0,3
Bermuda,Mexico,1969,2,1,3
Myanmar,India,1969,6,0,6
Egypt,Sudan,1969,3,1,4
Singapore,Western Australia,1969,4,2,6
Switzerland,Portugal,1969,1,1,2
Malaysia,South Korea,1969,4,1,5
Jamaica,Panama,1969,1,1,2
Myanmar,Western Australia,1969,5,2,7
India,Singapore,1969,3,0,3
Italy,Wales,1969,4,1,5
Austria,Scotland,1969,2,0,2
Hungary,Republic of Ireland,1969,4,0,4
Jamaica,Panama,1969,2,1,3
Mexico,Belgium,1969,1,0,1
Netherlands,England,1969,0,1,1
South Korea,Thailand,1969,3,0,3
South Korea,Western Australia,1969,3,2,5
Indonesia,Singapore,1969,9,2,11
India,Thailand,1969,0,1,1
Malaysia,Myanmar,1969,3,1,4
South Korea,Thailand,1969,2,1,3
India,Western Australia,1969,2,1,3
Nigeria,Morocco,1969,2,0,2
Myanmar,Singapore,1969,9,0,9
Ivory Coast,Morocco,1969,1,0,1
Malaysia,Indonesia,1969,2,3,5
Poland,Bulgaria,1969,3,0,3
Saint Vincent and the Grenadines,Dominica,1969,1,0,1
Bermuda,Iceland,1969,3,2,5
French Guiana,Suriname,1969,3,2,5
Grenada,Saint Lucia,1969,6,0,6
Mexico,Norway,1969,4,0,4
Singapore,India,1969,7,3,10
Congo,Guinea,1969,1,1,2
Saint Vincent and the Grenadines,Saint Lucia,1969,2,1,3
Dominica,Grenada,1969,0,1,1
Guatemala,Norway,1969,1,3,4
Dominica,Saint Lucia,1969,1,3,4
Saint Vincent and the Grenadines,Grenada,1969,0,0,0
Romania,Greece,1969,1,1,2
Turkey,Russia,1969,1,3,4
Iraq,Poland,1969,1,1,2
South Korea,Laos,1969,2,0,2
Thailand,Malaysia,1969,2,2,4
Vietnam Republic,Western Australia,1969,3,1,4
South Korea,Malaysia,1969,2,0,2
Thailand,Laos,1969,3,4,7
DR Congo,Zambia,1969,10,1,11
Indonesia,Vietnam Republic,1969,3,1,4
Italy,German DR,1969,3,0,3
Singapore,Western Australia,1969,1,3,4
Laos,Malaysia,1969,1,1,2
Thailand,South Korea,1969,0,0,0
Zimbabwe,Australia,1969,1,1,2
Costa Rica,Jamaica,1969,3,0,3
Indonesia,Western Australia,1969,3,1,4
Singapore,Vietnam Republic,1969,1,1,2
Indonesia,Laos,1969,3,0,3
South Korea,Vietnam Republic,1969,3,0,3
Australia,Zimbabwe,1969,0,0,0
Costa Rica,Curaçao,1969,2,1,3
Jamaica,Mexico,1969,0,2,2
Mexico,Jamaica,1969,2,0,2
Indonesia,South Korea,1969,0,1,1
Laos,Vietnam Republic,1969,0,7,7
Guatemala,Curaçao,1969,6,1,7
Zimbabwe,Australia,1969,1,3,4
Jamaica,Trinidad and Tobago,1969,2,3,5
Costa Rica,Mexico,1969,2,0,2
Malawi,Zimbabwe,1969,2,2,4
Curaçao,Trinidad and Tobago,1969,3,1,4
Mexico,Guatemala,1969,0,1,1
Czechoslovakia,Hungary,1969,4,1,5
Costa Rica,Trinidad and Tobago,1969,5,0,5
Israel,Australia,1969,1,0,1
Jamaica,Guatemala,1969,0,0,0
Mexico,Curaçao,1969,2,2,4
Algeria,North Korea,1969,1,3,4
Jamaica,Curaçao,1969,1,2,3
Mexico,Trinidad and Tobago,1969,0,0,0
Costa Rica,Guatemala,1969,1,1,2
Luxembourg,Bulgaria,1969,1,3,4
Iraq,German DR,1969,1,1,2
England,Portugal,1969,1,0,1
Australia,Israel,1969,1,1,2
DR Congo,Nigeria,1969,5,0,5
Egypt,German DR,1969,1,3,4
Morocco,Bulgaria,1969,3,0,3
Malta,Luxembourg,1970,1,1,2
England,Netherlands,1970,0,0,0
Israel,Netherlands,1970,0,1,1
Peru,Czechoslovakia,1970,0,2,2
Cameroon,Ivory Coast,1970,3,2,5
Sudan,Ethiopia,1970,3,0,3
DR Congo,Ghana,1970,0,2,2
Egypt,Guinea,1970,4,1,5
Peru,Czechoslovakia,1970,2,1,3
Cameroon,Ethiopia,1970,3,2,5
Sudan,Ivory Coast,1970,0,1,1
DR Congo,Guinea,1970,2,2,4
Egypt,Ghana,1970,1,1,2
Peru,Romania,1970,1,1,2
Ethiopia,Ivory Coast,1970,1,6,7
Sudan,Cameroon,1970,2,1,3
DR Congo,Egypt,1970,0,1,1
Ghana,Guinea,1970,1,1,2
Spain,Germany,1970,2,0,2
Ghana,Ivory Coast,1970,2,1,3
Peru,Russia,1970,0,0,0
Sudan,Egypt,1970,2,1,3
Mexico,Bulgaria,1970,1,1,2
Egypt,Ivory Coast,1970,3,1,4
Sudan,Ghana,1970,1,0,1
Mexico,Bulgaria,1970,2,0,2
Peru,Russia,1970,0,2,2
Peru,Bulgaria,1970,1,3,4
Spain,Italy,1970,2,2,4
El Salvador,Russia,1970,0,2,2
Mexico,Sweden,1970,0,0,0
Peru,Bulgaria,1970,5,3,8
Belgium,England,1970,1,3,4
Costa Rica,El Salvador,1970,2,0,2
Mexico,Russia,1970,0,0,0
Mexico,Sweden,1970,0,1,1
Brazil,Argentina,1970,0,2,2
Peru,Mexico,1970,0,1,1
Brazil,Argentina,1970,2,1,3
Peru,Mexico,1970,1,0,1
Mexico,Peru,1970,3,1,4
Mexico,Peru,1970,3,3,6
Brazil,Chile,1970,5,0,5
Burkina Faso,Niger,1970,3,3,6
Ethiopia,Israel,1970,1,5,6
Guinea,Ivory Coast,1970,4,2,6
Brazil,Chile,1970,2,1,3
Guinea,Mali,1970,2,1,3
Bahrain,Qatar,1970,2,1,3
Saudi Arabia,Kuwait,1970,1,3,4
Bahrain,Saudi Arabia,1970,0,0,0
Kuwait,Qatar,1970,4,2,6
Uruguay,Peru,1970,2,0,2
Saudi Arabia,Qatar,1970,1,1,2
Bahrain,Kuwait,1970,1,3,4
Argentina,Uruguay,1970,2,1,3
France,Bulgaria,1970,1,1,2
Germany,Romania,1970,1,1,2
Yugoslavia,Austria,1970,1,1,2
Austria,Czechoslovakia,1970,1,3,4
Brazil,Paraguay,1970,0,0,0
Yugoslavia,Hungary,1970,2,2,4
Haiti,Bermuda,1970,1,1,2
Ghana,Ivory Coast,1970,3,0,3
Uruguay,Argentina,1970,2,1,3
Northern Ireland,Scotland,1970,0,1,1
Wales,England,1970,1,1,2
Ghana,Ivory Coast,1970,1,1,2
England,Northern Ireland,1970,3,1,4
Peru,El Salvador,1970,3,0,3
Scotland,Wales,1970,0,0,0
Switzerland,Spain,1970,0,1,1
Scotland,England,1970,0,0,0
Wales,Northern Ireland,1970,1,0,1
France,Romania,1970,2,0,2
Brazil,Austria,1970,1,0,1
Mexico,Ecuador,1970,4,2,6
Hungary,Poland,1970,2,0,2
Switzerland,France,1970,2,1,3
Bulgaria,Russia,1970,3,3,6
Bulgaria,Russia,1970,0,0,0
Poland,Republic of Ireland,1970,2,1,3
Romania,Yugoslavia,1970,0,0,0
Germany,Republic of Ireland,1970,2,1,3
Luxembourg,Czechoslovakia,1970,0,1,1
Portugal,Italy,1970,1,2,3
Germany,Yugoslavia,1970,1,0,1
Norway,Czechoslovakia,1970,0,2,2
Guinea,Senegal,1970,3,1,4
Hungary,Sweden,1970,1,2,3
Poland,German DR,1970,1,1,2
Guinea,Senegal,1970,4,0,4
Denmark,Poland,1970,0,2,2
Colombia,England,1970,0,4,4
Ecuador,England,1970,0,2,2
Mexico,Russia,1970,0,0,0
Bulgaria,Peru,1970,2,3,5
England,Romania,1970,1,0,1
Israel,Uruguay,1970,0,2,2
Belgium,El Salvador,1970,3,0,3
Brazil,Czechoslovakia,1970,4,1,5
Finland,Denmark,1970,1,1,2
Germany,Morocco,1970,2,1,3
Italy,Sweden,1970,1,0,1
Belgium,Russia,1970,1,4,5
Czechoslovakia,Romania,1970,1,2,3
Italy,Uruguay,1970,0,0,0
Morocco,Peru,1970,0,3,3
Uganda,Tanzania,1970,1,1,2
Brazil,England,1970,1,0,1
Bulgaria,Germany,1970,2,5,7
Israel,Sweden,1970,1,1,2
Mexico,El Salvador,1970,4,0,4
Brazil,Romania,1970,3,2,5
El Salvador,Russia,1970,0,2,2
Germany,Peru,1970,3,1,4
Sweden,Uruguay,1970,1,0,1
Bulgaria,Morocco,1970,1,1,2
Czechoslovakia,England,1970,0,1,1
Israel,Italy,1970,0,0,0
Mexico,Belgium,1970,1,0,1
Honduras,Panama,1970,1,0,1
Brazil,Peru,1970,4,2,6
England,Germany,1970,2,3,5
Mexico,Italy,1970,1,4,5
Russia,Uruguay,1970,0,1,1
Brazil,Uruguay,1970,3,1,4
Germany,Italy,1970,3,4,7
Norway,Finland,1970,2,0,2
Germany,Uruguay,1970,1,0,1
Malaysia,Singapore,1970,5,0,5
Brazil,Italy,1970,4,1,5
Indonesia,Hong Kong,1970,2,1,3
South Korea,Singapore,1970,8,0,8
Indonesia,Western Australia,1970,3,1,4
South Korea,Malaysia,1970,0,1,1
Hong Kong,Western Australia,1970,3,1,4
Sweden,Denmark,1970,1,1,2
Hong Kong,Malaysia,1970,1,1,2
Indonesia,South Korea,1970,2,2,4
Indonesia,Hong Kong,1970,3,2,5
South Korea,Malaysia,1970,0,2,2
DR Congo,Sudan,1970,3,0,3
Malawi,Mauritius,1970,1,0,1
Iceland,Denmark,1970,0,0,0
Malawi,Mauritius,1970,0,0,0
Gabon,Cameroon,1970,1,1,2
Tahiti,New Caledonia,1970,3,1,4
Tahiti,New Caledonia,1970,0,2,2
Iceland,Norway,1970,2,0,2
Poland,Iraq,1970,2,0,2
German DR,Iraq,1970,5,0,5
Ivory Coast,Guinea,1970,3,2,5
India,Taiwan,1970,0,1,1
Malaysia,Vietnam Republic,1970,0,0,0
Hong Kong,Japan,1970,2,1,3
South Korea,Thailand,1970,0,0,0
Myanmar,Western Australia,1970,1,0,1
Taiwan,Vietnam Republic,1970,2,1,3
Malaysia,India,1970,1,3,4
Cameroon,Gabon,1970,0,3,3
Indonesia,Singapore,1970,3,1,4
Hong Kong,Thailand,1970,2,0,2
Japan,South Korea,1970,1,1,2
Myanmar,India,1970,2,0,2
Vietnam Republic,Western Australia,1970,1,3,4
Malaysia,Taiwan,1970,3,1,4
Hong Kong,Indonesia,1970,1,3,4
Japan,Thailand,1970,0,0,0
South Korea,Singapore,1970,4,0,4
Myanmar,Vietnam Republic,1970,4,2,6
India,Western Australia,1970,2,0,2
Hong Kong,Singapore,1970,3,2,5
Indonesia,South Korea,1970,1,2,3
Myanmar,Taiwan,1970,1,1,2
Malaysia,Western Australia,1970,4,1,5
Indonesia,Japan,1970,3,4,7
Malawi,Lesotho,1970,1,2,3
Singapore,Thailand,1970,4,5,9
Hong Kong,South Korea,1970,0,0,0
India,Vietnam Republic,1970,2,1,3
Taiwan,Western Australia,1970,1,3,4
Malaysia,Myanmar,1970,1,2,3
Indonesia,Thailand,1970,6,3,9
Japan,Singapore,1970,4,0,4
Malawi,Lesotho,1970,6,1,7
Myanmar,Hong Kong,1970,5,0,5
Thailand,Western Australia,1970,2,0,2
India,South Korea,1970,2,3,5
Singapore,Vietnam Republic,1970,0,4,4
Hong Kong,India,1970,2,3,5
Malaysia,Indonesia,1970,4,0,4
Myanmar,South Korea,1970,0,1,1
Japan,Taiwan,1970,3,2,5
Singapore,India,1970,3,8,11
Finland,Sweden,1970,1,2,3
Libya,Tunisia,1970,2,2,4
Poland,Denmark,1970,5,0,5
Libya,Tunisia,1970,3,2,5
France,Czechoslovakia,1970,3,0,3
German DR,Poland,1970,5,0,5
Iran,Pakistan,1970,7,0,7
Germany,Hungary,1970,3,1,4
Pakistan,Turkey,1970,1,3,4
Austria,Yugoslavia,1970,0,1,1
Iran,Turkey,1970,1,1,2
North Vietnam,Cuba,1970,2,1,3
Denmark,Norway,1970,0,1,1
Republic of Ireland,Poland,1970,0,2,2
Tunisia,Libya,1970,2,0,2
Zanzibar,Uganda,1970,0,1,1
Hungary,Austria,1970,1,1,2
Tanzania,Kenya,1970,2,0,2
Kenya,Uganda,1970,1,2,3
Brazil,Mexico,1970,2,1,3
Zanzibar,Tanzania,1970,1,2,3
Tanzania,Uganda,1970,1,4,5
Zanzibar,Kenya,1970,3,2,5
Chile,Brazil,1970,1,5,6
Suriname,Trinidad and Tobago,1970,3,2,5
Austria,France,1970,1,0,1
Curaçao,Trinidad and Tobago,1970,1,1,2
Czechoslovakia,Finland,1970,1,1,2
Norway,Hungary,1970,1,3,4
Guyana,Trinidad and Tobago,1970,1,1,2
Suriname,Curaçao,1970,5,1,6
Guyana,Trinidad and Tobago,1970,1,1,2
Malta,Greece,1970,1,1,2
Netherlands,Yugoslavia,1970,1,1,2
Romania,Finland,1970,3,0,3
Sierra Leone,Senegal,1970,1,0,1
Denmark,Portugal,1970,0,1,1
Republic of Ireland,Sweden,1970,1,1,2
Luxembourg,Yugoslavia,1970,0,2,2
Poland,Albania,1970,3,0,3
Germany,Turkey,1970,1,1,2
Switzerland,Italy,1970,1,1,2
Tanzania,Zambia,1970,1,1,2
Ivory Coast,Senegal,1970,0,1,1
Paraguay,Argentina,1970,1,1,2
New Caledonia,Australia,1970,1,3,4
Czechoslovakia,Poland,1970,2,2,4
New Caledonia,Australia,1970,0,1,1
Togo,Senegal,1970,3,0,3
Russia,Yugoslavia,1970,4,0,4
Spain,Greece,1970,2,1,3
Sweden,Republic of Ireland,1970,1,0,1
Indonesia,Thailand,1970,1,2,3
Vietnam Republic,Malaysia,1970,1,1,2
Macau,Australia,1970,0,9,9
Austria,Italy,1970,1,2,3
Malaysia,Thailand,1970,1,4,5
Vietnam Republic,Indonesia,1970,3,1,4
Benin,Congo,1970,3,2,5
Indonesia,Malaysia,1970,1,3,4
Sierra Leone,Guinea,1970,1,2,3
Vietnam Republic,Thailand,1970,1,0,1
Zambia,Tanzania,1970,5,1,6
Iran,Australia,1970,1,2,3
Gabon,Ivory Coast,1970,1,2,3
Hong Kong,Singapore,1970,0,1,1
Nigeria,Congo,1970,0,0,0
Thailand,Laos,1970,1,0,1
Togo,Benin,1970,2,1,3
Uganda,DR Congo,1970,1,4,5
Cambodia,Malaysia,1970,1,1,2
Hong Kong,South Korea,1970,0,3,3
Thailand,Singapore,1970,3,1,4
France,Norway,1970,3,1,4
German DR,Netherlands,1970,1,0,1
Indonesia,Vietnam Republic,1970,5,3,8
Scotland,Denmark,1970,1,0,1
Spain,Northern Ireland,1970,3,0,3
Suriname,French Guiana,1970,3,2,5
Wales,Romania,1970,0,0,0
South Korea,Laos,1970,4,0,4
Thailand,Hong Kong,1970,2,1,3
Cambodia,Vietnam Republic,1970,2,2,4
Indonesia,Malaysia,1970,3,0,3
Laos,Singapore,1970,3,0,3
Thailand,South Korea,1970,0,0,0
Belgium,France,1970,1,2,3
Bulgaria,Norway,1970,1,1,2
Cyprus,Russia,1970,1,3,4
Guinea,Senegal,1970,1,0,1
Indonesia,Cambodia,1970,4,1,5
Luxembourg,German DR,1970,0,5,5
Madagascar,Mauritius,1970,2,1,3
Malaysia,Vietnam Republic,1970,2,1,3
Switzerland,Hungary,1970,0,1,1
Hong Kong,Laos,1970,4,2,6
South Korea,Singapore,1970,4,0,4
South Korea,Malaysia,1970,2,0,2
Thailand,Indonesia,1970,2,1,3
Yugoslavia,Germany,1970,2,0,2
Indonesia,Malaysia,1970,1,3,4
Thailand,South Korea,1970,0,1,1
Dominica,Saint Lucia,1970,1,1,2
Kenya,Ethiopia,1970,2,0,2
Benin,Togo,1970,0,0,0
Congo,Nigeria,1970,2,1,3
Greece,Germany,1970,1,3,4
Grenada,Saint Vincent and the Grenadines,1970,5,3,8
Ivory Coast,Gabon,1970,1,0,1
DR Congo,Uganda,1970,1,0,1
Dominica,Saint Vincent and the Grenadines,1970,0,1,1
Belgium,Denmark,1970,2,0,2
England,German DR,1970,3,1,4
Grenada,Saint Lucia,1970,6,1,7
Grenada,Dominica,1970,2,1,3
Mauritius,Madagascar,1970,4,1,5
Netherlands,Romania,1970,2,0,2
Italy,Republic of Ireland,1970,3,0,3
Greece,Cyprus,1970,1,1,2
Algeria,Morocco,1970,3,1,4
Niger,Mali,1970,0,1,1
Turkey,Albania,1970,2,1,3
Ethiopia,Kenya,1970,0,1,1
Greece,Switzerland,1970,0,1,1
Senegal,Malawi,1970,4,1,5
Malta,Switzerland,1970,1,2,3
Libya,Egypt,1970,0,1,1
Mali,Niger,1970,3,1,4
Morocco,Algeria,1970,3,0,3
Egypt,Libya,1971,2,1,3
Argentina,France,1971,3,4,7
Ghana,DR Congo,1971,1,1,2
Argentina,France,1971,2,0,2
Kuwait,Iraq,1971,0,2,2
Ghana,Sierra Leone,1971,1,2,3
Chile,German DR,1971,0,1,1
Belgium,Scotland,1971,3,0,3
Cyprus,Northern Ireland,1971,0,3,3
Malta,England,1971,0,1,1
Ghana,Sierra Leone,1971,1,2,3
Uruguay,German DR,1971,0,3,3
Uruguay,German DR,1971,1,1,2
Nigeria,Sierra Leone,1971,1,0,1
Albania,Germany,1971,0,1,1
Belgium,Portugal,1971,3,0,3
Mexico,Russia,1971,0,0,0
Italy,Spain,1971,1,2,3
Mexico,Russia,1971,0,0,0
Basque Country,Catalonia,1971,1,2,3
Netherlands,Luxembourg,1971,6,0,6
El Salvador,Russia,1971,0,1,1
Madagascar,Liberia,1971,2,1,3
Cameroon,Senegal,1971,1,1,2
Cameroon,Senegal,1971,1,2,3
Lesotho,Madagascar,1971,1,2,3
Senegal,Cameroon,1971,3,0,3
Cameroon,Congo,1971,7,1,8
Spain,France,1971,2,2,4
Malawi,Zambia,1971,5,4,9
Malawi,Zambia,1971,1,3,4
Malawi,Zambia,1971,0,3,3
Togo,Liberia,1971,0,2,2
Madagascar,Mauritius,1971,3,0,3
Austria,Hungary,1971,0,2,2
Yugoslavia,Netherlands,1971,2,0,2
Greece,Bulgaria,1971,0,1,1
Haiti,Bahamas,1971,8,0,8
England,Greece,1971,3,0,3
Northern Ireland,Cyprus,1971,5,0,5
Portugal,Scotland,1971,2,0,2
Switzerland,Malta,1971,5,0,5
Wales,Czechoslovakia,1971,1,3,4
Yugoslavia,Romania,1971,0,1,1
German DR,Luxembourg,1971,2,1,3
Hungary,France,1971,1,1,2
Sierra Leone,Gambia,1971,3,1,4
Turkey,Germany,1971,0,3,3
Tanzania,DR Congo,1971,0,1,1
Bulgaria,Russia,1971,1,1,2
Guinea,Gambia,1971,4,2,6
Indonesia,Vietnam Republic,1971,9,1,10
Ivory Coast,Ghana,1971,2,6,8
South Korea,Thailand,1971,1,0,1
Myanmar,Taiwan,1971,2,0,2
Cambodia,Malaysia,1971,1,3,4
Cambodia,Thailand,1971,3,4,7
Switzerland,Poland,1971,2,4,6
Myanmar,Vietnam Republic,1971,2,0,2
South Korea,Malaysia,1971,5,1,6
Myanmar,Indonesia,1971,3,1,4
Malaysia,Thailand,1971,4,1,5
Cyprus,Spain,1971,0,2,2
German DR,Yugoslavia,1971,1,2,3
South Korea,Cambodia,1971,2,0,2
Republic of Ireland,Italy,1971,1,2,3
Myanmar,Malaysia,1971,6,1,7
South Korea,Indonesia,1971,3,0,3
Albania,Poland,1971,1,1,2
England,Malta,1971,5,0,5
Portugal,Denmark,1971,5,0,5
Switzerland,Greece,1971,1,0,1
Indonesia,Malaysia,1971,4,2,6
South Korea,Myanmar,1971,0,0,0
South Korea,Myanmar,1971,0,0,0
Malaysia,Thailand,1971,0,3,3
Northern Ireland,England,1971,0,1,1
Wales,Scotland,1971,0,0,0
Czechoslovakia,Romania,1971,1,0,1
Scotland,Northern Ireland,1971,0,1,1
Bulgaria,Hungary,1971,3,0,3
England,Wales,1971,0,0,0
Luxembourg,Belgium,1971,0,4,4
Sweden,Finland,1971,4,1,5
China PR,Cuba,1971,1,0,1
Thailand,Cambodia,1971,1,1,2
England,Scotland,1971,3,1,4
Indonesia,Hong Kong,1971,2,1,3
Malaysia,Brunei,1971,8,0,8
Northern Ireland,Wales,1971,1,0,1
Cambodia,Hong Kong,1971,2,1,3
Thailand,Brunei,1971,10,0,10
Uganda,Malawi,1971,3,3,6
Denmark,Belgium,1971,1,2,3
Finland,Wales,1971,0,1,1
Malaysia,Cambodia,1971,2,1,3
Norway,Iceland,1971,3,1,4
Sweden,Austria,1971,1,0,1
Thailand,Indonesia,1971,0,1,1
Indonesia,Brunei,1971,9,0,9
Malaysia,Hong Kong,1971,2,1,3
Cambodia,Indonesia,1971,2,0,2
Republic of Ireland,Austria,1971,1,4,5
Russia,Spain,1971,2,1,3
Thailand,Malaysia,1971,1,0,1
Malaysia,Indonesia,1971,3,0,3
Thailand,Cambodia,1971,4,2,6
Zambia,Ethiopia,1971,5,1,6
Indonesia,Singapore,1971,3,0,3
South Korea,Thailand,1971,0,1,1
Cambodia,Western Australia,1971,2,2,4
India,Thailand,1971,0,1,1
Indonesia,Myanmar,1971,1,1,2
Russia,Cyprus,1971,6,1,7
Cambodia,Malaysia,1971,1,1,2
India,South Korea,1971,2,3,5
Myanmar,Singapore,1971,6,0,6
Denmark,Scotland,1971,1,0,1
Malaysia,Western Australia,1971,3,2,5
Norway,Bulgaria,1971,1,4,5
Sweden,Italy,1971,0,0,0
Myanmar,Malaysia,1971,5,1,6
Indonesia,Thailand,1971,0,0,0
Myanmar,South Korea,1971,1,0,1
Cambodia,Thailand,1971,3,0,3
Germany,Albania,1971,2,0,2
Indonesia,Cambodia,1971,1,0,1
South Korea,Malaysia,1971,1,2,3
Myanmar,Cambodia,1971,8,0,8
Indonesia,Malaysia,1971,2,1,3
Russia,Scotland,1971,1,0,1
Cambodia,Malaysia,1971,1,2,3
Finland,Czechoslovakia,1971,0,4,4
Indonesia,Myanmar,1971,0,1,1
Greece,Malta,1971,2,0,2
Denmark,Sweden,1971,1,3,4
Norway,Germany,1971,1,7,8
Kenya,Sudan,1971,3,3,6
Hong Kong,Thailand,1971,6,0,6
Madagascar,Mauritius,1971,1,1,2
Sweden,Germany,1971,1,0,1
Denmark,Germany,1971,1,3,4
Kenya,Mauritius,1971,2,1,3
Paraguay,Argentina,1971,1,1,2
Zambia,Cyprus,1971,3,0,3
Malawi,Uganda,1971,3,1,4
Mexico,Greece,1971,1,1,2
Zambia,Cyprus,1971,3,0,3
Argentina,Paraguay,1971,1,0,1
Libya,Syria,1971,2,1,3
Malawi,Uganda,1971,0,1,1
Brazil,Austria,1971,1,1,2
Egypt,Syria,1971,1,0,1
Sudan,Palestine,1971,1,1,2
Zambia,Cyprus,1971,3,0,3
Libya,Egypt,1971,0,2,2
Argentina,Uruguay,1971,1,0,1
Brazil,Czechoslovakia,1971,1,0,1
Chile,Paraguay,1971,3,2,5
Martinique,Guadeloupe,1971,2,1,3
Tanzania,Guinea,1971,3,2,5
Libya,Sudan,1971,4,6,10
Brazil,Yugoslavia,1971,2,2,4
Libya,Egypt,1971,2,0,2
Mauritius,Kenya,1971,0,0,0
New Caledonia,New Zealand,1971,4,2,6
Uruguay,Argentina,1971,1,1,2
Zambia,Guinea,1971,4,2,6
New Caledonia,New Zealand,1971,2,1,3
Chile,Argentina,1971,2,2,4
Guadeloupe,Martinique,1971,1,1,2
Zambia,Guinea,1971,1,5,6
Brazil,Paraguay,1971,1,0,1
Senegal,Sierra Leone,1971,2,1,3
Zambia,Guinea,1971,2,1,3
Peru,Paraguay,1971,0,0,0
Argentina,Brazil,1971,1,1,2
Denmark,Japan,1971,3,2,5
Argentina,Brazil,1971,2,2,4
Argentina,Chile,1971,1,0,1
Malaysia,Vietnam Republic,1971,2,0,2
Hong Kong,Singapore,1971,1,2,3
India,Philippines,1971,5,1,6
Myanmar,Singapore,1971,0,1,1
India,Indonesia,1971,1,3,4
Malaysia,Taiwan,1971,0,0,0
Malaysia,Thailand,1971,0,2,2
Paraguay,Chile,1971,2,0,2
Sweden,Norway,1971,3,0,3
Myanmar,Indonesia,1971,2,2,4
Taiwan,Thailand,1971,4,0,4
Hong Kong,Philippines,1971,2,1,3
India,Singapore,1971,2,2,4
Thailand,Vietnam Republic,1971,2,4,6
Myanmar,Hong Kong,1971,4,0,4
Indonesia,Philippines,1971,3,1,4
Peru,Chile,1971,1,0,1
Taiwan,Vietnam Republic,1971,3,2,5
Myanmar,Philippines,1971,2,0,2
Hong Kong,India,1971,2,1,3
Iceland,Japan,1971,0,2,2
Indonesia,Singapore,1971,4,0,4
Bolivia,Chile,1971,3,4,7
Myanmar,India,1971,9,1,10
Hong Kong,Indonesia,1971,0,3,3
Paraguay,Peru,1971,2,0,2
Philippines,Singapore,1971,4,4,8
Philippines,Thailand,1971,3,1,4
Chile,Peru,1971,1,0,1
Guinea,Senegal,1971,1,0,1
Indonesia,Taiwan,1971,1,0,1
Mexico,German DR,1971,0,1,1
Myanmar,Indonesia,1971,1,0,1
Hong Kong,Vietnam Republic,1971,1,3,4
Saint Lucia,Saint Vincent and the Grenadines,1971,1,5,6
India,Indonesia,1971,2,1,3
Singapore,Malaysia,1971,2,4,6
Philippines,Thailand,1971,0,1,1
Finland,Norway,1971,1,1,2
India,Malaysia,1971,6,0,6
Thailand,Vietnam Republic,1971,1,2,3
Singapore,Indonesia,1971,3,2,5
India,Vietnam Republic,1971,0,0,0
Tahiti,Fiji,1971,5,2,7
Hungary,Yugoslavia,1971,2,1,3
Senegal,Guinea,1971,0,0,0
Austria,Sweden,1971,1,0,1
Honduras,Guatemala,1971,1,0,1
Denmark,Finland,1971,0,0,0
Germany,Mexico,1971,5,0,5
Norway,France,1971,1,3,4
Fiji,New Caledonia,1971,1,5,6
Tahiti,Papua New Guinea,1971,2,2,4
El Salvador,Nicaragua,1971,3,2,5
South Korea,Iran,1971,2,0,2
Cook Islands,Papua New Guinea,1971,1,16,17
Fiji,Vanuatu,1971,4,6,10
South Korea,Iran,1971,0,2,2
Guatemala,Honduras,1971,1,1,2
New Caledonia,Vanuatu,1971,0,0,0
Tahiti,Cook Islands,1971,30,0,30
Cook Islands,Fiji,1971,1,15,16
El Salvador,Nicaragua,1971,1,0,1
Suriname,Guyana,1971,4,1,5
New Caledonia,Papua New Guinea,1971,4,0,4
Tahiti,Vanuatu,1971,1,2,3
German DR,Mexico,1971,1,1,2
Russia,India,1971,5,0,5
Tahiti,Papua New Guinea,1971,8,1,9
New Caledonia,Vanuatu,1971,7,1,8
Guyana,Suriname,1971,2,3,5
Finland,Romania,1971,0,4,4
Poland,Turkey,1971,5,1,6
Russia,Northern Ireland,1971,1,0,1
Yugoslavia,Mexico,1971,4,0,4
German DR,Czechoslovakia,1971,1,1,2
Hungary,Bulgaria,1971,2,0,2
Italy,Mexico,1971,2,0,2
Kenya,Tanzania,1971,1,1,2
Norway,Denmark,1971,1,4,5
Switzerland,Turkey,1971,4,0,4
Uganda,Zanzibar,1971,3,1,4
Uganda,Tanzania,1971,0,0,0
Greece,Mexico,1971,0,1,1
Kenya,Zanzibar,1971,4,0,4
Jamaica,Cuba,1971,0,1,1
Tanzania,Zanzibar,1971,1,1,2
Kenya,Uganda,1971,2,0,2
Cuba,Jamaica,1971,0,0,0
Bermuda,Mexico,1971,0,2,2
Mexico,Bermuda,1971,4,0,4
Lesotho,Malawi,1971,0,0,0
France,Hungary,1971,0,2,2
Italy,Sweden,1971,3,0,3
Austria,Republic of Ireland,1971,6,0,6
Lesotho,Malawi,1971,0,2,2
Netherlands,German DR,1971,3,2,5
Poland,Germany,1971,1,3,4
Morocco,Egypt,1971,3,0,3
Zambia,DR Congo,1971,2,1,3
Togo,Ghana,1971,0,0,0
Ivory Coast,Congo,1971,3,2,5
Northern Ireland,Russia,1971,1,1,2
Scotland,Portugal,1971,2,1,3
Switzerland,England,1971,2,3,5
Wales,Finland,1971,3,0,3
Guinea,Mali,1971,0,0,0
Yugoslavia,German DR,1971,0,0,0
Zambia,Kenya,1971,0,2,2
Zambia,Kenya,1971,3,1,4
Zambia,Kenya,1971,0,1,1
Egypt,Morocco,1971,3,2,5
Ghana,Togo,1971,0,1,1
DR Congo,Zambia,1971,3,0,3
Congo,Ivory Coast,1971,2,0,2
Mali,Guinea,1971,3,1,4
Czechoslovakia,Wales,1971,1,0,1
Hungary,Norway,1971,4,0,4
Spain,Russia,1971,0,0,0
Uruguay,Chile,1971,3,0,3
Yugoslavia,Luxembourg,1971,0,0,0
Singapore,Thailand,1971,0,1,1
Vietnam Republic,Malaysia,1971,0,1,1
Malaysia,Singapore,1971,1,1,2
Vietnam Republic,Thailand,1971,3,0,3
Martinique,Haiti,1971,2,2,4
Singapore,Thailand,1971,3,1,4
Vietnam Republic,Malaysia,1971,1,1,2
Chile,Uruguay,1971,5,0,5
Belgium,Luxembourg,1971,1,0,1
Thailand,Singapore,1971,2,0,2
South Korea,Malaysia,1971,2,2,4
Singapore,Vietnam Republic,1971,4,5,9
England,Switzerland,1971,1,1,2
France,Bulgaria,1971,2,1,3
Indonesia,Malaysia,1971,2,0,2
Scotland,Belgium,1971,1,0,1
Australia,Israel,1971,2,2,4
Thailand,Vietnam Republic,1971,0,1,1
Indonesia,South Korea,1971,0,0,0
Albania,Turkey,1971,3,0,3
Australia,Israel,1971,1,0,1
Guinea,Tanzania,1971,3,2,5
South Korea,Vietnam Republic,1971,1,1,2
Malta,Hungary,1971,0,2,2
Romania,Czechoslovakia,1971,2,1,3
Thailand,Indonesia,1971,1,0,1
Thailand,South Korea,1971,0,1,1
Bulgaria,Greece,1971,2,2,4
Germany,Poland,1971,0,0,0
Netherlands,Luxembourg,1971,8,0,8
Iraq,Kuwait,1971,3,1,4
Italy,Austria,1971,2,2,4
Cuba,Costa Rica,1971,0,3,3
Australia,Israel,1971,1,3,4
Haiti,Mexico,1971,0,0,0
Trinidad and Tobago,Honduras,1971,1,1,2
Portugal,Belgium,1971,1,1,2
Cuba,Honduras,1971,3,1,4
Costa Rica,Haiti,1971,0,0,0
Libya,Algeria,1971,0,0,0
Romania,Wales,1971,2,0,2
Spain,Cyprus,1971,7,0,7
Trinidad and Tobago,Mexico,1971,0,2,2
Costa Rica,Honduras,1971,2,1,3
Grenada,Saint Lucia,1971,5,2,7
Nigeria,Burkina Faso,1971,4,0,4
Cuba,Mexico,1971,0,1,1
Dominica,Saint Vincent and the Grenadines,1971,3,0,3
Trinidad and Tobago,Haiti,1971,1,6,7
Trinidad and Tobago,Cuba,1971,2,2,4
Barbados,Curaçao,1971,1,3,4
Grenada,Saint Vincent and the Grenadines,1971,1,1,2
Togo,Burkina Faso,1971,1,0,1
Dominica,Saint Lucia,1971,2,2,4
Greece,England,1971,0,2,2
Guinea,Nigeria,1971,3,0,3
Haiti,Honduras,1971,3,1,4
Netherlands,Scotland,1971,2,1,3
Costa Rica,Mexico,1971,0,1,1
Bulgaria,France,1971,2,1,3
Cuba,Haiti,1971,0,0,0
Dominica,Grenada,1971,3,0,3
Honduras,Mexico,1971,1,2,3
Sierra Leone,Nigeria,1971,0,1,1
Trinidad and Tobago,Costa Rica,1971,3,1,4
Kenya,Zambia,1971,1,0,1
Tanzania,Burundi,1971,4,1,5
Turkey,Poland,1971,1,0,1
Kenya,Zambia,1971,3,2,5
Malta,Algeria,1971,1,1,2
Tanzania,China PR,1971,1,1,2
Kuwait,Iraq,1971,1,1,2
Bahrain,Lebanon,1971,3,0,3
Syria,Jordan,1971,0,0,0
Burkina Faso,Togo,1971,1,2,3
Kenya,Zambia,1971,0,2,2
Tanzania,China PR,1971,3,4,7
Iraq,Sri Lanka,1971,5,0,5
Jordan,Bahrain,1971,3,2,5
Kuwait,Lebanon,1971,1,0,1
Iraq,Bahrain,1971,1,0,1
Jordan,Sri Lanka,1971,2,1,3
Kuwait,Syria,1971,2,2,4
Iraq,Jordan,1971,2,0,2
Lebanon,Syria,1971,3,2,5
Niger,Libya,1971,0,1,1
Senegal,Mali,1971,4,1,5
Bahrain,Sri Lanka,1971,3,0,3
Kuwait,Jordan,1971,2,0,2
Iraq,Lebanon,1971,4,1,5
Kuwait,Iraq,1971,0,1,1
Lebanon,Jordan,1971,2,0,2
Algeria,Palestine,1972,2,0,2
Iraq,Egypt,1972,0,0,0
Kuwait,Libya,1972,3,2,5
Syria,Yemen DPR,1972,1,0,1
Zambia,China PR,1972,3,3,6
Algeria,Qatar,1972,3,0,3
Palestine,Syria,1972,1,3,4
Egypt,Kuwait,1972,2,0,2
Iraq,Libya,1972,3,0,3
Palestine,Yemen DPR,1972,1,2,3
Syria,Qatar,1972,3,2,5
Egypt,Libya,1972,1,1,2
Iraq,Kuwait,1972,3,1,4
Algeria,Syria,1972,0,1,1
Qatar,Yemen DPR,1972,1,2,3
Burkina Faso,Nigeria,1972,3,3,6
Senegal,Congo,1972,0,2,2
Algeria,Yemen DPR,1972,4,1,5
Palestine,Qatar,1972,7,2,9
Guinea,Congo,1972,0,1,1
Iraq,Algeria,1972,3,1,4
Spain,Hungary,1972,1,0,1
Egypt,Syria,1972,4,2,6
Algeria,Syria,1972,3,1,4
Iraq,Egypt,1972,1,3,4
Somalia,China PR,1972,1,3,4
Togo,Benin,1972,4,0,4
Mexico,Chile,1972,2,0,2
Nigeria,Guinea,1972,1,1,2
Congo,Benin,1972,2,2,4
Congo,Guinea,1972,2,2,4
Haiti,Chile,1972,1,0,1
Cameroon,Nigeria,1972,1,2,3
Guadeloupe,Haiti,1972,4,4,8
Martinique,Haiti,1972,2,2,4
Greece,Netherlands,1972,0,5,5
Northern Ireland,Spain,1972,1,1,2
Senegal,Morocco,1972,1,3,4
Nigeria,Morocco,1972,3,0,3
Tunisia,Austria,1972,3,3,6
Cameroon,Kenya,1972,2,1,3
Israel,Norway,1972,2,1,3
Mali,Togo,1972,3,3,6
Congo,Morocco,1972,1,1,2
Sudan,DR Congo,1972,1,1,2
Cameroon,Togo,1972,2,0,2
Kenya,Mali,1972,1,1,2
Congo,DR Congo,1972,0,2,2
Morocco,Sudan,1972,1,1,2
Cameroon,Mali,1972,1,1,2
Kenya,Togo,1972,1,1,2
Congo,Sudan,1972,4,2,6
Morocco,DR Congo,1972,1,1,2
Algeria,Guinea,1972,1,0,1
Cameroon,Congo,1972,0,1,1
Mali,DR Congo,1972,4,3,7
Cameroon,DR Congo,1972,5,2,7
Greece,Italy,1972,2,1,3
Congo,Mali,1972,3,2,5
Guinea,Algeria,1972,5,1,6
Algeria,Malta,1972,1,0,1
Saudi Arabia,Kuwait,1972,2,2,4
Qatar,United Arab Emirates,1972,0,1,1
Bahrain,Kuwait,1972,0,2,2
Saudi Arabia,United Arab Emirates,1972,4,0,4
Bahrain,Qatar,1972,6,2,8
Kuwait,United Arab Emirates,1972,7,0,7
Saudi Arabia,Qatar,1972,4,0,4
Bahrain,United Arab Emirates,1972,2,0,2
Kuwait,Qatar,1972,5,0,5
Saudi Arabia,Bahrain,1972,2,1,3
Bulgaria,Russia,1972,1,1,2
Colombia,Peru,1972,1,1,2
Hungary,Germany,1972,0,2,2
Portugal,Cyprus,1972,4,0,4
Jamaica,Cuba,1972,2,0,2
Mexico,Peru,1972,2,1,3
Czechoslovakia,Austria,1972,2,0,2
Poland,German DR,1972,2,1,3
Romania,France,1972,2,0,2
Greece,Spain,1972,0,0,0
Haiti,Puerto Rico,1972,7,0,7
Ghana,Ivory Coast,1972,1,2,3
Russia,Peru,1972,2,0,2
Puerto Rico,Haiti,1972,0,5,5
Romania,Peru,1972,2,2,4
Brazil,Paraguay,1972,3,2,5
Czechoslovakia,Luxembourg,1972,6,0,6
Scotland,Peru,1972,2,0,2
Switzerland,Sweden,1972,1,1,2
England,Germany,1972,1,3,4
Hungary,Romania,1972,1,1,2
Italy,Belgium,1972,0,0,0
Madagascar,Tanzania,1972,0,1,1
Austria,Malta,1972,4,0,4
Lesotho,Zambia,1972,0,0,0
Yugoslavia,Russia,1972,0,0,0
Netherlands,Peru,1972,3,0,3
Hungary,Malta,1972,3,0,3
Ethiopia,Greece,1972,0,1,1
Iran,Cambodia,1972,2,0,2
South Korea,Iraq,1972,0,0,0
Thailand,Kuwait,1972,0,2,2
Iran,Iraq,1972,3,0,3
Cambodia,South Korea,1972,1,4,5
Cyprus,Portugal,1972,0,1,1
Poland,Switzerland,1972,0,0,0
Thailand,Iraq,1972,1,1,2
South Korea,Kuwait,1972,1,2,3
Belgium,Italy,1972,2,1,3
Germany,England,1972,0,0,0
Russia,Yugoslavia,1972,3,0,3
Thailand,Iran,1972,2,3,5
Cambodia,Kuwait,1972,4,0,4
Romania,Hungary,1972,2,2,4
Sweden,Czechoslovakia,1972,1,2,3
Iran,Cambodia,1972,2,1,3
Hungary,Romania,1972,2,1,3
Kenya,Madagascar,1972,1,3,4
Thailand,South Korea,1972,1,1,2
Belgium,Iceland,1972,4,0,4
Iran,South Korea,1972,2,1,3
Thailand,Cambodia,1972,2,2,4
Scotland,Northern Ireland,1972,2,0,2
Wales,England,1972,0,3,3
Belgium,Iceland,1972,4,0,4
Mauritius,Uganda,1972,1,2,3
England,Northern Ireland,1972,0,1,1
Spain,Uruguay,1972,2,0,2
Scotland,Wales,1972,1,0,1
Argentina,Paraguay,1972,0,0,0
Sweden,Hungary,1972,0,0,0
Germany,Russia,1972,4,1,5
German DR,Uruguay,1972,1,0,1
Scotland,England,1972,0,1,1
Wales,Northern Ireland,1972,0,0,0
Finland,Norway,1972,0,0,0
Mauritius,Uganda,1972,1,3,4
Chile,Argentina,1972,3,4,7
German DR,Uruguay,1972,0,0,0
Liberia,Guinea,1972,0,2,2
Sierra Leone,Ghana,1972,3,1,4
Puerto Rico,Panama,1972,0,0,0
Zambia,Lesotho,1972,6,1,7
Indonesia,Myanmar,1972,1,0,1
Tunisia,Algeria,1972,3,1,4
Cambodia,Singapore,1972,3,0,3
Togo,DR Congo,1972,0,0,0
Denmark,Finland,1972,3,0,3
Russia,Bulgaria,1972,1,0,1
Cambodia,Thailand,1972,2,0,2
Philippines,Singapore,1972,2,0,2
Myanmar,Sri Lanka,1972,4,2,6
Laos,Malaysia,1972,1,2,3
Austria,Sweden,1972,2,0,2
Kenya,Uganda,1972,2,0,2
Bolivia,Peru,1972,0,3,3
Myanmar,Laos,1972,6,1,7
Ecuador,Portugal,1972,0,3,3
Iran,Republic of Ireland,1972,1,2,3
Paraguay,Venezuela,1972,4,1,5
Philippines,Thailand,1972,1,0,1
Laos,Sri Lanka,1972,1,3,4
Belgium,Germany,1972,1,2,3
Chile,Ecuador,1972,2,1,3
Hungary,Russia,1972,0,1,1
Iran,Portugal,1972,0,3,3
Norway,Uruguay,1972,0,1,1
Paraguay,Peru,1972,1,0,1
Venezuela,Yugoslavia,1972,0,10,10
Myanmar,Malaysia,1972,2,2,4
Benin,Congo,1972,5,3,8
Belgium,Hungary,1972,2,1,3
Romania,Italy,1972,3,3,6
Benin,Ghana,1972,0,5,5
Bolivia,Yugoslavia,1972,1,1,2
Chile,Portugal,1972,1,4,5
Colombia,France,1972,2,3,5
Ecuador,Republic of Ireland,1972,2,3,5
Germany,Russia,1972,3,0,3
Peru,Venezuela,1972,1,0,1
Myanmar,Cambodia,1972,0,3,3
DR Congo,Togo,1972,4,0,4
Bolivia,Venezuela,1972,2,2,4
Bulgaria,Italy,1972,1,1,2
Chile,Republic of Ireland,1972,2,1,3
Ecuador,Iran,1972,1,1,2
Finland,Albania,1972,1,0,1
Argentina,Colombia,1972,4,1,5
Paraguay,Yugoslavia,1972,1,2,3
Singapore,Sri Lanka,1972,3,1,4
Argentina,France,1972,0,0,0
Bolivia,Paraguay,1972,1,6,7
Chile,Iran,1972,2,1,3
Republic of Ireland,Portugal,1972,1,2,3
Peru,Yugoslavia,1972,1,2,3
Brazil,Czechoslovakia,1972,0,0,0
Argentina,Portugal,1972,1,3,4
Scotland,Yugoslavia,1972,2,2,4
Sweden,Denmark,1972,2,0,2
Uruguay,Russia,1972,0,1,1
Argentina,Russia,1972,1,0,1
Brazil,Yugoslavia,1972,3,0,3
DR Congo,Guinea,1972,6,0,6
Czechoslovakia,Scotland,1972,0,0,0
Ghana,Benin,1972,5,1,6
Portugal,Uruguay,1972,1,1,2
Iceland,Denmark,1972,2,5,7
Tanzania,Sudan,1972,3,0,3
Brazil,Scotland,1972,1,0,1
Argentina,Uruguay,1972,1,0,1
Czechoslovakia,Yugoslavia,1972,1,2,3
Malawi,Lesotho,1972,1,0,1
Portugal,Russia,1972,1,0,1
Tanzania,Nigeria,1972,0,0,0
Malawi,Lesotho,1972,4,0,4
Argentina,Yugoslavia,1972,2,4,6
Brazil,Portugal,1972,1,0,1
Uganda,Sudan,1972,4,0,4
Zanzibar,Nigeria,1972,1,4,5
Iceland,Faroe Islands,1972,3,0,3
Malaysia,Sri Lanka,1972,4,1,5
Japan,Cambodia,1972,4,1,5
Indonesia,Singapore,1972,0,0,0
Malaysia,Philippines,1972,1,0,1
Hong Kong,South Korea,1972,0,0,0
Singapore,Thailand,1972,0,2,2
Cambodia,Philippines,1972,2,2,4
Finland,Russia,1972,1,1,2
Japan,Sri Lanka,1972,5,0,5
Kenya,Sudan,1972,2,0,2
Hong Kong,Singapore,1972,4,1,5
South Korea,Thailand,1972,2,0,2
Japan,Philippines,1972,5,1,6
Indonesia,Thailand,1972,3,2,5
Malaysia,Cambodia,1972,6,1,7
South Korea,Singapore,1972,4,1,5
Philippines,Sri Lanka,1972,4,1,5
Hong Kong,Indonesia,1972,1,0,1
Cambodia,Sri Lanka,1972,6,1,7
Malaysia,Japan,1972,3,1,4
Hong Kong,Thailand,1972,2,2,4
Indonesia,South Korea,1972,0,2,2
Sudan,Kenya,1972,1,0,1
Singapore,Sri Lanka,1972,6,1,7
Japan,South Korea,1972,0,3,3
Uganda,Tanzania,1972,1,1,2
Cambodia,Hong Kong,1972,1,0,1
Philippines,Thailand,1972,0,4,4
Malaysia,South Korea,1972,1,2,3
Indonesia,Philippines,1972,3,0,3
Singapore,Sri Lanka,1972,6,1,7
Norway,Iceland,1972,4,1,5
Hong Kong,Sri Lanka,1972,2,1,3
Japan,Philippines,1972,4,1,5
Nigeria,Congo,1972,2,1,3
Costa Rica,Mexico,1972,1,0,1
Indonesia,Japan,1972,1,0,1
Singapore,Hong Kong,1972,0,2,2
Sweden,Russia,1972,4,4,8
Cambodia,Indonesia,1972,0,5,5
Peru,Mexico,1972,3,2,5
Hong Kong,Cambodia,1972,2,1,3
Congo,Nigeria,1972,1,1,2
Chile,Mexico,1972,0,2,2
Canada,United States,1972,3,2,5
Canada,Mexico,1972,0,1,1
United States,Canada,1972,2,2,4
Czechoslovakia,Netherlands,1972,1,2,3
Greece,France,1972,1,3,4
Guatemala,Canada,1972,2,2,4
Mexico,United States,1972,3,1,4
Romania,Austria,1972,1,1,2
Sri Lanka,China PR,1972,2,3,5
Mexico,Canada,1972,2,1,3
United States,Mexico,1972,1,2,3
Sri Lanka,China PR,1972,0,1,1
Japan,South Korea,1972,2,2,4
New Zealand,New Caledonia,1972,4,1,5
Norway,Sweden,1972,1,3,4
Cambodia,Malaysia,1972,0,1,1
Finland,Romania,1972,1,1,2
Italy,Yugoslavia,1972,3,1,4
South Korea,Thailand,1972,3,0,3
Myanmar,Philippines,1972,4,0,4
South Korea,Cambodia,1972,3,1,4
Malaysia,Thailand,1972,1,1,2
Myanmar,Indonesia,1972,1,1,2
Philippines,Singapore,1972,0,5,5
Cambodia,Thailand,1972,0,0,0
South Korea,Malaysia,1972,2,0,2
Myanmar,Singapore,1972,1,0,1
Cambodia,Philippines,1972,1,0,1
South Korea,Myanmar,1972,0,1,1
Indonesia,Malaysia,1972,3,1,4
Singapore,Thailand,1972,1,4,5
Myanmar,Indonesia,1972,3,1,4
South Korea,Malaysia,1972,1,0,1
Martinique,Trinidad and Tobago,1972,1,2,3
New Zealand,New Caledonia,1972,2,1,3
Costa Rica,El Salvador,1972,2,0,2
Martinique,Trinidad and Tobago,1972,1,2,3
Algeria,Turkey,1972,1,0,1
Denmark,Switzerland,1972,1,1,2
Lesotho,Zambia,1972,1,1,2
Norway,Belgium,1972,0,2,2
Hong Kong,Singapore,1972,2,3,5
German DR,Finland,1972,5,0,5
Indonesia,Australia,1972,1,4,5
Luxembourg,Italy,1972,0,4,4
El Salvador,Costa Rica,1972,0,1,1
Lesotho,Zambia,1972,1,1,2
Australia,New Zealand,1972,3,1,4
England,Yugoslavia,1972,1,1,2
Indonesia,New Zealand,1972,1,1,2
Spain,Argentina,1972,1,0,1
Saint Kitts and Nevis,Trinidad and Tobago,1972,0,3,3
Mexico,Costa Rica,1972,3,1,4
China PR,Nepal,1972,6,2,8
France,Russia,1972,1,0,1
New Caledonia,New Zealand,1972,3,1,4
Austria,Hungary,1972,2,2,4
Guatemala,Costa Rica,1972,0,0,0
Malawi,Kenya,1972,0,1,1
Poland,Czechoslovakia,1972,3,0,3
Sierra Leone,Ivory Coast,1972,0,1,1
Sweden,Malta,1972,7,0,7
Vietnam Republic,Australia,1972,0,1,1
Bulgaria,Northern Ireland,1972,3,0,3
Denmark,Scotland,1972,1,4,5
Republic of Ireland,Russia,1972,1,2,3
Spain,Yugoslavia,1972,2,2,4
Switzerland,Italy,1972,0,0,0
South Korea,Australia,1972,1,1,2
Luxembourg,Turkey,1972,2,0,2
Malawi,Kenya,1972,2,1,3
South Korea,Australia,1972,0,2,2
Peru,Argentina,1972,0,2,2
Cambodia,Singapore,1972,0,1,1
Vietnam Republic,Malaysia,1972,0,0,0
Cambodia,Malaysia,1972,1,0,1
Ivory Coast,Sierra Leone,1972,2,0,2
Philippines,Australia,1972,0,6,6
Romania,Albania,1972,2,0,2
Vietnam Republic,Singapore,1972,4,1,5
Czechoslovakia,German DR,1972,1,3,4
Malaysia,Singapore,1972,1,3,4
Netherlands,Norway,1972,9,0,9
Vietnam Republic,Cambodia,1972,1,2,3
Nigeria,Tanzania,1972,2,1,3
Trinidad and Tobago,Antigua and Barbuda,1972,11,1,12
Nigeria,Tanzania,1972,3,2,5
Costa Rica,Guatemala,1972,1,1,2
Germany,Switzerland,1972,5,1,6
Republic of Ireland,France,1972,2,1,3
Scotland,Denmark,1972,2,0,2
Wales,England,1972,0,1,1
Tunisia,Algeria,1972,1,2,3
South Korea,Malaysia,1972,4,1,5
Sierra Leone,Tanzania,1972,2,2,4
Thailand,Singapore,1972,4,0,4
Yugoslavia,Greece,1972,1,0,1
Antigua and Barbuda,Trinidad and Tobago,1972,1,2,3
Belgium,Netherlands,1972,0,0,0
Cyprus,Bulgaria,1972,0,4,4
Morocco,Senegal,1972,0,0,0
Indonesia,Singapore,1972,1,2,3
Thailand,Malaysia,1972,0,2,2
Indonesia,South Korea,1972,1,1,2
Malaysia,Singapore,1972,2,0,2
Mali,Nigeria,1972,2,1,3
Guinea,China PR,1972,1,1,2
South Korea,Singapore,1972,2,0,2
Liberia,Nigeria,1972,1,3,4
Thailand,Indonesia,1972,3,0,3
Dominica,Grenada,1972,1,2,3
Malta,Austria,1972,0,2,2
Tanzania,Ethiopia,1972,1,1,2
Indonesia,Malaysia,1972,0,2,2
Sierra Leone,Nigeria,1972,0,1,1
Saint Lucia,Saint Vincent and the Grenadines,1972,2,1,3
Thailand,South Korea,1972,1,0,1
Dominica,Saint Vincent and the Grenadines,1972,1,2,3
South Korea,Singapore,1972,0,0,0
Thailand,Malaysia,1972,0,1,1
Trinidad and Tobago,Suriname,1972,2,1,3
Senegal,China PR,1972,0,0,0
Saint Lucia,Grenada,1972,1,0,1
Trinidad and Tobago,Suriname,1972,1,1,2
Grenada,Saint Vincent and the Grenadines,1972,0,0,0
Saint Lucia,Dominica,1972,1,0,1
Antigua and Barbuda,Suriname,1972,0,6,6
Ethiopia,Tanzania,1972,0,0,0
Guatemala,El Salvador,1972,1,0,1
Honduras,Costa Rica,1972,2,1,3
Senegal,Morocco,1972,1,2,3
Nigeria,Mali,1972,3,0,3
Antigua and Barbuda,Suriname,1972,1,3,4
Egypt,Tunisia,1972,2,1,3
Costa Rica,Honduras,1972,3,3,6
El Salvador,Guatemala,1972,0,1,1
Ethiopia,Tanzania,1972,3,0,3
Mauritius,Kenya,1972,1,3,4
Turkey,Luxembourg,1972,3,0,3
Nigeria,Sierra Leone,1972,4,0,4
Haiti,Curaçao,1972,3,0,3
Panama,Puerto Rico,1972,5,0,5
Panama,Puerto Rico,1972,0,1,1
Haiti,Curaçao,1972,4,1,5
Kenya,Mauritius,1972,2,2,4
Tunisia,Egypt,1972,2,0,2
Nigeria,Benin,1972,3,0,3
Bermuda,Jamaica,1972,0,0,0
Bermuda,Jamaica,1972,0,3,3
Ghana,Togo,1972,2,2,4
Liberia,Ghana,1972,2,2,4
Gambia,Senegal,1973,2,1,3
Italy,Turkey,1973,0,0,0
Greece,Spain,1973,2,3,5
England,Wales,1973,1,1,2
Uganda,Congo,1973,3,1,4
Cyprus,Bulgaria,1973,0,3,3
Guyana,Haiti,1973,1,3,4
Greece,Bulgaria,1973,2,2,4
Guyana,Haiti,1973,1,0,1
Cameroon,DR Congo,1973,0,1,1
Haiti,Trinidad and Tobago,1973,0,0,0
Indonesia,Bulgaria,1973,0,4,4
Tunisia,Yugoslavia,1973,0,5,5
Haiti,Trinidad and Tobago,1973,4,2,6
Mexico,Argentina,1973,2,0,2
Barbados,Haiti,1973,3,2,5
New Caledonia,Bulgaria,1973,3,5,8
Nigeria,Ghana,1973,2,3,5
Guinea,Morocco,1973,1,1,2
Tunisia,Ivory Coast,1973,1,1,2
Australia,Bulgaria,1973,2,2,4
Chile,Tahiti,1973,10,1,11
Cyprus,Northern Ireland,1973,1,0,1
Germany,Argentina,1973,2,3,5
Scotland,England,1973,0,5,5
Turkey,Algeria,1973,4,0,4
Colombia,German DR,1973,0,2,2
Australia,Bulgaria,1973,1,3,4
Morocco,Senegal,1973,3,1,4
New Caledonia,Tahiti,1973,1,2,3
New Zealand,Fiji,1973,5,1,6
Australia,Bulgaria,1973,0,2,2
Ecuador,German DR,1973,1,1,2
New Caledonia,Vanuatu,1973,4,1,5
New Zealand,Tahiti,1973,1,1,2
Fiji,New Caledonia,1973,0,2,2
Israel,Argentina,1973,1,1,2
Vanuatu,Tahiti,1973,0,1,1
Fiji,Vanuatu,1973,1,2,3
New Zealand,New Caledonia,1973,2,1,3
Spain,Greece,1973,3,1,4
Fiji,Tahiti,1973,0,4,4
New Zealand,Vanuatu,1973,3,1,4
New Caledonia,Vanuatu,1973,2,1,3
New Zealand,Tahiti,1973,2,0,2
DR Congo,Cameroon,1973,0,1,1
Ghana,Nigeria,1973,0,0,0
Ivory Coast,Tunisia,1973,2,1,3
Morocco,Guinea,1973,2,0,2
Turkey,Italy,1973,0,1,1
DR Congo,Cameroon,1973,2,0,2
France,Portugal,1973,1,2,3
New Zealand,Australia,1973,1,1,2
Peru,Guatemala,1973,5,1,6
Sudan,Ethiopia,1973,1,0,1
Australia,Iraq,1973,3,1,4
Indonesia,New Zealand,1973,1,1,2
Australia,Indonesia,1973,2,1,3
Iraq,New Zealand,1973,2,0,2
Australia,New Zealand,1973,3,3,6
Iraq,Indonesia,1973,1,1,2
Bermuda,United States,1973,4,0,4
Australia,Iraq,1973,0,0,0
Indonesia,New Zealand,1973,1,0,1
Poland,United States,1973,4,0,4
Iraq,Indonesia,1973,3,2,5
Australia,Indonesia,1973,6,0,6
Iraq,New Zealand,1973,4,0,4
Peru,Bolivia,1973,2,0,2
Austria,Netherlands,1973,1,0,1
Bulgaria,Russia,1973,1,0,1
Germany,Czechoslovakia,1973,3,0,3
Northern Ireland,Portugal,1973,1,1,2
Peru,Paraguay,1973,1,0,1
Wales,Poland,1973,2,0,2
Sierra Leone,Mali,1973,1,1,2
Bolivia,Paraguay,1973,1,1,2
Italy,Luxembourg,1973,5,0,5
Ethiopia,Zambia,1973,0,0,0
Central African Republic,Ivory Coast,1973,4,2,6
German DR,Albania,1973,2,0,2
Luxembourg,Switzerland,1973,0,1,1
Paraguay,Peru,1973,1,1,2
Ghana,Senegal,1973,3,2,5
Lesotho,Mauritius,1973,0,0,0
Ethiopia,Tanzania,1973,2,1,3
Tanzania,Ethiopia,1973,3,0,3
Kuwait,Qatar,1973,9,0,9
Sudan,Nigeria,1973,1,1,2
Haiti,Chile,1973,1,1,2
Uganda,Kenya,1973,1,0,1
Burkina Faso,DR Congo,1973,0,5,5
Zambia,Ethiopia,1973,4,2,6
Kuwait,Qatar,1973,4,1,5
Belgium,German DR,1973,3,0,3
Russia,Romania,1973,2,0,2
Turkey,Bulgaria,1973,5,2,7
Nigeria,Sudan,1973,2,1,3
Senegal,Ghana,1973,1,0,1
Mauritius,Lesotho,1973,5,1,6
DR Congo,Burkina Faso,1973,4,1,5
Peru,Panama,1973,4,0,4
Ecuador,Chile,1973,1,1,2
Denmark,Sweden,1973,1,2,3
Kenya,Uganda,1973,1,2,3
Mali,Sierra Leone,1973,4,2,6
Bolivia,Ecuador,1973,3,3,6
Hungary,Austria,1973,2,2,4
Peru,Chile,1973,2,0,2
Bulgaria,Portugal,1973,2,1,3
Denmark,Czechoslovakia,1973,1,1,2
Netherlands,Spain,1973,3,2,5
Iran,North Korea,1973,0,0,0
Syria,Kuwait,1973,2,1,3
Albania,Romania,1973,1,4,5
Ecuador,Bolivia,1973,0,0,0
Iran,Kuwait,1973,2,1,3
North Korea,Syria,1973,1,1,2
Iran,Syria,1973,1,0,1
North Korea,Kuwait,1973,0,0,0
Northern Ireland,Cyprus,1973,3,0,3
Germany,Yugoslavia,1973,0,1,1
Switzerland,Turkey,1973,0,0,0
Iran,North Korea,1973,2,1,3
Syria,Kuwait,1973,2,0,2
England,Northern Ireland,1973,2,1,3
Germany,Bulgaria,1973,3,0,3
Haiti,Ecuador,1973,1,2,3
Wales,Scotland,1973,0,2,2
Chile,Peru,1973,2,0,2
Iran,Kuwait,1973,2,0,2
North Korea,Syria,1973,3,0,3
Poland,Yugoslavia,1973,2,2,4
Russia,Republic of Ireland,1973,1,0,1
England,Wales,1973,3,0,3
Haiti,Ecuador,1973,1,0,1
Iran,Syria,1973,0,1,1
North Korea,Kuwait,1973,0,2,2
German DR,Hungary,1973,2,1,3
Israel,Japan,1973,2,1,3
Poland,Republic of Ireland,1973,2,0,2
Scotland,Northern Ireland,1973,1,2,3
Thailand,Vietnam Republic,1973,0,1,1
Argentina,Uruguay,1973,1,1,2
Hong Kong,Malaysia,1973,1,0,1
England,Scotland,1973,1,0,1
France,Republic of Ireland,1973,1,1,2
Israel,Malaysia,1973,3,0,3
South Korea,Thailand,1973,4,0,4
Northern Ireland,Wales,1973,1,0,1
Ivory Coast,Morocco,1973,1,1,2
Vietnam Republic,Japan,1973,0,4,4
Israel,Thailand,1973,6,0,6
South Korea,Malaysia,1973,0,0,0
Japan,Hong Kong,1973,0,1,1
South Korea,Israel,1973,0,0,0
Sweden,Austria,1973,3,2,5
Thailand,Malaysia,1973,0,2,2
Uruguay,Argentina,1973,1,1,2
Hong Kong,Vietnam Republic,1973,1,0,1
Israel,Japan,1973,1,0,1
South Korea,Hong Kong,1973,3,1,4
Russia,France,1973,2,0,2
Brazil,Bolivia,1973,5,0,5
Cameroon,DR Congo,1973,2,1,3
Mali,Guinea,1973,2,2,4
Uganda,Algeria,1973,2,1,3
Tanzania,Mauritius,1973,1,1,2
Czechoslovakia,England,1973,1,1,2
Haiti,Colombia,1973,1,2,3
Romania,German DR,1973,1,0,1
South Korea,Israel,1973,1,0,1
Haiti,Colombia,1973,2,1,3
Algeria,Brazil,1973,0,2,2
Morocco,Ivory Coast,1973,4,1,5
Zambia,Madagascar,1973,3,1,4
Madagascar,Zambia,1973,2,1,3
Czechoslovakia,Denmark,1973,6,0,6
Finland,German DR,1973,1,5,6
Haiti,Uruguay,1973,0,0,0
Norway,Republic of Ireland,1973,1,1,2
Poland,England,1973,2,0,2
Tunisia,Brazil,1973,1,4,5
Faroe Islands,Iceland,1973,0,4,4
Italy,Brazil,1973,2,0,2
China PR,Pakistan,1973,7,4,11
Russia,England,1973,1,2,3
Myanmar,Malaysia,1973,2,2,4
Austria,Brazil,1973,1,1,2
Hungary,Sweden,1973,3,3,6
Algeria,Uganda,1973,1,1,2
Guinea,Mali,1973,1,1,2
Mauritius,Tanzania,1973,1,1,2
DR Congo,Cameroon,1973,2,0,2
Indonesia,Malaysia,1973,2,0,2
Italy,England,1973,2,0,2
Germany,Brazil,1973,0,1,1
China PR,Somalia,1973,7,4,11
Indonesia,Myanmar,1973,0,0,0
Colombia,Ecuador,1973,1,1,2
Denmark,Norway,1973,1,0,1
Russia,Brazil,1973,0,1,1
Switzerland,Scotland,1973,1,0,1
South Korea,Japan,1973,2,0,2
Colombia,Uruguay,1973,0,0,0
Sweden,Brazil,1973,1,0,1
Ecuador,Colombia,1973,1,1,2
Scotland,Brazil,1973,0,1,1
Ecuador,Uruguay,1973,1,2,3
Peru,Colombia,1973,3,1,4
Republic of Ireland,Brazil,1973,3,4,7
Tanzania,Congo,1973,2,1,3
Uruguay,Colombia,1973,0,1,1
Malawi,Mauritius,1973,4,1,5
Malawi,Mauritius,1973,1,0,1
Sweden,Finland,1973,1,1,2
Uruguay,Ecuador,1973,4,0,4
Sweden,Iceland,1973,1,0,1
Argentina,Chile,1973,5,4,9
Bolivia,Peru,1973,2,0,2
Ghana,Ivory Coast,1973,0,3,3
Zambia,Nigeria,1973,5,1,6
Mauritius,Réunion,1973,1,1,2
Nigeria,Zambia,1973,3,2,5
Egypt,Tanzania,1973,10,1,11
Iceland,German DR,1973,1,2,3
Chile,Argentina,1973,3,1,4
Iceland,German DR,1973,0,2,2
Israel,Uruguay,1973,1,2,3
Syria,Palestine,1973,1,1,2
Chile,Bolivia,1973,3,0,3
Norway,North Korea,1973,3,0,3
Cambodia,Singapore,1973,1,1,2
Malaysia,Kuwait,1973,0,0,0
Argentina,Peru,1973,3,1,4
Bangladesh,Thailand,1973,2,2,4
India,Vietnam Republic,1973,2,1,3
Myanmar,South Korea,1973,0,0,0
Kuwait,Singapore,1973,2,0,2
Ivory Coast,Central African Republic,1973,5,1,6
Bangladesh,Vietnam Republic,1973,1,1,2
India,Thailand,1973,2,0,2
Ivory Coast,Ghana,1973,1,0,1
Malaysia,South Korea,1973,1,2,3
Myanmar,Singapore,1973,1,0,1
Bangladesh,Kuwait,1973,1,2,3
Canada,Poland,1973,1,3,4
South Korea,Thailand,1973,0,0,0
Bangladesh,Singapore,1973,1,1,2
Myanmar,Vietnam Republic,1973,2,1,3
China PR,Guinea,1973,5,2,7
Cambodia,South Korea,1973,0,1,1
Iceland,Norway,1973,0,4,4
United States,Poland,1973,0,1,1
Malaysia,Thailand,1973,2,2,4
Malaysia,Cambodia,1973,1,0,1
Malaysia,India,1973,4,0,4
India,Cambodia,1973,3,0,3
Myanmar,Kuwait,1973,2,0,2
India,South Korea,1973,0,0,0
Canada,United States,1973,0,2,2
Chile,Peru,1973,2,1,3
Ghana,DR Congo,1973,1,0,1
Mexico,Poland,1973,0,1,1
Russia,Sweden,1973,0,0,0
Singapore,Vietnam Republic,1973,0,1,1
Cambodia,Thailand,1973,1,4,5
Eswatini,Malawi,1973,0,1,1
Bangladesh,Myanmar,1973,0,6,6
Kuwait,Vietnam Republic,1973,2,1,3
Mexico,Poland,1973,1,2,3
India,Vietnam Republic,1973,1,1,2
Cambodia,Singapore,1973,0,3,3
Malaysia,Myanmar,1973,2,1,3
United States,Poland,1973,0,4,4
Libya,United Arab Emirates,1973,2,2,4
South Korea,Kuwait,1973,0,1,1
South Korea,Myanmar,1973,1,2,3
Bangladesh,Thailand,1973,0,2,2
Egypt,Yemen DPR,1973,6,1,7
Malaysia,Kuwait,1973,3,1,4
New Zealand,Iran,1973,0,0,0
United States,Poland,1973,1,0,1
Zambia,Kenya,1973,2,0,2
Algeria,United Arab Emirates,1973,2,0,2
Iraq,Yemen,1973,2,0,2
Singapore,Bangladesh,1973,0,1,1
Palestine,Yemen DPR,1973,1,0,1
Syria,Tunisia,1973,1,4,5
Libya,Yemen,1973,10,0,10
Algeria,Iraq,1973,0,0,0
Congo,Uganda,1973,3,2,5
Egypt,Tunisia,1973,0,1,1
Singapore,India,1973,4,5,9
Yemen,United Arab Emirates,1973,1,1,2
Syria,Yemen DPR,1973,7,1,8
Egypt,Palestine,1973,2,0,2
Algeria,Yemen,1973,15,1,16
Australia,Iran,1973,3,0,3
Libya,Iraq,1973,0,0,0
Bulgaria,Poland,1973,0,2,2
DR Congo,Ghana,1973,4,1,5
Kenya,Zambia,1973,2,2,4
Tunisia,Yemen DPR,1973,2,0,2
Egypt,Syria,1973,0,2,2
Iraq,United Arab Emirates,1973,3,1,4
Libya,Algeria,1973,0,2,2
Palestine,Tunisia,1973,2,6,8
Netherlands,Iceland,1973,5,0,5
Algeria,Syria,1973,0,0,0
Iraq,Tunisia,1973,0,2,2
Iran,Australia,1973,2,0,2
Algeria,Iraq,1973,0,0,0
Syria,Tunisia,1973,0,4,4
Finland,Sweden,1973,1,2,3
Netherlands,Iceland,1973,8,1,9
Bolivia,Paraguay,1973,1,2,3
Russia,Germany,1973,0,1,1
France,Greece,1973,3,1,4
Argentina,Bolivia,1973,4,0,4
United States,Bermuda,1973,1,0,1
Norway,Netherlands,1973,1,2,3
Paraguay,Argentina,1973,1,1,2
Mexico,Chile,1973,1,2,3
Myanmar,Thailand,1973,2,2,4
South Korea,Cambodia,1973,6,0,6
Uganda,Somalia,1973,6,1,7
Bolivia,Argentina,1973,0,1,1
Kenya,Zanzibar,1973,2,0,2
Norway,Denmark,1973,0,1,1
South Korea,Indonesia,1973,3,1,4
Malaysia,Thailand,1973,5,1,6
Somalia,Zambia,1973,1,6,7
Tanzania,Zanzibar,1973,1,0,1
Myanmar,Malaysia,1973,1,3,4
England,Austria,1973,7,0,7
German DR,Romania,1973,2,0,2
Indonesia,Cambodia,1973,2,3,5
Northern Ireland,Bulgaria,1973,0,0,0
Poland,Wales,1973,3,0,3
Russia,Chile,1973,0,0,0
Scotland,Czechoslovakia,1973,2,1,3
Switzerland,Luxembourg,1973,1,0,1
Uganda,Zambia,1973,1,1,2
Yugoslavia,Hungary,1973,1,1,2
Kenya,Tanzania,1973,1,2,3
Cambodia,Malaysia,1973,2,0,2
South Korea,Myanmar,1973,0,1,1
Malta,Canada,1973,2,0,2
Uganda,Zambia,1973,2,1,3
Italy,Sweden,1973,2,0,2
Uganda,Tanzania,1973,2,1,3
Myanmar,Cambodia,1973,0,0,0
South Korea,Malaysia,1973,2,0,2
Malta,Canada,1973,0,0,0
Paraguay,Bolivia,1973,4,0,4
Argentina,Paraguay,1973,3,1,4
Luxembourg,Canada,1973,0,2,2
Albania,Finland,1973,1,0,1
Germany,Austria,1973,4,0,4
Netherlands,Poland,1973,1,1,2
Trinidad and Tobago,Martinique,1973,2,0,2
Denmark,Hungary,1973,2,2,4
Germany,France,1973,2,1,3
Portugal,Bulgaria,1973,2,2,4
Romania,Finland,1973,9,0,9
Mexico,United States,1973,2,0,2
Czechoslovakia,Scotland,1973,1,0,1
England,Poland,1973,1,1,2
German DR,Russia,1973,1,0,1
Turkey,Spain,1973,0,0,0
Italy,Switzerland,1973,2,0,2
Republic of Ireland,Poland,1973,1,0,1
Yugoslavia,Spain,1973,0,0,0
Zambia,Morocco,1973,4,0,4
Curaçao,Suriname,1973,1,1,2
Australia,South Korea,1973,0,0,0
Curaçao,Suriname,1973,2,2,4
Algeria,Morocco,1973,2,0,2
Belgium,Norway,1973,2,0,2
Vietnam Republic,Malaysia,1973,1,5,6
Albania,German DR,1973,1,4,5
Haiti,United States,1973,1,0,1
Malaysia,Singapore,1973,2,1,3
Guyana,Jamaica,1973,2,1,3
Vietnam Republic,Singapore,1973,4,2,6
Zambia,DR Congo,1973,0,2,2
Haiti,United States,1973,1,0,1
Barbados,Suriname,1973,0,2,2
Guadeloupe,Martinique,1973,0,2,2
Albania,China PR,1973,1,1,2
Dominica,Grenada,1973,4,2,6
Guyana,Suriname,1973,0,2,2
Haiti,Canada,1973,5,1,6
South Korea,Australia,1973,2,2,4
Dominica,Saint Lucia,1973,1,0,1
Malta,Sweden,1973,1,2,3
Saint Vincent and the Grenadines,Grenada,1973,4,1,5
Haiti,Canada,1973,0,1,1
Australia,South Korea,1973,1,0,1
Israel,United States,1973,3,1,4
England,Italy,1973,0,1,1
Portugal,Northern Ireland,1973,1,1,2
Scotland,Germany,1973,1,1,2
Israel,United States,1973,2,0,2
Saint Lucia,Grenada,1973,1,3,4
Saint Lucia,Dominica,1973,2,1,3
Bulgaria,Cyprus,1973,2,0,2
DR Congo,Zambia,1973,2,1,3
Netherlands,Belgium,1973,0,0,0
Turkey,Switzerland,1973,2,0,2
Saint Vincent and the Grenadines,Dominica,1973,2,2,4
France,Denmark,1973,3,0,3
Grenada,Dominica,1973,1,1,2
Hungary,German DR,1973,0,1,1
Saint Vincent and the Grenadines,Saint Lucia,1973,2,0,2
Germany,Spain,1973,2,1,3
Morocco,Zambia,1973,2,0,2
Austria,Sweden,1973,1,2,3
Saint Lucia,Saint Vincent and the Grenadines,1973,0,1,1
Grenada,Saint Lucia,1973,2,0,2
Honduras,Trinidad and Tobago,1973,2,1,3
Dominica,Saint Vincent and the Grenadines,1973,0,0,0
Guatemala,Mexico,1973,0,0,0
Haiti,Curaçao,1973,3,0,3
Panama,Nicaragua,1973,2,0,2
Myanmar,Vietnam Republic,1973,0,1,1
Honduras,Mexico,1973,1,1,2
Haiti,Trinidad and Tobago,1973,2,1,3
Guatemala,Curaçao,1973,2,2,4
Haiti,Honduras,1973,1,0,1
Kenya,Uganda,1973,2,2,4
Mexico,Curaçao,1973,8,0,8
DR Congo,Morocco,1973,3,0,3
Guatemala,Trinidad and Tobago,1973,0,1,1
Uganda,Zambia,1973,2,0,2
Honduras,Curaçao,1973,2,2,4
Kenya,Zambia,1973,3,1,4
Haiti,Guatemala,1973,2,1,3
Mexico,Trinidad and Tobago,1973,0,4,4
Guatemala,Honduras,1973,1,1,2
Laos,Singapore,1973,3,2,5
Thailand,Myanmar,1973,2,1,3
Cambodia,South Korea,1973,0,5,5
Myanmar,Singapore,1973,6,1,7
Curaçao,Trinidad and Tobago,1973,0,4,4
Thailand,Laos,1973,5,0,5
Haiti,Mexico,1973,0,1,1
South Korea,Malaysia,1973,0,0,0
Myanmar,Laos,1973,2,1,3
Greece,Yugoslavia,1973,2,4,6
Thailand,Singapore,1973,3,0,3
Cambodia,Malaysia,1973,2,3,5
Congo,Tunisia,1973,0,1,1
Myanmar,South Korea,1973,0,2,2
Thailand,Malaysia,1973,0,1,1
South Korea,Malaysia,1973,2,1,3
Thailand,Myanmar,1973,1,0,1
Guinea,Tunisia,1973,0,0,0
Uganda,Congo,1974,0,2,2
Mali,Tunisia,1974,1,0,1
Mauritius,Malawi,1974,4,1,5
Mauritius,Malawi,1974,2,1,3
Pakistan,Iran,1974,1,2,3
Pakistan,Turkey,1974,2,2,4
Iran,Turkey,1974,0,1,1
Mauritius,Malawi,1974,2,2,4
Panama,El Salvador,1974,1,0,1
Cyprus,Bulgaria,1974,1,4,5
Kuwait,Bulgaria,1974,1,3,4
Kuwait,Bulgaria,1974,1,2,3
Singapore,Japan,1974,0,1,1
Yugoslavia,Spain,1974,1,0,1
Ghana,Guinea,1974,5,2,7
Congo,Mali,1974,2,2,4
Ghana,Guinea,1974,3,1,4
Tahiti,New Caledonia,1974,2,1,3
Tahiti,New Caledonia,1974,1,2,3
Hong Kong,Japan,1974,0,0,0
Tahiti,New Caledonia,1974,2,2,4
Iraq,Morocco,1974,0,0,0
Spain,Germany,1974,1,0,1
Iraq,Morocco,1974,0,0,0
Kuwait,Morocco,1974,0,2,2
Italy,Germany,1974,0,0,0
Tunisia,German DR,1974,0,4,4
Qatar,Morocco,1974,0,1,1
Algeria,German DR,1974,1,3,4
Bahrain,Morocco,1974,0,1,1
Egypt,Uganda,1974,2,1,3
Ivory Coast,Zambia,1974,0,1,1
Congo,Mauritius,1974,2,0,2
Guinea,DR Congo,1974,1,2,3
Egypt,Zambia,1974,3,1,4
Ivory Coast,Uganda,1974,2,2,4
Congo,DR Congo,1974,2,1,3
Guinea,Mauritius,1974,2,1,3
Egypt,Ivory Coast,1974,2,0,2
Saudi Arabia,Morocco,1974,0,0,0
Togo,Denmark,1974,0,2,2
Uganda,Zambia,1974,0,1,1
Congo,Guinea,1974,1,1,2
Mauritius,DR Congo,1974,1,4,5
Congo,Zambia,1974,2,4,6
Egypt,DR Congo,1974,2,3,5
Benin,Denmark,1974,2,0,2
Egypt,Congo,1974,4,0,4
DR Congo,Zambia,1974,2,2,4
German DR,Belgium,1974,1,0,1
Réunion,Seychelles,1974,2,0,2
DR Congo,Zambia,1974,2,0,2
Puerto Rico,Panama,1974,0,1,1
Kuwait,United Arab Emirates,1974,2,0,2
Bahrain,Oman,1974,4,0,4
Qatar,Saudi Arabia,1974,0,2,2
Bahrain,United Arab Emirates,1974,0,4,4
Kuwait,Oman,1974,5,0,5
Bahrain,Saudi Arabia,1974,1,4,5
Oman,Qatar,1974,0,4,4
France,Romania,1974,1,0,1
Haiti,Uruguay,1974,0,1,1
Saudi Arabia,United Arab Emirates,1974,2,0,2
Kuwait,Qatar,1974,1,0,1
Haiti,Uruguay,1974,0,0,0
Kuwait,United Arab Emirates,1974,6,0,6
Qatar,Saudi Arabia,1974,1,3,4
German DR,Czechoslovakia,1974,1,0,1
Germany,Scotland,1974,2,1,3
Netherlands,Austria,1974,1,1,2
Jamaica,Uruguay,1974,0,3,3
Qatar,United Arab Emirates,1974,1,1,2
Kuwait,Saudi Arabia,1974,4,0,4
Brazil,Mexico,1974,1,1,2
Hungary,Bulgaria,1974,3,1,4
Portugal,England,1974,0,0,0
Brazil,Czechoslovakia,1974,1,0,1
Morocco,Algeria,1974,2,0,2
Bermuda,Canada,1974,0,0,0
Bulgaria,Czechoslovakia,1974,0,1,1
Haiti,Poland,1974,2,1,3
Brazil,Bulgaria,1974,1,0,1
Haiti,Poland,1974,1,3,4
Belgium,Poland,1974,1,1,2
Brazil,Romania,1974,2,0,2
Germany,Hungary,1974,5,0,5
Yugoslavia,Russia,1974,0,1,1
Indonesia,Uruguay,1974,2,1,3
Brazil,Haiti,1974,4,0,4
Indonesia,Uruguay,1974,2,3,5
Argentina,Romania,1974,2,1,3
Haiti,Chile,1974,0,1,1
Haiti,Chile,1974,0,0,0
Czechoslovakia,France,1974,3,3,6
Brazil,Greece,1974,0,0,0
Brazil,Austria,1974,0,0,0
Germany,Sweden,1974,2,0,2
Switzerland,Belgium,1974,0,1,1
Yemen DPR,Iraq,1974,2,0,2
Brazil,Republic of Ireland,1974,2,1,3
China PR,Sierra Leone,1974,4,1,5
Bulgaria,Turkey,1974,5,1,6
Uruguay,Republic of Ireland,1974,2,0,2
Scotland,Northern Ireland,1974,0,1,1
Wales,England,1974,0,2,2
Brazil,Paraguay,1974,2,0,2
Chile,Republic of Ireland,1974,1,2,3
South Korea,Cambodia,1974,0,1,1
Scotland,Wales,1974,2,0,2
England,Northern Ireland,1974,1,0,1
Poland,Greece,1974,2,0,2
Myanmar,Thailand,1974,2,1,3
France,Argentina,1974,0,1,1
South Korea,Myanmar,1974,3,0,3
Scotland,England,1974,2,0,2
Wales,Northern Ireland,1974,1,0,1
Myanmar,Cambodia,1974,6,0,6
Russia,Czechoslovakia,1974,0,1,1
Indonesia,Australia,1974,1,2,3
England,Argentina,1974,2,2,4
German DR,Norway,1974,1,0,1
Bulgaria,North Korea,1974,6,1,7
Netherlands,Argentina,1974,4,1,5
Israel,Australia,1974,2,1,3
German DR,England,1974,1,1,2
Hungary,Yugoslavia,1974,3,2,5
Romania,Greece,1974,3,1,4
Belgium,Scotland,1974,2,1,3
Bulgaria,England,1974,0,1,1
Indonesia,Myanmar,1974,2,4,6
Tunisia,Iraq,1974,2,1,3
Myanmar,Malaysia,1974,3,0,3
Denmark,Sweden,1974,0,2,2
Netherlands,Romania,1974,0,0,0
Yugoslavia,England,1974,2,2,4
Finland,Denmark,1974,1,1,2
Norway,Scotland,1974,1,2,3
Indonesia,Malaysia,1974,4,3,7
Libya,Iraq,1974,1,0,1
Austria,Italy,1974,0,0,0
South Korea,Malaysia,1974,0,0,0
Sweden,Switzerland,1974,0,0,0
Brazil,Yugoslavia,1974,0,0,0
DR Congo,Scotland,1974,0,2,2
German DR,Australia,1974,2,0,2
Germany,Chile,1974,1,0,1
Italy,Haiti,1974,3,1,4
Poland,Argentina,1974,3,2,5
Sweden,Bulgaria,1974,0,0,0
Uruguay,Netherlands,1974,0,2,2
Chile,German DR,1974,1,1,2
Germany,Australia,1974,3,0,3
Scotland,Brazil,1974,0,0,0
Yugoslavia,DR Congo,1974,9,0,9
Argentina,Italy,1974,1,1,2
Bulgaria,Uruguay,1974,1,1,2
Haiti,Poland,1974,0,7,7
Netherlands,Sweden,1974,0,0,0
Australia,Chile,1974,0,0,0
DR Congo,Brazil,1974,0,3,3
Germany,German DR,1974,0,1,1
Scotland,Yugoslavia,1974,1,1,2
Argentina,Haiti,1974,4,1,5
Bulgaria,Netherlands,1974,1,4,5
Poland,Italy,1974,2,1,3
Sweden,Uruguay,1974,3,0,3
Brazil,German DR,1974,1,0,1
Germany,Yugoslavia,1974,2,0,2
Mali,Congo,1974,1,1,2
Netherlands,Argentina,1974,4,0,4
Sweden,Poland,1974,0,1,1
Argentina,Brazil,1974,1,2,3
German DR,Netherlands,1974,0,2,2
Germany,Sweden,1974,4,2,6
Poland,Yugoslavia,1974,2,1,3
Argentina,German DR,1974,1,1,2
Faroe Islands,Iceland,1974,2,3,5
Germany,Poland,1974,1,0,1
Netherlands,Brazil,1974,2,0,2
Sweden,Yugoslavia,1974,2,1,3
China PR,Togo,1974,4,2,6
Brazil,Poland,1974,0,1,1
Malawi,Ivory Coast,1974,5,1,6
Germany,Netherlands,1974,2,1,3
Malawi,Tanzania,1974,1,0,1
Malawi,Zambia,1974,0,1,1
China PR,Yemen DPR,1974,6,5,11
Nigeria,Ivory Coast,1974,2,0,2
Silesia,Tanzania,1974,7,2,9
Hong Kong,Indonesia,1974,2,2,4
India,Thailand,1974,4,2,6
Malaysia,India,1974,4,1,5
Indonesia,Thailand,1974,1,2,3
Indonesia,Singapore,1974,5,0,5
Hong Kong,India,1974,2,2,4
Singapore,Thailand,1974,1,1,2
India,Indonesia,1974,0,0,0
Malaysia,Thailand,1974,3,2,5
Hong Kong,Thailand,1974,1,0,1
Singapore,Hong Kong,1974,0,1,1
Sweden,Norway,1974,2,1,3
Somalia,Burundi,1974,0,2,2
China PR,Senegal,1974,5,2,7
Nigeria,Ghana,1974,1,1,2
Iraq,Bahrain,1974,4,0,4
Norway,Finland,1974,1,2,3
Nigeria,Ghana,1974,0,1,1
Iceland,Finland,1974,2,2,4
Burundi,Somalia,1974,0,1,1
Malta,Libya,1974,0,1,1
Haiti,Jamaica,1974,0,1,1
Jamaica,Trinidad and Tobago,1974,2,1,3
Finland,Poland,1974,1,2,3
Denmark,Indonesia,1974,9,0,9
Austria,Wales,1974,2,1,3
Libya,Malta,1974,0,0,0
Norway,Northern Ireland,1974,2,1,3
Poland,German DR,1974,1,3,4
Sweden,Netherlands,1974,1,5,6
Switzerland,Germany,1974,1,2,3
Mexico,United States,1974,3,1,4
Libya,DR Congo,1974,0,2,2
Poland,France,1974,0,2,2
Iceland,Belgium,1974,0,2,2
United States,Mexico,1974,0,1,1
Libya,Somalia,1974,3,2,5
Ivory Coast,Ghana,1974,1,1,2
Libya,Somalia,1974,3,2,5
Bulgaria,Romania,1974,0,0,0
Czechoslovakia,German DR,1974,3,1,4
Denmark,Spain,1974,1,2,3
Finland,Netherlands,1974,1,3,4
Syria,Palestine,1974,2,0,2
Algeria,Lebanon,1974,4,1,5
Austria,Hungary,1974,1,0,1
Japan,South Korea,1974,4,1,5
Yemen,Sudan,1974,0,6,6
Yugoslavia,Italy,1974,1,0,1
Algeria,Jordan,1974,6,0,6
Libya,Yemen,1974,9,1,10
Palestine,Sudan,1974,1,3,4
Morocco,Tunisia,1974,3,1,4
Libya,Palestine,1974,0,0,0
Algeria,Tunisia,1974,0,1,1
Libya,Sudan,1974,1,3,4
Syria,Yemen,1974,6,0,6
Palestine,Yemen,1974,7,1,8
Morocco,Sudan,1974,2,0,2
Denmark,Iceland,1974,2,1,3
German DR,Canada,1974,2,0,2
Netherlands,Switzerland,1974,1,0,1
Poland,Finland,1974,3,0,3
Sudan,Tunisia,1974,1,3,4
Syria,Morocco,1974,1,1,2
Argentina,Spain,1974,1,1,2
Belgium,France,1974,2,1,3
German DR,Iceland,1974,1,1,2
Bulgaria,Greece,1974,3,3,6
Czechoslovakia,Sweden,1974,4,0,4
Denmark,Romania,1974,0,0,0
Luxembourg,Hungary,1974,2,4,6
England,Czechoslovakia,1974,3,0,3
Republic of Ireland,Russia,1974,3,0,3
Scotland,German DR,1974,3,0,3
Sweden,Northern Ireland,1974,0,2,2
Wales,Hungary,1974,2,0,2
Yugoslavia,Norway,1974,3,1,4
Zanzibar,Somalia,1974,2,1,3
Algeria,Morocco,1974,0,0,0
Poland,Canada,1974,2,0,2
Vietnam Republic,Laos,1974,1,0,1
Laos,Malaysia,1974,0,0,0
Zanzibar,Uganda,1974,1,2,3
Cambodia,Thailand,1974,2,2,4
Kenya,Zambia,1974,2,3,5
Malaysia,Taiwan,1974,0,0,0
Singapore,China PR,1974,1,1,2
Somalia,Uganda,1974,1,1,2
Laos,Taiwan,1974,1,2,3
Vietnam Republic,Malaysia,1974,1,0,1
Chile,Argentina,1974,0,2,2
Tanzania,Uganda,1974,1,1,2
Vietnam Republic,Taiwan,1974,1,1,2
Vietnam Republic,Thailand,1974,3,2,5
Bulgaria,Hungary,1974,0,0,0
Togo,Liberia,1974,1,0,1
Tunisia,Libya,1974,1,0,1
Czechoslovakia,Poland,1974,2,2,4
Switzerland,Portugal,1974,3,0,3
Turkey,Austria,1974,0,1,1
Greece,Cyprus,1974,3,1,4
France,German DR,1974,2,2,4
Argentina,Chile,1974,1,1,2
England,Portugal,1974,0,0,0
Greece,Germany,1974,2,2,4
Netherlands,Italy,1974,3,1,4
Scotland,Spain,1974,1,2,3
Turkey,Republic of Ireland,1974,1,1,2
Wales,Luxembourg,1974,5,0,5
Liberia,Togo,1974,0,2,2
Libya,Tunisia,1974,1,0,1
Suriname,Trinidad and Tobago,1974,0,0,0
Morocco,Gambia,1974,3,0,3
Suriname,Trinidad and Tobago,1974,2,1,3
Grenada,Saint Vincent and the Grenadines,1974,1,0,1
Turkey,Switzerland,1974,2,1,3
Saint Lucia,Dominica,1974,0,3,3
Dominica,Grenada,1974,0,0,0
Hungary,Switzerland,1974,1,0,1
Israel,Romania,1974,0,1,1
Saint Lucia,Saint Vincent and the Grenadines,1974,1,2,3
Dominica,Saint Vincent and the Grenadines,1974,1,2,3
Gambia,Morocco,1974,0,3,3
German DR,Belgium,1974,0,0,0
Saint Lucia,Grenada,1974,1,2,3
Laos,Singapore,1974,0,2,2
Thailand,Malaysia,1974,0,2,2
Cambodia,Vietnam Republic,1974,3,2,5
Kenya,Seychelles,1974,2,3,5
Malaysia,Singapore,1974,0,0,0
Thailand,Laos,1974,6,1,7
Cambodia,South Korea,1974,1,2,3
Laos,Malaysia,1974,2,2,4
Thailand,Singapore,1974,2,1,3
Ghana,Guinea,1974,1,1,2
South Korea,Vietnam Republic,1974,2,2,4
Cambodia,Vietnam Republic,1974,2,0,2
Thailand,Malaysia,1974,4,1,5
Greece,Bulgaria,1974,2,1,3
South Korea,Malaysia,1974,0,0,0
Thailand,Cambodia,1974,1,0,1
Cambodia,Malaysia,1974,0,3,3
Iran,Czechoslovakia,1974,0,1,1
Thailand,South Korea,1974,1,3,4
Chile,Paraguay,1974,1,0,1
Malta,Germany,1974,0,1,1
Suriname,Trinidad and Tobago,1974,2,3,5
Indonesia,South Korea,1974,1,3,4
Bermuda,Suriname,1974,2,1,3
Bermuda,Suriname,1974,1,3,4
Cameroon,Guinea,1974,1,1,2
Italy,Bulgaria,1974,0,0,0
Kuwait,Tunisia,1974,2,0,2
Malawi,Tanzania,1974,1,1,2
Malawi,Tanzania,1974,3,3,6
Cameroon,Guinea,1975,1,0,1
Iraq,Tunisia,1975,0,0,0
Bermuda,Suriname,1975,2,5,7
Cuba,Canada,1975,4,0,4
Iraq,Libya,1975,3,1,4
Kuwait,Libya,1975,1,0,1
Mali,Guinea,1975,0,2,2
Nigeria,Cameroon,1975,1,0,1
Guinea,Cameroon,1975,3,0,3
Malawi,Mauritius,1975,1,0,1
Liberia,Cameroon,1975,2,0,2
Malawi,Mauritius,1975,1,1,2
Jamaica,Haiti,1975,1,0,1
Malawi,Mauritius,1975,3,0,3
Mali,Cameroon,1975,1,2,3
Senegal,Nigeria,1975,0,1,1
Jamaica,Haiti,1975,0,1,1
Spain,Scotland,1975,1,1,2
Liberia,Nigeria,1975,0,1,1
Mali,Senegal,1975,2,1,3
Italy,Norway,1975,4,1,5
Haiti,Jamaica,1975,0,1,1
Nigeria,Senegal,1975,1,1,2
Burkina Faso,Niger,1975,4,1,5
Malta,Greece,1975,2,0,2
Tanzania,Malawi,1975,3,1,4
Haiti,Jamaica,1975,3,2,5
Tanzania,Malawi,1975,2,0,2
Zanzibar,Malawi,1975,2,7,9
Morocco,Tunisia,1975,0,0,0
Brazil,Portugal,1975,2,1,3
England,Germany,1975,2,0,2
Guadeloupe,Puerto Rico,1975,2,1,3
Thailand,Indonesia,1975,3,1,4
Luxembourg,Austria,1975,1,2,3
Malaysia,South Korea,1975,2,1,3
Indonesia,Vietnam Republic,1975,2,1,3
Thailand,Malaysia,1975,0,1,1
South Korea,Vietnam Republic,1975,1,0,1
Turkey,Romania,1975,1,1,2
Malaysia,Indonesia,1975,0,0,0
Thailand,Vietnam Republic,1975,4,0,4
South Korea,Indonesia,1975,1,0,1
Morocco,Senegal,1975,4,0,4
Senegal,Morocco,1975,2,1,3
Tunisia,Algeria,1975,1,1,2
Sudan,Kenya,1975,1,0,1
Niger,Guinea,1975,2,4,6
Uganda,Mauritius,1975,4,0,4
Ghana,Burkina Faso,1975,3,1,4
Malaysia,Vietnam Republic,1975,3,0,3
Kenya,Sudan,1975,0,2,2
Burundi,Egypt,1975,0,3,3
Thailand,South Korea,1975,1,0,1
France,Hungary,1975,2,0,2
German DR,Bulgaria,1975,0,0,0
Poland,United States,1975,7,0,7
Congo,Ivory Coast,1975,1,0,1
Ghana,Mali,1975,4,0,4
Malawi,Zambia,1975,1,6,7
Guadeloupe,Suriname,1975,4,2,6
Barbados,Suriname,1975,1,0,1
Czechoslovakia,Romania,1975,1,1,2
Cyprus,Greece,1975,1,2,3
Austria,Hungary,1975,0,0,0
Iraq,Qatar,1975,1,0,1
Italy,United States,1975,10,0,10
Russia,Turkey,1975,3,0,3
Saudi Arabia,Afghanistan,1975,2,0,2
Iraq,Afghanistan,1975,4,0,4
Macau,Panama,1975,2,1,3
Saudi Arabia,Qatar,1975,2,1,3
Mauritius,Uganda,1975,1,1,2
Guinea,Niger,1975,3,0,3
Algeria,Tunisia,1975,1,2,3
Iraq,Saudi Arabia,1975,1,1,2
Qatar,Afghanistan,1975,2,1,3
Iraq,Qatar,1975,3,0,3
Saudi Arabia,Afghanistan,1975,6,0,6
Iraq,Saudi Arabia,1975,2,1,3
Qatar,Afghanistan,1975,1,1,2
Ivory Coast,Congo,1975,2,1,3
Mali,Ghana,1975,3,1,4
Cameroon,Togo,1975,3,0,3
Iraq,Afghanistan,1975,3,1,4
Zambia,Malawi,1975,3,3,6
Saudi Arabia,Qatar,1975,0,1,1
England,Cyprus,1975,5,0,5
Hungary,Wales,1975,1,2,3
Northern Ireland,Yugoslavia,1975,1,0,1
Sweden,Scotland,1975,1,1,2
Spain,Romania,1975,1,1,2
Italy,Poland,1975,0,0,0
Egypt,Burundi,1975,2,0,2
Togo,Cameroon,1975,4,0,4
Czechoslovakia,Cyprus,1975,4,0,4
France,Portugal,1975,0,2,2
Nigeria,Togo,1975,1,0,1
Senegal,Ivory Coast,1975,1,0,1
Bulgaria,Germany,1975,1,1,2
Ivory Coast,Togo,1975,0,3,3
Senegal,Nigeria,1975,1,0,1
Belgium,Netherlands,1975,1,0,1
Czechoslovakia,Portugal,1975,5,0,5
Switzerland,Turkey,1975,1,1,2
Luxembourg,Wales,1975,1,3,4
Republic of Ireland,Switzerland,1975,2,1,3
Martinique,Guadeloupe,1975,8,2,10
Cyprus,England,1975,0,1,1
Romania,Denmark,1975,6,1,7
Scotland,Portugal,1975,1,0,1
Myanmar,Thailand,1975,4,1,5
Finland,Norway,1975,3,5,8
South Korea,Lebanon,1975,1,0,1
Germany,Netherlands,1975,1,1,2
Northern Ireland,England,1975,0,0,0
Wales,Scotland,1975,2,2,4
Russia,Republic of Ireland,1975,2,1,3
Sweden,Algeria,1975,4,0,4
Scotland,Northern Ireland,1975,3,0,3
England,Wales,1975,2,2,4
Switzerland,Republic of Ireland,1975,1,0,1
South Korea,Myanmar,1975,1,0,1
China PR,Equatorial Guinea,1975,6,2,8
Northern Ireland,Wales,1975,1,0,1
England,Scotland,1975,5,1,6
Iceland,France,1975,0,0,0
German DR,Poland,1975,1,2,3
Romania,Scotland,1975,1,1,2
Greece,Malta,1975,4,0,4
Sweden,Yugoslavia,1975,1,2,3
Uruguay,Chile,1975,1,0,1
Finland,Italy,1975,0,1,1
Iceland,German DR,1975,2,1,3
Kenya,Ethiopia,1975,2,1,3
Austria,Czechoslovakia,1975,0,0,0
Cyprus,Portugal,1975,0,2,2
Guinea-Bissau,Gambia,1975,1,0,1
Russia,Italy,1975,1,0,1
Norway,Yugoslavia,1975,1,3,4
Bulgaria,Malta,1975,5,0,5
Kenya,Congo,1975,2,1,3
Myanmar,South Korea,1975,0,2,2
Indonesia,Thailand,1975,5,0,5
Paraguay,Uruguay,1975,0,1,1
Malaysia,Thailand,1975,1,0,1
Panama,Costa Rica,1975,1,1,2
Uganda,Congo,1975,0,1,1
Hong Kong,Japan,1975,0,0,0
Indonesia,Malaysia,1975,3,1,4
China PR,North Korea,1975,1,0,1
Indonesia,Myanmar,1975,0,2,2
South Korea,Malaysia,1975,1,1,2
North Korea,Japan,1975,1,0,1
Myanmar,Malaysia,1975,2,0,2
Indonesia,South Korea,1975,3,2,5
China PR,Brunei,1975,10,1,11
North Korea,Singapore,1975,1,0,1
Uruguay,Paraguay,1975,0,1,1
Hong Kong,China PR,1975,0,1,1
Ecuador,Peru,1975,6,0,6
Tanzania,Zambia,1975,1,1,2
China PR,Japan,1975,2,1,3
Iceland,Faroe Islands,1975,6,0,6
Hong Kong,North Korea,1975,3,3,6
United States,Poland,1975,0,4,4
Chile,Uruguay,1975,1,3,4
Denmark,Finland,1975,2,0,2
Ecuador,Peru,1975,1,0,1
Mozambique,Zambia,1975,2,1,3
North Korea,China PR,1975,2,0,2
Bolivia,Argentina,1975,1,2,3
Mozambique,Tanzania,1975,2,1,3
Ghana,Morocco,1975,2,0,2
Sweden,Norway,1975,3,1,4
Peru,Ecuador,1975,2,0,2
China PR,Thailand,1975,2,2,4
Togo,Guinea,1975,2,2,4
Canada,Poland,1975,1,8,9
Malawi,Kenya,1975,3,3,6
Tunisia,Sudan,1975,3,2,5
Bolivia,Paraguay,1975,1,2,3
Hong Kong,Thailand,1975,1,1,2
Malawi,Kenya,1975,1,2,3
Bolivia,Ecuador,1975,1,0,1
Canada,Poland,1975,1,4,5
Malawi,Kenya,1975,3,1,4
Peru,Paraguay,1975,2,0,2
Zambia,Uganda,1975,2,1,3
Egypt,DR Congo,1975,3,2,5
Congo,Nigeria,1975,0,1,1
Morocco,Ghana,1975,2,0,2
Chile,Peru,1975,1,1,2
Guinea,Togo,1975,2,0,2
Uruguay,Argentina,1975,2,3,5
Bolivia,Chile,1975,2,1,3
Colombia,Paraguay,1975,1,0,1
New Zealand,China PR,1975,2,1,3
New Zealand,China PR,1975,2,2,4
Ecuador,Paraguay,1975,2,2,4
New Zealand,China PR,1975,2,0,2
Nigeria,Congo,1975,2,1,3
Bolivia,Peru,1975,0,1,1
Ecuador,Colombia,1975,1,3,4
Malaysia,Thailand,1975,1,0,1
Fiji,China PR,1975,1,4,5
Bangladesh,Indonesia,1975,0,4,4
Canada,German DR,1975,0,3,3
Malaysia,South Korea,1975,1,3,4
Myanmar,Thailand,1975,1,0,1
Hong Kong,Japan,1975,2,0,2
Paraguay,Colombia,1975,0,1,1
Canada,German DR,1975,1,7,8
Venezuela,Brazil,1975,0,4,4
Malaysia,Hong Kong,1975,3,1,4
Myanmar,Indonesia,1975,2,0,2
Hong Kong,South Korea,1975,0,1,1
Mexico,German DR,1975,2,3,5
Panama,Guatemala,1975,2,0,2
Bangladesh,Thailand,1975,1,1,2
New Caledonia,Tahiti,1975,3,0,3
Vanuatu,Papua New Guinea,1975,3,0,3
Guam,Solomon Islands,1975,1,5,6
Malaysia,Japan,1975,2,0,2
Myanmar,South Korea,1975,2,3,5
Hong Kong,Indonesia,1975,2,3,5
Mexico,German DR,1975,0,1,1
Venezuela,Argentina,1975,1,5,6
Bangladesh,Japan,1975,0,3,3
New Caledonia,Vanuatu,1975,3,1,4
Papua New Guinea,Tahiti,1975,2,4,6
Guam,Fiji,1975,0,11,11
Malaysia,Indonesia,1975,2,1,3
New Caledonia,Papua New Guinea,1975,5,1,6
Vanuatu,Tahiti,1975,0,3,3
Fiji,Solomon Islands,1975,1,1,2
Australia,China PR,1975,1,0,1
Brazil,Argentina,1975,2,1,3
Myanmar,Hong Kong,1975,5,0,5
Ghana,Ivory Coast,1975,3,1,4
Mexico,German DR,1975,1,0,1
Malaysia,Bangladesh,1975,3,0,3
Colombia,Ecuador,1975,2,0,2
Fiji,Tahiti,1975,0,3,3
Indonesia,Japan,1975,1,4,5
South Korea,Thailand,1975,6,0,6
New Caledonia,Solomon Islands,1975,4,0,4
Peru,Bolivia,1975,3,1,4
Bangladesh,Myanmar,1975,1,7,8
Fiji,Solomon Islands,1975,2,3,5
Indonesia,Thailand,1975,2,1,3
Japan,South Korea,1975,1,3,4
New Caledonia,Tahiti,1975,1,2,3
Argentina,Venezuela,1975,11,0,11
Bangladesh,Hong Kong,1975,1,9,10
Ghana,Ivory Coast,1975,0,0,0
Iran,Hungary,1975,1,2,3
Malaysia,Myanmar,1975,2,1,3
Paraguay,Ecuador,1975,3,1,4
Indonesia,South Korea,1975,1,5,6
Japan,Thailand,1975,4,0,4
Brazil,Venezuela,1975,6,0,6
Chile,Bolivia,1975,4,0,4
Norway,Sweden,1975,0,2,2
Myanmar,Japan,1975,0,2,2
China PR,Kuwait,1975,3,3,6
Sudan,Tunisia,1975,2,1,3
Uganda,Zambia,1975,3,0,3
Bangladesh,South Korea,1975,0,4,4
Hong Kong,Thailand,1975,3,0,3
Panama,Haiti,1975,2,0,2
Argentina,Brazil,1975,0,1,1
Malaysia,South Korea,1975,0,1,1
Mexico,Costa Rica,1975,7,0,7
Panama,Haiti,1975,1,1,2
Costa Rica,United States,1975,3,1,4
Peru,Chile,1975,3,1,4
Argentina,United States,1975,6,0,6
Ghana,Nigeria,1975,1,2,3
Mexico,United States,1975,2,0,2
Ghana,Nigeria,1975,3,0,3
Mexico,Argentina,1975,1,1,2
Austria,Germany,1975,0,2,2
Denmark,Scotland,1975,0,1,1
France,Iceland,1975,3,0,3
Netherlands,Finland,1975,4,1,5
Northern Ireland,Sweden,1975,1,2,3
Switzerland,England,1975,1,2,3
Mali,Nigeria,1975,4,1,5
Panama,Cuba,1975,0,1,1
Belgium,Iceland,1975,1,0,1
Ivory Coast,Nigeria,1975,1,1,2
Panama,Cuba,1975,2,2,4
South Korea,Japan,1975,3,0,3
Poland,Netherlands,1975,4,1,5
Panama,Cuba,1975,2,3,5
Colombia,Uruguay,1975,3,0,3
Czechoslovakia,Switzerland,1975,1,1,2
Greece,Romania,1975,1,1,2
Hungary,Austria,1975,2,1,3
Sweden,Denmark,1975,0,0,0
Haiti,Guadeloupe,1975,3,0,3
Belgium,German DR,1975,1,2,3
Italy,Finland,1975,0,0,0
Brazil,Peru,1975,1,3,4
Uruguay,Colombia,1975,1,0,1
Peru,Brazil,1975,0,2,2
Antigua and Barbuda,Barbados,1975,1,0,1
Poland,Hungary,1975,4,2,6
Uganda,DR Congo,1975,1,2,3
Germany,Greece,1975,1,1,2
German DR,France,1975,2,1,3
Romania,Turkey,1975,2,2,4
Spain,Denmark,1975,2,0,2
Switzerland,Russia,1975,0,1,1
Austria,Luxembourg,1975,6,2,8
Czechoslovakia,Hungary,1975,1,1,2
Netherlands,Poland,1975,3,0,3
Yugoslavia,Sweden,1975,3,0,3
Colombia,Peru,1975,1,0,1
Tanzania,Kenya,1975,1,2,3
China PR,New Zealand,1975,2,1,3
Hungary,Luxembourg,1975,8,1,9
Israel,Mexico,1975,1,0,1
Peru,Colombia,1975,2,0,2
Zambia,Mozambique,1975,3,0,3
Poland,Italy,1975,0,0,0
Colombia,Peru,1975,0,1,1
Republic of Ireland,Turkey,1975,4,0,4
Northern Ireland,Norway,1975,3,0,3
Scotland,Denmark,1975,3,1,4
Czechoslovakia,England,1975,2,1,3
Zambia,Kenya,1975,1,2,3
Malawi,Tanzania,1975,3,1,4
Zambia,Uganda,1975,0,1,1
Malawi,Zanzibar,1975,4,2,6
Kenya,Uganda,1975,1,1,2
French Guiana,Martinique,1975,1,2,3
Macau,New Zealand,1975,1,1,2
Tanzania,Zanzibar,1975,4,0,4
Kenya,Tanzania,1975,3,2,5
Malawi,Uganda,1975,2,1,3
Kenya,Malawi,1975,2,2,4
Singapore,New Zealand,1975,2,2,4
Portugal,Czechoslovakia,1975,1,1,2
Russia,Switzerland,1975,4,1,5
France,Belgium,1975,0,0,0
Romania,Spain,1975,2,2,4
Cameroon,DR Congo,1975,2,1,3
Germany,Bulgaria,1975,1,0,1
Portugal,England,1975,1,1,2
Wales,Austria,1975,1,0,1
Yugoslavia,Northern Ireland,1975,1,0,1
Cameroon,DR Congo,1975,2,2,4
Italy,Netherlands,1975,1,0,1
Cyprus,Czechoslovakia,1975,0,3,3
Turkey,Russia,1975,1,0,1
Romania,Russia,1975,2,2,4
Portugal,Cyprus,1975,1,0,1
Scotland,Romania,1975,1,1,2
Egypt,Yemen DPR,1975,5,0,5
Palestine,Sudan,1975,0,0,0
Tunisia,United Arab Emirates,1975,3,0,3
Malawi,Eswatini,1975,2,0,2
Turkey,Germany,1975,0,5,5
Myanmar,South Korea,1975,1,3,4
Iraq,United Arab Emirates,1975,5,0,5
Libya,Syria,1975,2,3,5
Malaysia,Singapore,1975,0,0,0
Malta,Bulgaria,1975,0,2,2
Palestine,Sudan,1975,0,1,1
Saudi Arabia,Yemen DPR,1975,0,1,1
Malawi,Eswatini,1975,0,0,0
Egypt,Saudi Arabia,1975,2,1,3
Libya,Syria,1975,1,0,1
Thailand,South Korea,1975,2,1,3
Tunisia,Iraq,1975,1,1,2
Myanmar,Singapore,1975,6,0,6
Bermuda,Suriname,1975,1,5,6
Egypt,Sudan,1975,3,1,4
Iraq,Syria,1975,4,0,4
Thailand,Singapore,1975,0,1,1
Myanmar,Malaysia,1975,2,1,3
Egypt,Iraq,1975,1,0,1
Sudan,Syria,1975,1,0,1
Thailand,Malaysia,1975,1,0,1
Italy,Greece,1975,3,2,5
South Korea,Singapore,1975,5,0,5
Libya,Sudan,1976,1,0,1
Thailand,Myanmar,1976,0,0,0
South Korea,Malaysia,1976,4,0,4
Myanmar,South Korea,1976,0,1,1
Saudi Arabia,Algeria,1976,1,3,4
Gambia,Guinea-Bissau,1976,3,1,4
Gambia,Mali,1976,0,3,3
Mauritania,Senegal,1976,1,4,5
Guinea,Senegal,1976,2,2,4
Guinea-Bissau,Mali,1976,1,1,2
Guinea,Mauritania,1976,4,0,4
Guinea,Mali,1976,0,1,1
Chad,Gabon,1976,4,0,4
Japan,Bulgaria,1976,1,3,4
Japan,Bulgaria,1976,1,1,2
Japan,Bulgaria,1976,0,3,3
Israel,Denmark,1976,0,1,1
Montenegro,Russia,1976,2,1,3
Congo,Angola,1976,3,2,5
Iraq,Turkey,1976,0,0,0
Kenya,Nigeria,1976,1,1,2
Malawi,Lesotho,1976,4,1,5
El Salvador,Hungary,1976,1,2,3
Zambia,Nigeria,1976,1,3,4
Angola,Congo,1976,1,1,2
Iraq,German DR,1976,1,1,2
Tunisia,Yugoslavia,1976,2,1,3
Nigeria,Tanzania,1976,0,0,0
Saudi Arabia,Morocco,1976,0,2,2
Gabon,Chad,1976,0,1,1
Algeria,Yugoslavia,1976,1,2,3
Paraguay,Argentina,1976,2,3,5
Uruguay,Brazil,1976,1,2,3
Argentina,Brazil,1976,1,2,3
Germany,Malta,1976,8,0,8
Tunisia,Sweden,1976,1,1,2
Egypt,Guinea,1976,1,1,2
Ethiopia,Uganda,1976,2,0,2
New Zealand,Australia,1976,0,1,1
Morocco,Sudan,1976,2,2,4
Nigeria,DR Congo,1976,4,2,6
Algeria,Sweden,1976,0,2,2
Australia,New Zealand,1976,3,1,4
Egypt,Uganda,1976,2,1,3
Ethiopia,Guinea,1976,1,2,3
Israel,Northern Ireland,1976,1,1,2
Morocco,DR Congo,1976,1,0,1
Nigeria,Sudan,1976,1,0,1
Ethiopia,Egypt,1976,1,1,2
Guinea,Uganda,1976,2,1,3
Morocco,Nigeria,1976,3,1,4
Sudan,DR Congo,1976,1,1,2
Sierra Leone,Niger,1976,5,1,6
Egypt,Morocco,1976,1,2,3
Guinea,Nigeria,1976,1,1,2
Czechoslovakia,Russia,1976,2,2,4
Malta,Libya,1976,2,2,4
Uruguay,Paraguay,1976,2,2,4
Egypt,Guinea,1976,2,4,6
Morocco,Nigeria,1976,2,1,3
Burkina Faso,Mauritania,1976,1,1,2
Egypt,Nigeria,1976,2,3,5
Guinea,Morocco,1976,1,1,2
Russia,Argentina,1976,0,1,1
Ghana,Togo,1976,4,0,4
Ivory Coast,Senegal,1976,4,1,5
Niger,Sierra Leone,1976,2,1,3
Bulgaria,Russia,1976,0,3,3
Republic of Ireland,Norway,1976,3,0,3
Poland,Argentina,1976,1,2,3
Wales,England,1976,1,2,3
Qatar,Saudi Arabia,1976,1,0,1
Bahrain,United Arab Emirates,1976,3,2,5
France,Czechoslovakia,1976,2,2,4
Hungary,Argentina,1976,2,0,2
Iraq,Oman,1976,4,0,4
Gabon,Ivory Coast,1976,0,3,3
Mauritania,Burkina Faso,1976,0,2,2
Qatar,Kuwait,1976,0,4,4
Bahrain,Iraq,1976,1,4,5
Saudi Arabia,United Arab Emirates,1976,2,0,2
Kuwait,Oman,1976,8,0,8
Algeria,Libya,1976,1,0,1
Iraq,Saudi Arabia,1976,7,1,8
Qatar,United Arab Emirates,1976,3,1,4
Bahrain,Oman,1976,1,0,1
Dominican Republic,Haiti,1976,0,3,3
Kuwait,United Arab Emirates,1976,0,0,0
Qatar,Iraq,1976,0,0,0
Oman,Saudi Arabia,1976,1,3,4
Panama,Costa Rica,1976,3,2,5
Bahrain,Kuwait,1976,2,5,7
Iraq,United Arab Emirates,1976,4,0,4
Italy,Portugal,1976,3,1,4
Paraguay,Brazil,1976,1,1,2
Qatar,Oman,1976,4,1,5
Scotland,Switzerland,1976,1,0,1
Argentina,Uruguay,1976,4,1,5
Bahrain,Saudi Arabia,1976,2,1,3
Iraq,Kuwait,1976,2,2,4
Oman,United Arab Emirates,1976,1,1,2
Qatar,Bahrain,1976,3,0,3
Kuwait,Saudi Arabia,1976,3,1,4
Iraq,Kuwait,1976,2,4,6
Libya,Algeria,1976,0,0,0
Haiti,Dominican Republic,1976,3,0,3
Yugoslavia,Hungary,1976,0,0,0
Ivory Coast,Gabon,1976,1,3,4
Sierra Leone,Guinea,1976,1,1,2
Congo,Cuba,1976,3,1,4
German DR,Algeria,1976,5,0,5
Czechoslovakia,Russia,1976,2,0,2
France,Poland,1976,2,0,2
Spain,Germany,1976,1,1,2
Yugoslavia,Wales,1976,2,0,2
Netherlands,Belgium,1976,5,0,5
Sierra Leone,Liberia,1976,1,0,1
Argentina,Paraguay,1976,2,2,4
Austria,Sweden,1976,1,0,1
Brazil,Uruguay,1976,2,1,3
Switzerland,Hungary,1976,0,1,1
Algeria,Guinea,1976,1,2,3
Gabon,São Tomé and Príncipe,1976,6,1,7
Guadeloupe,Martinique,1976,0,1,1
Panama,El Salvador,1976,1,1,2
Bulgaria,North Korea,1976,3,0,3
China PR,Malaysia,1976,2,0,2
Greece,Poland,1976,1,0,1
Scotland,Wales,1976,3,1,4
Scotland,Northern Ireland,1976,3,0,3
Wales,England,1976,0,1,1
Zambia,Malawi,1976,4,0,4
England,Northern Ireland,1976,4,0,4
Martinique,Guadeloupe,1976,3,2,5
Sweden,Denmark,1976,1,2,3
Switzerland,Poland,1976,2,1,3
Bulgaria,Romania,1976,1,0,1
Wales,Northern Ireland,1976,1,0,1
Scotland,England,1976,2,1,3
Brazil,Argentina,1976,2,0,2
Finland,Switzerland,1976,1,0,1
Norway,Iceland,1976,0,1,1
Paraguay,Uruguay,1976,1,0,1
Belgium,Netherlands,1976,1,2,3
Germany,Spain,1976,2,0,2
Hungary,France,1976,1,0,1
Russia,Czechoslovakia,1976,2,2,4
Wales,Yugoslavia,1976,1,1,2
Brazil,England,1976,1,0,1
Cyprus,Denmark,1976,1,5,6
Hungary,Russia,1976,1,1,2
Poland,Republic of Ireland,1976,0,2,2
England,Italy,1976,3,2,5
Malawi,Zambia,1976,0,1,1
Brazil,Italy,1976,4,1,5
Finland,Sweden,1976,0,2,2
Kuwait,Malaysia,1976,2,0,2
Iran,Iraq,1976,2,0,2
Mexico,Brazil,1976,0,3,3
China PR,Malaysia,1976,1,1,2
Italy,Romania,1976,4,2,6
Iraq,Yemen DPR,1976,1,0,1
Catalonia,Russia,1976,1,1,2
China PR,Kuwait,1976,0,1,1
Myanmar,Malaysia,1976,3,1,4
Iran,Yemen DPR,1976,8,0,8
Brazil,Paraguay,1976,3,1,4
Uruguay,Argentina,1976,0,3,3
Indonesia,Malaysia,1976,1,2,3
Iran,China PR,1976,2,0,2
Iraq,Kuwait,1976,2,3,5
Hungary,Austria,1976,2,0,2
Indonesia,Myanmar,1976,1,1,2
China PR,Iraq,1976,1,0,1
Finland,England,1976,1,4,5
Iran,Kuwait,1976,1,0,1
Czechoslovakia,Netherlands,1976,3,1,4
Faroe Islands,Iceland,1976,1,6,7
Sweden,Norway,1976,2,0,2
Yugoslavia,Germany,1976,2,4,6
Yugoslavia,Netherlands,1976,2,3,5
Czechoslovakia,Germany,1976,2,2,4
Austria,Russia,1976,1,2,3
Norway,Denmark,1976,0,0,0
Réunion,Kenya,1976,1,3,4
Guatemala,Costa Rica,1976,1,0,1
Gabon,DR Congo,1976,1,1,2
Seychelles,Réunion,1976,1,4,5
Iran,Romania,1976,2,2,4
Réunion,Mauritius,1976,0,2,2
Rwanda,DR Congo,1976,1,6,7
Seychelles,Kenya,1976,1,4,5
Guyana,Suriname,1976,2,0,2
Cameroon,DR Congo,1976,2,1,3
Malawi,Kenya,1976,1,0,1
Burundi,DR Congo,1976,0,1,1
Guatemala,El Salvador,1976,1,0,1
Malawi,Sierra Leone,1976,4,2,6
Costa Rica,Panama,1976,3,0,3
Finland,Iceland,1976,1,0,1
Afghanistan,Pakistan,1976,1,0,1
India,Pakistan,1976,1,1,2
Afghanistan,India,1976,1,1,2
Curaçao,Haiti,1976,1,2,3
Malaysia,South Korea,1976,2,1,3
Myanmar,Indonesia,1976,5,1,6
India,Japan,1976,1,5,6
São Tomé and Príncipe,Congo,1976,2,3,5
Malaysia,Thailand,1976,0,0,0
Malaysia,India,1976,5,1,6
India,South Korea,1976,0,8,8
Indonesia,Japan,1976,0,6,6
Australia,Hong Kong,1976,0,1,1
Myanmar,Thailand,1976,1,0,1
El Salvador,Panama,1976,4,1,5
Sweden,Finland,1976,6,0,6
Indonesia,South Korea,1976,0,2,2
Myanmar,Japan,1976,2,2,4
Malaysia,Indonesia,1976,7,1,8
Haiti,Curaçao,1976,7,0,7
India,Thailand,1976,2,6,8
Indonesia,India,1976,1,3,4
Barbados,Trinidad and Tobago,1976,2,1,3
Myanmar,South Korea,1976,2,2,4
Jamaica,Cuba,1976,1,3,4
Japan,Thailand,1976,2,2,4
Malaysia,Myanmar,1976,3,1,4
Switzerland,Bulgaria,1976,2,2,4
Australia,Hong Kong,1976,2,0,2
Indonesia,Thailand,1976,0,1,1
Japan,South Korea,1976,0,0,0
Myanmar,India,1976,2,2,4
South Korea,Thailand,1976,2,1,3
Malaysia,Japan,1976,2,2,4
Iceland,Luxembourg,1976,3,1,4
Malaysia,Japan,1976,2,0,2
Denmark,Norway,1976,3,0,3
Finland,Turkey,1976,2,1,3
Cuba,Jamaica,1976,2,0,2
Suriname,Guyana,1976,3,0,3
Trinidad and Tobago,Barbados,1976,1,0,1
Denmark,France,1976,1,1,2
Burkina Faso,Ivory Coast,1976,1,1,2
Malawi,Uganda,1976,1,1,2
Iceland,Belgium,1976,0,1,1
Saudi Arabia,Iraq,1976,0,0,0
Malawi,Uganda,1976,1,2,3
England,Republic of Ireland,1976,1,1,2
Iceland,Netherlands,1976,0,1,1
Libya,Algeria,1976,0,1,1
Norway,Switzerland,1976,1,0,1
Scotland,Finland,1976,6,0,6
Sweden,Hungary,1976,1,1,2
Ivory Coast,Ghana,1976,3,1,4
Libya,Algeria,1976,1,0,1
South Korea,Malaysia,1976,4,4,8
Myanmar,New Zealand,1976,0,2,2
Saudi Arabia,Morocco,1976,0,2,2
South Korea,India,1976,4,0,4
Malawi,Botswana,1976,7,1,8
Malaysia,Singapore,1976,4,1,5
Barbados,Trinidad and Tobago,1976,1,3,4
India,Singapore,1976,1,2,3
Myanmar,Thailand,1976,2,0,2
South Korea,Singapore,1976,7,0,7
Malawi,Botswana,1976,3,0,3
Panama,Guatemala,1976,2,4,6
New Zealand,Thailand,1976,3,1,4
India,Malaysia,1976,0,4,4
Austria,Switzerland,1976,3,1,4
Bulgaria,Turkey,1976,2,2,4
Denmark,Italy,1976,0,1,1
Finland,Luxembourg,1976,7,1,8
German DR,Hungary,1976,1,1,2
Greece,Israel,1976,0,1,1
Norway,Sweden,1976,3,2,5
Romania,Czechoslovakia,1976,1,1,2
South Korea,New Zealand,1976,2,0,2
Canada,United States,1976,1,1,2
Italy,Yugoslavia,1976,3,0,3
Guatemala,Panama,1976,7,0,7
Ivory Coast,Burkina Faso,1976,2,0,2
Botswana,Zambia,1976,2,3,5
Saudi Arabia,Tunisia,1976,0,1,1
New Caledonia,New Zealand,1976,2,1,3
United States,Mexico,1976,0,0,0
Chile,Uruguay,1976,0,0,0
Czechoslovakia,Romania,1976,3,2,5
Wales,Germany,1976,0,2,2
Bulgaria,France,1976,2,2,4
Greece,Hungary,1976,1,1,2
Switzerland,Sweden,1976,1,2,3
Uganda,Burundi,1976,2,0,2
Albania,Algeria,1976,3,0,3
Canada,Mexico,1976,1,0,1
Ethiopia,Mauritius,1976,3,0,3
Ghana,Guinea,1976,2,1,3
Spain,Yugoslavia,1976,1,0,1
Uganda,Burundi,1976,1,0,1
Pakistan,Afghanistan,1976,1,0,1
Peru,Uruguay,1976,0,0,0
Argentina,Chile,1976,2,0,2
Austria,Hungary,1976,2,4,6
Czechoslovakia,Scotland,1976,2,0,2
England,Finland,1976,2,1,3
Netherlands,Northern Ireland,1976,2,2,4
Turkey,Republic of Ireland,1976,3,3,6
Colombia,Uruguay,1976,1,2,3
Mexico,United States,1976,3,0,3
Luxembourg,Italy,1976,1,4,5
Portugal,Poland,1976,0,2,2
Sierra Leone,Nigeria,1976,0,0,0
Congo,Cameroon,1976,2,2,4
Togo,Senegal,1976,1,0,1
Ecuador,Uruguay,1976,2,2,4
Indonesia,Australia,1976,1,1,2
Iraq,Libya,1976,1,0,1
United States,Canada,1976,2,0,2
Iraq,Libya,1976,3,1,4
Singapore,Australia,1976,0,1,1
Hong Kong,Australia,1976,0,2,2
Malawi,Mauritius,1976,1,1,2
Uganda,Ethiopia,1976,4,1,5
Bulgaria,German DR,1976,0,4,4
Denmark,Cyprus,1976,5,0,5
Mexico,Canada,1976,0,0,0
Peru,Argentina,1976,1,3,4
Egypt,Ethiopia,1976,3,0,3
Nigeria,Sierra Leone,1976,6,2,8
Cameroon,Congo,1976,1,2,3
Guinea,Ghana,1976,2,1,3
Poland,Cyprus,1976,5,0,5
Senegal,Togo,1976,1,1,2
Turkey,Malta,1976,4,0,4
Algeria,Libya,1976,2,0,2
Israel,Australia,1976,1,1,2
Tunisia,Libya,1976,3,0,3
Zanzibar,Zambia,1976,0,3,3
Somalia,Uganda,1976,0,2,2
Tanzania,Kenya,1976,1,1,2
Tanzania,Malawi,1976,1,1,2
Somalia,Zambia,1976,2,4,6
Zanzibar,Uganda,1976,0,1,1
Kenya,Malawi,1976,2,2,4
Argentina,Peru,1976,1,0,1
Belgium,Northern Ireland,1976,2,0,2
Greece,Austria,1976,0,3,3
Haiti,United States,1976,0,0,0
Zanzibar,Somalia,1976,1,0,1
Uganda,Zambia,1976,2,3,5
Haiti,United States,1976,0,0,0
Kenya,Zambia,1976,0,2,2
Malawi,Uganda,1976,1,2,3
Saudi Arabia,Syria,1976,2,0,2
Ethiopia,Egypt,1976,1,2,3
Haiti,United States,1976,0,0,0
Suriname,Trinidad and Tobago,1976,1,1,2
Uganda,Zambia,1976,2,0,2
Tanzania,Zambia,1976,2,3,5
Zanzibar,Somalia,1976,1,1,2
France,Republic of Ireland,1976,2,0,2
German DR,Turkey,1976,1,1,2
Germany,Czechoslovakia,1976,2,0,2
Italy,England,1976,2,0,2
Portugal,Denmark,1976,1,0,1
Scotland,Wales,1976,1,0,1
Mali,Burkina Faso,1976,2,1,3
Malta,Tunisia,1976,1,1,2
Uruguay,Peru,1976,0,0,0
Syria,Saudi Arabia,1976,2,1,3
Argentina,Russia,1976,0,0,0
Cuba,Haiti,1976,1,1,2
Romania,Bulgaria,1976,3,2,5
Trinidad and Tobago,Suriname,1976,2,2,4
Brazil,Russia,1976,2,0,2
El Salvador,Costa Rica,1976,1,1,2
Japan,South Korea,1976,1,2,3
Costa Rica,Guatemala,1976,0,0,0
Cyprus,Portugal,1976,1,2,3
Malta,Austria,1976,0,1,1
Guatemala,El Salvador,1976,3,1,4
Haiti,Cuba,1976,1,1,2
Guatemala,Costa Rica,1976,1,1,2
Morocco,Tunisia,1976,1,1,2
Costa Rica,El Salvador,1976,1,1,2
Israel,Austria,1976,1,3,4
Thailand,South Korea,1976,2,1,3
South Korea,Singapore,1976,4,0,4
Bangladesh,Malaysia,1976,0,6,6
Suriname,Trinidad and Tobago,1976,3,2,5
El Salvador,Guatemala,1976,2,0,2
Thailand,Singapore,1976,6,0,6
Canada,United States,1976,3,0,3
South Korea,Malaysia,1976,1,1,2
Portugal,Italy,1976,2,1,3
Panama,Cuba,1976,0,5,5
Thailand,Malaysia,1976,1,1,2
Cuba,Haiti,1976,0,2,2
Uruguay,Ecuador,1977,1,1,2
Northern Cyprus,Turkey,1977,0,1,1
Saudi Arabia,Iran,1977,0,3,3
Paraguay,Ecuador,1977,2,0,2
Tunisia,Morocco,1977,1,1,2
Algeria,Bulgaria,1977,1,1,2
Paraguay,Uruguay,1977,1,1,2
Colombia,Ecuador,1977,0,1,1
Guinea,Ghana,1977,2,0,2
Venezuela,Ecuador,1977,1,0,1
Brazil,Bulgaria,1977,1,0,1
Congo,Gabon,1977,2,2,4
Uruguay,Paraguay,1977,2,1,3
Uganda,Iraq,1977,1,1,2
Cameroon,Congo,1977,2,2,4
Chile,Paraguay,1977,4,0,4
Ecuador,Colombia,1977,4,1,5
Israel,Greece,1977,1,1,2
Italy,Belgium,1977,2,1,3
Mauritius,Malawi,1977,3,2,5
Colombia,Yugoslavia,1977,0,1,1
Cyprus,Bulgaria,1977,1,2,3
Gambia,Denmark,1977,1,4,5
Uruguay,Chile,1977,3,0,3
Mexico,Yugoslavia,1977,5,1,6
Tanzania,Mozambique,1977,2,1,3
France,Romania,1977,2,0,2
Paraguay,Chile,1977,2,0,2
Senegal,Denmark,1977,2,3,5
Gabon,Morocco,1977,0,1,1
Bolivia,Paraguay,1977,0,1,1
Kenya,Egypt,1977,0,0,0
Tunisia,Algeria,1977,2,0,2
Mexico,Yugoslavia,1977,0,1,1
Bolivia,Paraguay,1977,2,2,4
England,Netherlands,1977,0,2,2
Republic of Ireland,Spain,1977,0,1,1
Peru,Hungary,1977,3,2,5
Thailand,Israel,1977,3,3,6
Venezuela,Uruguay,1977,1,1,2
Australia,Israel,1977,1,1,2
Ecuador,Paraguay,1977,2,1,3
Ivory Coast,Congo,1977,3,2,5
Togo,Guinea,1977,0,2,2
Uganda,Zambia,1977,1,0,1
Nigeria,Benin,1977,7,0,7
Singapore,South Korea,1977,0,4,4
Australia,Israel,1977,1,1,2
Turkey,Bulgaria,1977,2,0,2
Bahrain,South Korea,1977,1,4,5
Algeria,Kenya,1977,4,1,5
Mauritius,Ethiopia,1977,2,3,5
Sierra Leone,Nigeria,1977,1,1,2
Bahrain,South Korea,1977,1,1,2
Colombia,Brazil,1977,0,0,0
Ecuador,Peru,1977,1,1,2
Panama,Paraguay,1977,0,4,4
Mexico,Hungary,1977,1,1,2
France,Germany,1977,1,0,1
Colombia,Paraguay,1977,0,1,1
Argentina,Hungary,1977,5,1,6
Bolivia,Uruguay,1977,1,0,1
Botswana,China PR,1977,0,2,2
Congo,Ivory Coast,1977,1,3,4
Ecuador,Chile,1977,0,1,1
Egypt,Kenya,1977,1,0,1
Guinea,Togo,1977,2,1,3
Israel,South Korea,1977,0,0,0
Singapore,Thailand,1977,2,0,2
Zambia,Uganda,1977,4,2,6
Algeria,Tunisia,1977,1,1,2
Hong Kong,Indonesia,1977,4,1,5
Malaysia,Thailand,1977,6,4,10
Singapore,Hong Kong,1977,2,2,4
Indonesia,Malaysia,1977,0,0,0
New Zealand,New Caledonia,1977,3,0,3
Senegal,Guinea,1977,1,0,1
Thailand,Hong Kong,1977,1,2,3
Tunisia,Malta,1977,0,1,1
Chile,Peru,1977,1,1,2
Israel,Japan,1977,2,0,2
Paraguay,Colombia,1977,1,1,2
Singapore,Malaysia,1977,1,0,1
Venezuela,Bolivia,1977,1,3,4
Guadeloupe,Martinique,1977,1,3,4
Thailand,Indonesia,1977,3,2,5
Malaysia,Hong Kong,1977,1,1,2
New Zealand,New Caledonia,1977,4,0,4
Qatar,Tunisia,1977,1,0,1
Austria,Greece,1977,2,0,2
Brazil,Colombia,1977,6,0,6
Singapore,Indonesia,1977,0,4,4
Israel,Japan,1977,2,0,2
Bahrain,Kuwait,1977,0,2,2
Peru,Ecuador,1977,4,0,4
Singapore,Hong Kong,1977,0,1,1
Kenya,Algeria,1977,2,1,3
Cameroon,Congo,1977,2,0,2
Guinea,Libya,1977,3,0,3
Senegal,Togo,1977,2,1,3
Egypt,Tunisia,1977,2,2,4
Ethiopia,Mauritius,1977,1,0,1
Nigeria,Sierra Leone,1977,2,0,2
Australia,Taiwan,1977,3,0,3
Bolivia,Venezuela,1977,2,0,2
Paraguay,Brazil,1977,0,1,1
Qatar,Bahrain,1977,2,0,2
Iran,Hungary,1977,0,2,2
Qatar,Kuwait,1977,0,2,2
Bahrain,Kuwait,1977,1,2,3
Uruguay,Venezuela,1977,2,0,2
Fiji,Australia,1977,1,0,1
Qatar,Bahrain,1977,0,3,3
Brazil,Paraguay,1977,1,1,2
Burkina Faso,Ivory Coast,1977,0,1,1
Chile,Ecuador,1977,3,0,3
South Korea,Israel,1977,3,1,4
New Zealand,Taiwan,1977,6,0,6
Tunisia,Russia,1977,0,3,3
Qatar,Kuwait,1977,1,4,5
Argentina,Iran,1977,1,1,2
Czechoslovakia,Greece,1977,4,0,4
Romania,Turkey,1977,4,0,4
Syria,Morocco,1977,0,2,2
Yugoslavia,Russia,1977,2,4,6
Libya,Guinea,1977,0,2,2
Togo,Senegal,1977,0,1,1
Belgium,Netherlands,1977,0,2,2
Japan,South Korea,1977,0,0,0
Peru,Chile,1977,2,0,2
Zambia,Malawi,1977,8,1,9
Australia,New Zealand,1977,3,1,4
Ivory Coast,Burkina Faso,1977,4,1,5
Spain,Hungary,1977,1,1,2
Uruguay,Bolivia,1977,2,2,4
England,Luxembourg,1977,5,0,5
Republic of Ireland,France,1977,1,0,1
New Zealand,Australia,1977,1,1,2
Portugal,Switzerland,1977,1,0,1
Wales,Czechoslovakia,1977,3,0,3
Malta,German DR,1977,0,1,1
South Korea,Japan,1977,1,0,1
Morocco,Gabon,1977,5,1,6
Turkey,Finland,1977,1,2,3
Guinea-Bissau,Mali,1977,1,3,4
South Africa,Zimbabwe,1977,7,0,7
Bulgaria,Denmark,1977,3,1,4
Hungary,Poland,1977,2,1,3
Martinique,Guadeloupe,1977,1,0,1
Romania,Spain,1977,1,0,1
Austria,Turkey,1977,1,0,1
Hungary,Czechoslovakia,1977,2,0,2
Iran,Saudi Arabia,1977,2,0,2
Switzerland,France,1977,0,4,4
Republic of Ireland,Poland,1977,0,0,0
Russia,Greece,1977,2,0,2
Tunisia,Egypt,1977,3,2,5
Germany,Northern Ireland,1977,5,0,5
Romania,German DR,1977,1,1,2
Scotland,Sweden,1977,3,1,4
Austria,Malta,1977,9,0,9
Hungary,Russia,1977,2,1,3
Yugoslavia,Germany,1977,1,2,3
Algeria,Senegal,1977,2,0,2
Denmark,Poland,1977,1,2,3
Hong Kong,Macau,1977,2,0,2
Yugoslavia,Romania,1977,0,2,2
Greece,Russia,1977,1,0,1
Cyprus,Poland,1977,1,3,4
Mexico,Peru,1977,1,1,2
Russia,Hungary,1977,2,0,2
Mexico,Peru,1977,2,1,3
Switzerland,Czechoslovakia,1977,1,0,1
Haiti,Peru,1977,1,2,3
Luxembourg,Finland,1977,0,1,1
Sweden,Norway,1977,1,0,1
Hungary,Greece,1977,3,0,3
Northern Ireland,England,1977,1,2,3
Senegal,Morocco,1977,3,2,5
Wales,Scotland,1977,0,0,0
Argentina,Poland,1977,3,1,4
Haiti,Peru,1977,2,2,4
Togo,Ghana,1977,0,2,2
Mozambique,Cuba,1977,0,2,2
England,Wales,1977,0,1,1
Bulgaria,Republic of Ireland,1977,2,1,3
Czechoslovakia,Austria,1977,0,0,0
Norway,Denmark,1977,0,2,2
Scotland,Northern Ireland,1977,3,0,3
Libya,Cuba,1977,1,0,1
Northern Ireland,Wales,1977,1,1,2
England,Scotland,1977,1,2,3
Congo,Cameroon,1977,4,0,4
Argentina,Germany,1977,1,3,4
Guinea,Tunisia,1977,1,0,1
Mauritania,Senegal,1977,1,2,3
Honduras,Panama,1977,1,0,1
Brazil,England,1977,0,0,0
Finland,Italy,1977,0,3,3
Sweden,Switzerland,1977,2,1,3
Uruguay,Germany,1977,0,2,2
Algeria,Zambia,1977,2,0,2
Ethiopia,Cuba,1977,0,0,0
Peru,Poland,1977,1,3,4
Iceland,Northern Ireland,1977,1,0,1
Senegal,Nigeria,1977,3,1,4
Ethiopia,Uganda,1977,0,0,0
Argentina,England,1977,1,1,2
Bolivia,Poland,1977,1,2,3
Brazil,Germany,1977,1,1,2
Ghana,Togo,1977,2,0,2
Zambia,Cuba,1977,2,0,2
Mexico,Germany,1977,2,2,4
Chile,Scotland,1977,2,4,6
Denmark,Sweden,1977,2,1,3
South Korea,Japan,1977,2,1,3
Uruguay,England,1977,0,0,0
Zambia,Cuba,1977,0,1,1
Argentina,Scotland,1977,1,1,2
Brazil,Poland,1977,3,1,4
Hong Kong,Iran,1977,0,2,2
Tunisia,Guinea,1977,3,1,4
Finland,Denmark,1977,1,2,3
Brazil,Scotland,1977,2,0,2
Zambia,Algeria,1977,2,0,2
Uganda,Ethiopia,1977,2,1,3
Nigeria,Senegal,1977,3,0,3
Argentina,France,1977,0,0,0
Brazil,Yugoslavia,1977,0,0,0
Hong Kong,South Korea,1977,0,2,2
Brazil,France,1977,2,2,4
Iceland,Norway,1977,2,1,3
Argentina,Yugoslavia,1977,1,0,1
South Korea,Iran,1977,0,0,0
Zimbabwe,South Africa,1977,1,1,2
Malawi,Tanzania,1977,0,0,0
Malawi,Tanzania,1977,1,0,1
Australia,Hong Kong,1977,3,0,3
Nigeria,Ivory Coast,1977,4,0,4
Peru,Brazil,1977,0,1,1
Argentina,German DR,1977,2,0,2
Brazil,Bolivia,1977,8,0,8
Egypt,Zambia,1977,2,0,2
Malaysia,Myanmar,1977,1,0,1
Congo,Gabon,1977,3,2,5
China PR,Hong Kong,1977,2,1,3
South Korea,Libya,1977,4,0,4
Peru,Bolivia,1977,5,0,5
Malaysia,Thailand,1977,3,0,3
China PR,DR Congo,1977,3,2,5
Iraq,Libya,1977,0,0,0
Iceland,Sweden,1977,0,1,1
South Korea,Thailand,1977,4,1,5
Myanmar,Iraq,1977,0,3,3
Malaysia,Libya,1977,1,1,2
Libya,Thailand,1977,2,2,4
Malaysia,Iraq,1977,0,0,0
Afghanistan,India,1977,0,3,3
Myanmar,South Korea,1977,0,4,4
Hong Kong,Iran,1977,1,0,1
Ivory Coast,Nigeria,1977,2,2,4
China PR,Morocco,1977,3,2,5
Iraq,Thailand,1977,5,0,5
Malaysia,South Korea,1977,1,1,2
Myanmar,Libya,1977,3,1,4
China PR,Hong Kong,1977,1,2,3
Iran,Morocco,1977,1,1,2
German DR,Russia,1977,2,1,3
Iraq,South Korea,1977,1,1,2
Myanmar,Thailand,1977,1,1,2
Iran,DR Congo,1977,1,3,4
Gabon,Congo,1977,3,3,6
Iraq,South Korea,1977,0,1,1
Zambia,Egypt,1977,0,0,0
Iran,Romania,1977,0,0,0
Australia,Iran,1977,0,1,1
Czechoslovakia,Romania,1977,1,3,4
Sweden,German DR,1977,0,1,1
Norway,Finland,1977,1,1,2
Argentina,Paraguay,1977,2,1,3
Austria,Poland,1977,2,1,3
Australia,South Korea,1977,2,1,3
Netherlands,Iceland,1977,4,1,5
Paraguay,Argentina,1977,2,0,2
India,Thailand,1977,0,4,4
Belgium,Iceland,1977,4,0,4
South Korea,Thailand,1977,5,1,6
Nigeria,Ghana,1977,2,1,3
South Korea,India,1977,3,0,3
Tunisia,Malta,1977,2,1,3
Wales,Kuwait,1977,0,0,0
Czechoslovakia,Turkey,1977,1,0,1
England,Switzerland,1977,0,0,0
Finland,Germany,1977,0,1,1
German DR,Scotland,1977,1,0,1
Norway,Sweden,1977,2,1,3
Russia,Poland,1977,4,1,5
Bahrain,Malaysia,1977,1,3,4
Trinidad and Tobago,Canada,1977,1,1,2
South Korea,Malaysia,1977,3,0,3
China PR,Thailand,1977,5,2,7
El Salvador,United States,1977,1,2,3
Malaysia,Thailand,1977,1,1,2
Guatemala,United States,1977,3,1,4
Réunion,Mauritius,1977,0,2,2
Suriname,Trinidad and Tobago,1977,2,1,3
Kuwait,Wales,1977,0,0,0
Bulgaria,Turkey,1977,3,1,4
Mauritius,Seychelles,1977,2,1,3
Northern Ireland,Iceland,1977,2,0,2
Poland,Denmark,1977,4,1,5
Romania,Greece,1977,6,1,7
Scotland,Czechoslovakia,1977,3,1,4
Switzerland,Spain,1977,1,2,3
Guyana,Trinidad and Tobago,1977,2,1,3
Austria,German DR,1977,1,1,2
Guyana,Trinidad and Tobago,1977,2,2,4
Libya,Malta,1977,1,0,1
Guatemala,United States,1977,2,0,2
Réunion,Seychelles,1977,1,0,1
Tunisia,Nigeria,1977,0,0,0
Guyana,Trinidad and Tobago,1977,0,2,2
Mexico,United States,1977,3,0,3
Libya,Cyprus,1977,1,0,1
Botswana,Malawi,1977,0,2,2
United States,El Salvador,1977,0,0,0
Botswana,Malawi,1977,1,5,6
Tunisia,Guinea,1977,3,0,3
Hong Kong,Kuwait,1977,1,3,4
Zambia,India,1977,3,1,4
Hungary,Yugoslavia,1977,4,3,7
Netherlands,Russia,1977,0,0,0
Sweden,Denmark,1977,1,0,1
Switzerland,Finland,1977,2,0,2
United States,China PR,1977,1,1,2
Canada,El Salvador,1977,1,2,3
France,Russia,1977,0,0,0
Germany,Italy,1977,2,1,3
Guatemala,Suriname,1977,3,2,5
Nigeria,Egypt,1977,4,0,4
Denmark,Portugal,1977,2,4,6
South Korea,Kuwait,1977,1,0,1
Mexico,Haiti,1977,4,1,5
Zambia,India,1977,3,1,4
United States,China PR,1977,1,0,1
Canada,Suriname,1977,2,1,3
German DR,Austria,1977,1,1,2
Guatemala,Haiti,1977,1,2,3
Hungary,Sweden,1977,3,0,3
Republic of Ireland,Bulgaria,1977,0,0,0
Luxembourg,England,1977,0,2,2
Mexico,El Salvador,1977,3,1,4
Northern Ireland,Netherlands,1977,0,1,1
Wales,Scotland,1977,0,2,2
Italy,Finland,1977,6,1,7
Mexico,Suriname,1977,8,1,9
Guinea,Tunisia,1977,3,2,5
Australia,Kuwait,1977,1,2,3
Canada,Guatemala,1977,2,1,3
El Salvador,Haiti,1977,0,1,1
United States,China PR,1977,2,1,3
Mexico,Guatemala,1977,2,1,3
Canada,Haiti,1977,1,1,2
El Salvador,Suriname,1977,3,2,5
Egypt,Nigeria,1977,3,1,4
Guyana,Barbados,1977,2,0,2
Guyana,Barbados,1977,0,0,0
Mexico,Canada,1977,3,1,4
El Salvador,Guatemala,1977,2,2,4
Haiti,Suriname,1977,1,0,1
Jamaica,China PR,1977,0,1,1
South Korea,Australia,1977,0,0,0
Bulgaria,Greece,1977,0,0,0
Guyana,Barbados,1977,0,0,0
Netherlands,Belgium,1977,1,0,1
Spain,Romania,1977,2,0,2
Iran,Kuwait,1977,1,0,1
Thailand,Singapore,1977,2,0,2
German DR,Malta,1977,9,0,9
Hungary,Bolivia,1977,6,0,6
Poland,Portugal,1977,1,1,2
Hong Kong,Australia,1977,2,5,7
Switzerland,Norway,1977,1,0,1
Turkey,Austria,1977,0,1,1
Jamaica,China PR,1977,0,3,3
Thailand,India,1977,1,1,2
Malaysia,Singapore,1977,4,3,7
India,Singapore,1977,2,1,3
Kuwait,South Korea,1977,2,2,4
Thailand,Malaysia,1977,1,2,3
Czechoslovakia,Hungary,1977,1,1,2
India,Malaysia,1977,0,3,3
Iran,South Korea,1977,2,2,4
Malawi,Lesotho,1977,3,0,3
Kuwait,Hong Kong,1977,4,0,4
Nigeria,Tunisia,1977,0,1,1
Poland,Sweden,1977,2,1,3
Malawi,Lesotho,1977,6,1,7
Romania,Yugoslavia,1977,4,6,10
Singapore,Australia,1977,0,2,2
Czechoslovakia,Wales,1977,1,0,1
England,Italy,1977,2,0,2
France,Bulgaria,1977,3,1,4
Germany,Switzerland,1977,4,1,5
Greece,Yugoslavia,1977,0,0,0
Northern Ireland,Belgium,1977,3,0,3
Portugal,Cyprus,1977,4,0,4
Turkey,German DR,1977,1,2,3
Iran,Hong Kong,1977,3,0,3
Kuwait,Australia,1977,1,0,1
Egypt,Tunisia,1977,3,2,5
Iran,Australia,1977,1,0,1
Uganda,Zanzibar,1977,1,0,1
Iraq,Morocco,1977,3,0,3
Malta,Turkey,1977,0,3,3
Tanzania,Zambia,1977,2,4,6
Kenya,Uganda,1977,1,3,4
Malawi,Zambia,1977,1,0,1
Bolivia,Hungary,1977,2,3,5
Somalia,Zanzibar,1977,1,0,1
Yugoslavia,Spain,1977,0,1,1
Malawi,Tanzania,1977,0,0,0
Kenya,Zanzibar,1977,3,0,3
Italy,Luxembourg,1977,3,0,3
Kuwait,Iran,1977,1,2,3
Morocco,Iraq,1977,0,0,0
South Korea,Hong Kong,1977,5,2,7
Kenya,Zambia,1977,2,4,6
Malawi,Uganda,1977,0,1,1
Kenya,Malawi,1977,1,2,3
Uganda,Zambia,1977,0,0,0
Tunisia,Egypt,1977,4,1,5
Kenya,Malawi,1977,1,1,2
Germany,Wales,1977,1,1,2
Puerto Rico,Martinique,1977,0,2,2
Belgium,Italy,1977,0,1,1
Ghana,Sierra Leone,1977,4,0,4
Cyprus,Greece,1978,0,2,2
Ghana,Gambia,1978,7,1,8
Libya,Morocco,1978,0,1,1
Spain,Italy,1978,2,1,3
Sudan,Kenya,1978,3,0,3
Zambia,Zanzibar,1978,6,1,7
Zambia,Zanzibar,1978,5,0,5
Sudan,Congo,1978,2,1,3
Gabon,Nigeria,1978,0,1,1
Zambia,Eswatini,1978,11,2,13
Israel,Denmark,1978,2,0,2
Italy,France,1978,2,2,4
Benin,Burkina Faso,1978,0,2,2
El Salvador,Mexico,1978,1,5,6
Greece,Austria,1978,1,1,2
Gabon,Burkina Faso,1978,2,2,4
Ghana,Ivory Coast,1978,3,1,4
Iraq,Algeria,1978,3,0,3
Germany,England,1978,2,1,3
Israel,Netherlands,1978,1,2,3
Scotland,Bulgaria,1978,2,1,3
Iraq,Algeria,1978,1,0,1
Burkina Faso,Benin,1978,3,0,3
Morocco,Russia,1978,2,3,5
Syria,Algeria,1978,0,1,1
Iraq,North Korea,1978,1,0,1
Martinique,Antigua and Barbuda,1978,5,0,5
Basque Country,Russia,1978,0,0,0
Ghana,Zambia,1978,2,1,3
Nigeria,Burkina Faso,1978,4,2,6
Congo,Uganda,1978,1,3,4
Morocco,Tunisia,1978,1,1,2
Burkina Faso,Zambia,1978,0,2,2
France,Portugal,1978,2,0,2
German DR,Switzerland,1978,3,1,4
Germany,Russia,1978,1,0,1
Ghana,Nigeria,1978,1,1,2
Congo,Morocco,1978,0,1,1
Tunisia,Uganda,1978,3,1,4
Ghana,Burkina Faso,1978,3,0,3
Nigeria,Zambia,1978,0,0,0
Congo,Tunisia,1978,0,0,0
Morocco,Uganda,1978,0,3,3
Lesotho,Kenya,1978,0,1,1
Libya,Algeria,1978,1,0,1
Ghana,Tunisia,1978,1,0,1
Nigeria,Uganda,1978,1,2,3
Ghana,Uganda,1978,2,0,2
Argentina,Peru,1978,2,1,3
Belgium,Austria,1978,1,0,1
Greece,Czechoslovakia,1978,0,1,1
Luxembourg,Poland,1978,1,3,4
Turkey,Romania,1978,1,1,2
Peru,Argentina,1978,1,3,4
Martinique,Guadeloupe,1978,1,2,3
Argentina,Bulgaria,1978,3,1,4
Spain,Norway,1978,3,0,3
Venezuela,China PR,1978,0,1,1
France,Brazil,1978,1,0,1
Peru,Bulgaria,1978,1,1,2
German DR,Sweden,1978,0,1,1
Switzerland,Austria,1978,0,1,1
Argentina,Romania,1978,2,0,2
Germany,Brazil,1978,0,1,1
Iran,Yugoslavia,1978,0,0,0
Republic of Ireland,Turkey,1978,4,2,6
Poland,Greece,1978,5,2,7
Russia,Finland,1978,10,2,12
Tunisia,Netherlands,1978,0,4,4
Mexico,Peru,1978,0,1,1
Poland,Republic of Ireland,1978,3,0,3
Hungary,Czechoslovakia,1978,2,1,3
Martinique,Puerto Rico,1978,3,1,4
Iran,Wales,1978,0,1,1
England,Brazil,1978,1,1,2
German DR,Belgium,1978,0,0,0
Sweden,Germany,1978,3,1,4
Puerto Rico,Martinique,1978,4,1,5
Peru,China PR,1978,2,1,3
Czechoslovakia,Bulgaria,1978,0,0,0
Uruguay,Argentina,1978,2,0,2
Iran,Bulgaria,1978,1,1,2
Malaysia,Singapore,1978,0,1,1
Poland,Bulgaria,1978,1,0,1
Spain,Mexico,1978,2,0,2
Kenya,Lesotho,1978,1,0,1
Barbados,Guyana,1978,1,0,1
Brazil,Peru,1978,3,0,3
Argentina,Uruguay,1978,3,0,3
Barbados,Guyana,1978,3,0,3
Finland,Mexico,1978,0,1,1
Romania,Bulgaria,1978,2,0,2
Thailand,Singapore,1978,2,2,4
Trinidad and Tobago,Guyana,1978,3,0,3
France,Iran,1978,2,1,3
Trinidad and Tobago,Guyana,1978,5,1,6
Réunion,Seychelles,1978,4,1,5
Scotland,Northern Ireland,1978,1,1,2
Wales,England,1978,1,3,4
Libya,Malta,1978,1,0,1
Romania,Russia,1978,0,1,1
Mauritius,Seychelles,1978,2,0,2
England,Northern Ireland,1978,1,0,1
Brazil,Czechoslovakia,1978,2,0,2
Scotland,Wales,1978,1,1,2
Italy,Yugoslavia,1978,0,0,0
Réunion,Mauritius,1978,5,3,8
France,Tunisia,1978,2,0,2
Iran,Ghana,1978,3,0,3
Wales,Northern Ireland,1978,1,0,1
Austria,Netherlands,1978,0,1,1
Scotland,England,1978,0,1,1
Norway,Republic of Ireland,1978,0,0,0
Sweden,Czechoslovakia,1978,0,0,0
Japan,Thailand,1978,3,0,3
Denmark,Republic of Ireland,1978,3,3,6
England,Hungary,1978,4,1,5
Finland,Greece,1978,3,0,3
Uruguay,Spain,1978,0,0,0
Bulgaria,Romania,1978,1,1,2
Norway,Denmark,1978,1,2,3
Germany,Poland,1978,0,0,0
Argentina,Hungary,1978,2,1,3
France,Italy,1978,1,2,3
Mexico,Tunisia,1978,1,3,4
Austria,Spain,1978,2,1,3
Brazil,Sweden,1978,1,1,2
Iran,Netherlands,1978,0,3,3
Peru,Scotland,1978,3,1,4
Argentina,France,1978,2,1,3
Germany,Mexico,1978,6,0,6
Hungary,Italy,1978,1,3,4
Poland,Tunisia,1978,1,0,1
Austria,Sweden,1978,1,0,1
Brazil,Spain,1978,0,0,0
Iran,Scotland,1978,1,1,2
Netherlands,Peru,1978,0,0,0
Argentina,Italy,1978,0,1,1
France,Hungary,1978,3,1,4
Germany,Tunisia,1978,0,0,0
Mexico,Poland,1978,1,3,4
Australia,Greece,1978,1,2,3
Austria,Brazil,1978,0,1,1
Iran,Peru,1978,1,4,5
Macau,Hong Kong,1978,0,4,4
Netherlands,Scotland,1978,2,3,5
Spain,Sweden,1978,1,0,1
Indonesia,Malaysia,1978,3,0,3
Argentina,Poland,1978,2,0,2
Australia,Greece,1978,0,1,1
Austria,Netherlands,1978,1,5,6
Brazil,Peru,1978,3,0,3
Germany,Italy,1978,0,0,0
Indonesia,Thailand,1978,1,0,1
Malaysia,Singapore,1978,1,1,2
Singapore,Thailand,1978,1,3,4
Argentina,Brazil,1978,0,0,0
Austria,Italy,1978,0,1,1
Germany,Netherlands,1978,2,2,4
Malawi,Zambia,1978,1,2,3
Peru,Poland,1978,0,1,1
Argentina,Peru,1978,6,0,6
Austria,Germany,1978,3,2,5
Brazil,Poland,1978,3,1,4
Indonesia,Singapore,1978,2,2,4
Italy,Netherlands,1978,1,2,3
Malaysia,Thailand,1978,1,1,2
Indonesia,South Korea,1978,1,3,4
Malaysia,Thailand,1978,3,3,6
Brazil,Italy,1978,2,1,3
Argentina,Netherlands,1978,3,1,4
Barbados,Curaçao,1978,0,0,0
Zambia,Malawi,1978,0,0,0
Iceland,Denmark,1978,0,0,0
Sweden,Finland,1978,2,1,3
Algeria,Iraq,1978,1,1,2
Guadeloupe,Jamaica,1978,1,0,1
Algeria,Iraq,1978,0,0,0
Malawi,Sierra Leone,1978,5,0,5
Guyana,Suriname,1978,0,2,2
Malawi,Sierra Leone,1978,4,2,6
Malaysia,South Korea,1978,1,3,4
Indonesia,Syria,1978,1,0,1
Iraq,Japan,1978,0,0,0
Malaysia,Singapore,1978,6,0,6
South Korea,Thailand,1978,3,0,3
Indonesia,Japan,1978,2,1,3
Iraq,Syria,1978,2,1,3
Malaysia,Thailand,1978,2,0,2
South Korea,Singapore,1978,2,0,2
Malaysia,Indonesia,1978,1,0,1
Indonesia,Iraq,1978,0,4,4
Japan,Syria,1978,3,2,5
Malaysia,Iraq,1978,1,2,3
Singapore,Thailand,1978,1,2,3
Japan,South Korea,1978,0,4,4
Iraq,Singapore,1978,3,0,3
Syria,Thailand,1978,1,3,4
Malaysia,Japan,1978,4,1,5
Indonesia,Thailand,1978,0,3,3
Iraq,South Korea,1978,0,2,2
Japan,Singapore,1978,1,2,3
Malaysia,Syria,1978,5,2,7
Iraq,Thailand,1978,1,0,1
Indonesia,South Korea,1978,0,2,2
Singapore,Syria,1978,4,1,5
Japan,Thailand,1978,4,0,4
Indonesia,Singapore,1978,0,0,0
South Korea,Syria,1978,2,0,2
Curaçao,Barbados,1978,1,0,1
Iraq,South Korea,1978,0,2,2
Grenada,Trinidad and Tobago,1978,1,1,2
Jamaica,Guadeloupe,1978,1,2,3
Suriname,Guyana,1978,2,1,3
Vanuatu,Tahiti,1978,2,4,6
Finland,Norway,1978,1,1,2
New Caledonia,Tahiti,1978,2,0,2
Denmark,Sweden,1978,2,1,3
São Tomé and Príncipe,Angola,1978,3,3,6
New Caledonia,Tahiti,1978,3,4,7
Puerto Rico,Haiti,1978,1,1,2
Trinidad and Tobago,French Guiana,1978,2,4,6
Haiti,Puerto Rico,1978,1,0,1
Finland,Poland,1978,0,1,1
German DR,Bulgaria,1978,2,2,4
Norway,Austria,1978,0,2,2
France,Sweden,1978,2,2,4
French Guiana,Trinidad and Tobago,1978,1,4,5
China PR,Congo,1978,1,0,1
Iceland,United States,1978,0,0,0
German DR,Czechoslovakia,1978,2,1,3
Iceland,Poland,1978,0,2,2
Iran,Russia,1978,0,1,1
Eswatini,Zambia,1978,1,6,7
Switzerland,United States,1978,2,0,2
Eswatini,Zambia,1978,2,5,7
Bahrain,Malaysia,1978,1,2,3
French Guiana,Martinique,1978,4,2,6
Indonesia,Thailand,1978,0,2,2
Lebanon,Mexico,1978,1,7,8
South Korea,Malaysia,1978,2,2,4
South Korea,Bahrain,1978,3,1,4
Haiti,Martinique,1978,0,0,0
Seychelles,Réunion,1978,1,0,1
Austria,Scotland,1978,3,2,5
Belgium,Norway,1978,1,1,2
Denmark,England,1978,3,4,7
Finland,Hungary,1978,2,1,3
Republic of Ireland,Northern Ireland,1978,0,0,0
Italy,Bulgaria,1978,1,0,1
Libya,Yemen DPR,1978,2,0,2
Netherlands,Iceland,1978,3,0,3
Portugal,United States,1978,1,0,1
Russia,Greece,1978,2,0,2
Italy,Turkey,1978,1,0,1
Réunion,Mauritius,1978,0,2,2
Botswana,Mozambique,1978,1,4,5
Curaçao,Suriname,1978,0,2,2
Botswana,Mozambique,1978,0,2,2
Martinique,Haiti,1978,0,0,0
Singapore,New Zealand,1978,0,2,2
German DR,Iceland,1978,3,1,4
Sweden,Czechoslovakia,1978,1,3,4
Yugoslavia,Spain,1978,1,2,3
Turkey,Russia,1978,0,2,2
Luxembourg,France,1978,1,3,4
Czechoslovakia,Germany,1978,3,4,7
Denmark,Bulgaria,1978,2,2,4
Greece,Finland,1978,8,1,9
Hungary,Russia,1978,2,0,2
Portugal,Belgium,1978,1,1,2
Romania,Poland,1978,1,0,1
Switzerland,Netherlands,1978,1,3,4
Suriname,Curaçao,1978,3,0,3
Tanzania,Kenya,1978,1,0,1
Kenya,Tanzania,1978,0,0,0
Haiti,Suriname,1978,0,3,3
Malawi,Algeria,1978,1,1,2
Trinidad and Tobago,Antigua and Barbuda,1978,3,1,4
Malawi,Algeria,1978,2,1,3
Republic of Ireland,England,1978,1,1,2
Northern Ireland,Denmark,1978,2,1,3
Romania,Yugoslavia,1978,3,2,5
Scotland,Norway,1978,3,2,5
Trinidad and Tobago,Suriname,1978,0,1,1
Wales,Malta,1978,7,0,7
Antigua and Barbuda,Haiti,1978,0,1,1
Antigua and Barbuda,Suriname,1978,0,4,4
Zambia,Algeria,1978,0,3,3
Greece,Hungary,1978,4,1,5
Trinidad and Tobago,Haiti,1978,2,2,4
Malawi,Kenya,1978,1,0,1
Malawi,Somalia,1978,3,1,4
Malawi,Uganda,1978,0,2,2
Uganda,Zambia,1978,1,2,3
Czechoslovakia,Italy,1978,3,0,3
France,Spain,1978,1,0,1
Kenya,Uganda,1978,0,1,1
Somalia,Zambia,1978,0,4,4
Burkina Faso,Mali,1978,3,1,4
Kenya,Somalia,1978,1,0,1
Malawi,Zambia,1978,2,1,3
Kenya,Zambia,1978,0,9,9
Somalia,Uganda,1978,2,2,4
Austria,Portugal,1978,1,2,3
Germany,Hungary,1978,0,0,0
Israel,Belgium,1978,1,0,1
Netherlands,German DR,1978,3,0,3
Poland,Switzerland,1978,2,0,2
Spain,Romania,1978,1,0,1
Yugoslavia,Greece,1978,4,1,5
Algeria,Congo,1978,3,0,3
Malawi,Kenya,1978,2,0,2
Uganda,Zambia,1978,0,4,4
Japan,Russia,1978,1,4,5
Kenya,Uganda,1978,2,0,2
Malawi,Zambia,1978,3,2,5
Japan,Russia,1978,1,4,5
Grenada,Barbados,1978,2,0,2
Grenada,Barbados,1978,0,0,0
Japan,Russia,1978,0,3,3
Bulgaria,Northern Ireland,1978,0,2,2
England,Czechoslovakia,1978,1,0,1
Portugal,Scotland,1978,1,0,1
Wales,Turkey,1978,1,0,1
Madagascar,Malawi,1978,2,1,3
Mauritius,Lesotho,1978,0,1,1
Antigua and Barbuda,Martinique,1978,0,2,2
Greece,Romania,1978,2,1,3
Spain,Cyprus,1978,5,0,5
Lesotho,Mauritius,1978,1,2,3
Malawi,Madagascar,1978,5,1,6
Israel,Romania,1978,1,1,2
Syria,Tunisia,1978,2,1,3
Germany,Netherlands,1978,3,1,4
Italy,Spain,1978,1,0,1
South Korea,Macau,1978,4,1,5
Philippines,China PR,1978,0,3,3
China PR,Macau,1978,2,1,3
Philippines,South Korea,1978,0,5,5
South Korea,China PR,1978,1,0,1
Guinea-Bissau,Cape Verde,1979,3,0,3
Gambia,Mauritania,1979,3,1,4
Guinea,Mali,1979,0,1,1
Cape Verde,Senegal,1979,0,1,1
Gambia,Mali,1979,0,1,1
Guinea,Mauritania,1979,4,1,5
Rwanda,Gabon,1979,2,2,4
Guinea-Bissau,Senegal,1979,0,2,2
Gambia,Guinea,1979,1,1,2
Mali,Mauritania,1979,4,2,6
Guinea,Senegal,1979,1,3,4
Guinea-Bissau,Mali,1979,1,1,2
Guinea-Bissau,Guinea,1979,2,2,4
Mali,Senegal,1979,0,1,1
Cyprus,Bulgaria,1979,0,1,1
Ivory Coast,Togo,1979,0,1,1
Liberia,Guinea,1979,2,1,3
Gambia,Ivory Coast,1979,2,1,3
Guinea,Senegal,1979,1,1,2
Israel,Austria,1979,0,1,1
Gambia,Togo,1979,2,2,4
Liberia,Senegal,1979,1,1,2
Senegal,Togo,1979,0,1,1
Liberia,Gambia,1979,1,0,1
Iraq,Finland,1979,1,0,1
England,Northern Ireland,1979,4,0,4
Iraq,Finland,1979,2,0,2
Libya,Greece,1979,2,2,4
Bahrain,Finland,1979,0,1,1
Iraq,German DR,1979,1,1,2
Iraq,German DR,1979,2,1,3
Israel,Greece,1979,4,1,5
Libya,Poland,1979,1,0,1
Tunisia,Poland,1979,0,2,2
Mauritania,Morocco,1979,2,2,4
Italy,Netherlands,1979,3,0,3
France,Luxembourg,1979,3,0,3
Malta,Germany,1979,0,0,0
Bulgaria,German DR,1979,1,0,1
Turkey,Algeria,1979,0,1,1
Barbados,Trinidad and Tobago,1979,2,2,4
Japan,South Korea,1979,2,1,3
Bangladesh,Afghanistan,1979,3,2,5
Bangladesh,Qatar,1979,1,3,4
Senegal,Mali,1979,2,1,3
Czechoslovakia,Spain,1979,1,0,1
Martinique,Trinidad and Tobago,1979,0,0,0
Turkey,Malta,1979,2,1,3
Romania,Greece,1979,3,0,3
Iraq,Bahrain,1979,4,0,4
Kuwait,Qatar,1979,3,1,4
Saudi Arabia,United Arab Emirates,1979,2,1,3
Mali,Senegal,1979,2,1,3
Iraq,Qatar,1979,2,0,2
Bahrain,United Arab Emirates,1979,3,0,3
Belgium,Austria,1979,1,1,2
Hungary,German DR,1979,3,0,3
Netherlands,Switzerland,1979,3,0,3
Russia,Bulgaria,1979,3,1,4
Saudi Arabia,Oman,1979,4,0,4
Qatar,United Arab Emirates,1979,1,0,1
Bahrain,Oman,1979,3,1,4
Iraq,Kuwait,1979,3,1,4
Cyprus,Yugoslavia,1979,0,3,3
Oman,Qatar,1979,0,1,1
Turkey,Germany,1979,0,0,0
Kuwait,United Arab Emirates,1979,7,0,7
Saudi Arabia,Bahrain,1979,1,1,2
Barbados,Martinique,1979,1,2,3
Kuwait,Oman,1979,2,0,2
Czechoslovakia,France,1979,2,0,2
Poland,Hungary,1979,1,1,2
Romania,Spain,1979,2,2,4
Saudi Arabia,Qatar,1979,7,0,7
Iraq,United Arab Emirates,1979,5,0,5
Iraq,Oman,1979,7,0,7
Kuwait,Saudi Arabia,1979,0,0,0
Bahrain,Qatar,1979,1,1,2
Gabon,Ivory Coast,1979,2,1,3
Iraq,Saudi Arabia,1979,2,0,2
Morocco,Mauritania,1979,4,1,5
Bahrain,Kuwait,1979,0,2,2
Oman,United Arab Emirates,1979,0,4,4
Benin,Ivory Coast,1979,1,0,1
Congo,DR Congo,1979,4,2,6
Guadeloupe,Martinique,1979,0,1,1
Malawi,Zambia,1979,0,2,2
Guinea,Cameroon,1979,3,0,3
Libya,Ethiopia,1979,2,1,3
Togo,Gambia,1979,2,0,2
Mauritius,Tanzania,1979,3,2,5
German DR,Poland,1979,2,1,3
Russia,Sweden,1979,2,0,2
Argentina,Bulgaria,1979,2,1,3
São Tomé and Príncipe,Angola,1979,1,2,3
DR Congo,Congo,1979,4,1,5
Gambia,Togo,1979,1,0,1
Tanzania,Mauritius,1979,4,0,4
Ivory Coast,Benin,1979,4,1,5
Ethiopia,Libya,1979,1,1,2
Cameroon,Guinea,1979,3,0,3
Madagascar,Kenya,1979,4,0,4
Zambia,Malawi,1979,2,0,2
Luxembourg,Czechoslovakia,1979,0,3,3
Austria,Belgium,1979,0,0,0
Hungary,Greece,1979,0,0,0
Republic of Ireland,Denmark,1979,2,0,2
North Korea,Hong Kong,1979,3,0,3
Northern Ireland,Bulgaria,1979,2,0,2
Poland,Netherlands,1979,2,0,2
United States,France,1979,0,6,6
Wales,Germany,1979,0,2,2
Russia,Czechoslovakia,1979,3,0,3
Saint Vincent and the Grenadines,Martinique,1979,2,2,4
Switzerland,German DR,1979,0,2,2
North Korea,Indonesia,1979,3,1,4
Denmark,Sweden,1979,2,2,4
Malaysia,North Korea,1979,1,1,2
Norway,Portugal,1979,0,1,1
Malaysia,Hong Kong,1979,0,0,0
Thailand,North Korea,1979,0,1,1
Cyprus,Romania,1979,1,1,2
North Korea,Malaysia,1979,1,0,1
Brazil,Paraguay,1979,6,0,6
Bulgaria,Republic of Ireland,1979,1,0,1
Mozambique,Zimbabwe,1979,0,6,6
Northern Ireland,England,1979,0,2,2
Russia,Hungary,1979,2,2,4
Wales,Scotland,1979,3,0,3
Argentina,Netherlands,1979,0,0,0
Republic of Ireland,Germany,1979,1,3,4
Scotland,Northern Ireland,1979,1,0,1
Switzerland,Iceland,1979,2,0,2
England,Wales,1979,0,0,0
Martinique,Trinidad and Tobago,1979,3,1,4
England,Scotland,1979,3,1,4
Iceland,Germany,1979,1,3,4
Italy,Argentina,1979,2,2,4
Northern Ireland,Wales,1979,1,1,2
Republic of Ireland,Argentina,1979,0,0,0
Brazil,Uruguay,1979,5,1,6
Japan,Indonesia,1979,4,0,4
German DR,Romania,1979,1,0,1
Malta,Wales,1979,0,2,2
Scotland,Argentina,1979,1,3,4
Benin,Togo,1979,0,1,1
Jamaica,Saint Kitts and Nevis,1979,2,1,3
Bulgaria,England,1979,0,3,3
Denmark,Northern Ireland,1979,4,0,4
Norway,Scotland,1979,0,4,4
Sweden,Luxembourg,1979,3,0,3
Iceland,Switzerland,1979,1,2,3
Martinique,Saint Vincent and the Grenadines,1979,0,1,1
Sweden,England,1979,0,0,0
Austria,England,1979,4,3,7
Chile,Ecuador,1979,0,0,0
New Zealand,Australia,1979,1,0,1
Yugoslavia,Italy,1979,4,1,5
South Korea,Japan,1979,4,1,5
Saint Kitts and Nevis,Jamaica,1979,1,2,3
Ecuador,Chile,1979,2,1,3
Ghana,Liberia,1979,0,0,0
Malawi,Lesotho,1979,1,0,1
Zambia,DR Congo,1979,4,1,5
Algeria,Libya,1979,3,1,4
Morocco,Togo,1979,7,0,7
Malawi,Lesotho,1979,1,2,3
Denmark,Russia,1979,1,2,3
Sweden,Norway,1979,2,0,2
Malaysia,Japan,1979,1,1,2
Fiji,New Zealand,1979,0,6,6
Japan,Thailand,1979,2,0,2
Malaysia,Myanmar,1979,4,1,5
Sudan,Ivory Coast,1979,2,0,2
Kenya,Egypt,1979,3,1,4
DR Congo,Zambia,1979,1,2,3
Indonesia,Singapore,1979,0,0,0
Malaysia,Thailand,1979,4,2,6
Myanmar,Japan,1979,0,1,1
Fiji,New Zealand,1979,0,3,3
Myanmar,Thailand,1979,2,0,2
Malaysia,Indonesia,1979,1,1,2
Finland,Russia,1979,1,1,2
Singapore,Thailand,1979,1,1,2
Ivory Coast,Sudan,1979,4,0,4
Togo,Morocco,1979,2,1,3
Malawi,Kenya,1979,1,0,1
Libya,Algeria,1979,1,0,1
DR Congo,Togo,1979,4,1,5
Indonesia,Thailand,1979,2,1,3
Malawi,Kenya,1979,0,0,0
Malaysia,Singapore,1979,3,0,3
Bolivia,Paraguay,1979,3,1,4
Myanmar,Singapore,1979,4,1,5
Chile,Uruguay,1979,1,0,1
Indonesia,Japan,1979,0,0,0
Peru,Ecuador,1979,2,1,3
Bolivia,Paraguay,1979,1,1,2
Myanmar,Indonesia,1979,4,0,4
Japan,Singapore,1979,3,1,4
Egypt,Kenya,1979,3,0,3
Kenya,DR Congo,1979,2,2,4
Malawi,Tanzania,1979,2,0,2
Malawi,Tanzania,1979,2,0,2
Bolivia,Argentina,1979,2,1,3
Peru,Colombia,1979,0,1,1
Uruguay,Chile,1979,2,1,3
Malawi,Tanzania,1979,0,1,1
Kyrgyzstan,Lithuania,1979,0,0,0
Belarus,Armenia,1979,3,0,3
Georgia,Lithuania,1979,5,0,5
Grenada,Trinidad and Tobago,1979,0,1,1
Belarus,Latvia,1979,2,1,3
Azerbaijan,Lithuania,1979,0,1,1
Belarus,Russia,1979,2,3,5
Benin,DR Congo,1979,0,1,1
Colombia,Peru,1979,1,2,3
Bolivia,Brazil,1979,2,1,3
Liberia,Ghana,1979,3,1,4
Benin,DR Congo,1979,0,3,3
Lithuania,Ukraine,1979,0,2,2
Russia,Belarus,1979,0,0,0
Madagascar,Tanzania,1979,2,4,6
Belarus,Ukraine,1979,0,0,0
Russia,Lithuania,1979,2,0,2
Belarus,Lithuania,1979,0,2,2
Madagascar,Tanzania,1979,1,0,1
Paraguay,Bolivia,1979,2,0,2
Venezuela,Colombia,1979,0,0,0
Brazil,Argentina,1979,2,1,3
Belarus,Kazakhstan,1979,0,1,1
Trinidad and Tobago,Grenada,1979,2,1,3
DR Congo,Guinea,1979,3,2,5
Russia,Lithuania,1979,2,1,3
Argentina,Bolivia,1979,3,0,3
Ecuador,Peru,1979,2,1,3
Venezuela,Chile,1979,1,1,2
Tanzania,Zambia,1979,1,0,1
Colombia,Chile,1979,1,0,1
Norway,Sweden,1979,2,0,2
Brazil,Bolivia,1979,2,0,2
Guinea,DR Congo,1979,3,1,4
Poland,Libya,1979,5,0,5
Colombia,Venezuela,1979,4,0,4
Argentina,Brazil,1979,2,2,4
North Korea,Japan,1979,0,0,0
Lesotho,Malawi,1979,0,3,3
Zambia,Tanzania,1979,1,1,2
Tunisia,Malta,1979,4,0,4
Austria,Norway,1979,4,0,4
Chile,Venezuela,1979,7,0,7
Ecuador,Paraguay,1979,1,2,3
Finland,Denmark,1979,0,0,0
Guam,Vanuatu,1979,0,4,4
Poland,Romania,1979,3,0,3
Solomon Islands,Wallis Islands and Futuna,1979,6,0,6
Tahiti,Tonga,1979,8,0,8
Fiji,Papua New Guinea,1979,0,0,0
Fiji,Kiribati,1979,24,0,24
Guam,New Caledonia,1979,1,10,11
Peru,Uruguay,1979,2,0,2
Tahiti,Tuvalu,1979,18,0,18
Kiribati,Papua New Guinea,1979,0,13,13
Solomon Islands,Samoa,1979,12,0,12
New Caledonia,Vanuatu,1979,3,0,3
Tonga,Tuvalu,1979,3,5,8
Wallis Islands and Futuna,Samoa,1979,3,1,4
Fiji,Wallis Islands and Futuna,1979,5,0,5
Libya,Palestine,1979,0,0,0
New Caledonia,Tuvalu,1979,11,0,11
Papua New Guinea,Solomon Islands,1979,2,3,5
Tahiti,Vanuatu,1979,1,0,1
New Caledonia,Tahiti,1979,2,3,5
Fiji,Solomon Islands,1979,2,0,2
Chile,Colombia,1979,2,0,2
Ecuador,Uruguay,1979,2,1,3
Guam,Samoa,1979,4,2,6
Iceland,Netherlands,1979,0,4,4
Kiribati,Tuvalu,1979,3,3,6
Russia,German DR,1979,1,0,1
Sweden,France,1979,1,3,4
Tonga,Wallis Islands and Futuna,1979,1,0,1
Vanuatu,Papua New Guinea,1979,2,0,2
Guam,Tuvalu,1979,7,2,9
Vanuatu,Tonga,1979,7,1,8
New Caledonia,Solomon Islands,1979,1,3,4
Fiji,Tahiti,1979,0,3,3
South Korea,Sudan,1979,8,0,8
Indonesia,Thailand,1979,0,2,2
Bangladesh,Sudan,1979,1,4,5
Wales,Republic of Ireland,1979,2,1,3
England,Denmark,1979,1,0,1
Germany,Argentina,1979,2,1,3
Greece,Russia,1979,1,0,1
Hungary,Czechoslovakia,1979,2,1,3
Iceland,German DR,1979,0,3,3
South Korea,Sri Lanka,1979,6,0,6
Norway,Belgium,1979,1,2,3
Scotland,Peru,1979,1,1,2
Switzerland,Poland,1979,0,2,2
Paraguay,Ecuador,1979,2,0,2
South Korea,Bahrain,1979,5,1,6
South Korea,Bangladesh,1979,9,0,9
Sri Lanka,Sudan,1979,0,1,1
Uruguay,Ecuador,1979,2,1,3
Yugoslavia,Argentina,1979,4,2,6
Paraguay,Uruguay,1979,0,0,0
Austria,Hungary,1979,3,1,4
Czechoslovakia,Republic of Ireland,1979,4,1,5
Denmark,Finland,1979,1,0,1
Italy,Sweden,1979,1,0,1
Netherlands,Belgium,1979,1,0,1
Poland,German DR,1979,1,1,2
Spain,Portugal,1979,1,1,2
Uruguay,Paraguay,1979,2,2,4
Haiti,Antigua and Barbuda,1979,1,0,1
Senegal,Nigeria,1979,0,2,2
Sierra Leone,Gambia,1979,2,0,2
Bahrain,New Zealand,1979,0,2,2
Bermuda,United States,1979,1,3,4
Bahrain,New Zealand,1979,1,2,3
Czechoslovakia,Sweden,1979,4,1,5
France,United States,1979,3,0,3
Peru,Paraguay,1979,2,3,5
Poland,Iceland,1979,2,0,2
Spain,Yugoslavia,1979,0,1,1
German DR,Switzerland,1979,5,2,7
Benin,Nigeria,1979,1,1,2
Russia,Romania,1979,3,1,4
Antigua and Barbuda,Haiti,1979,1,2,3
Belgium,Portugal,1979,2,0,2
Germany,Wales,1979,5,1,6
Hungary,Finland,1979,3,1,4
Republic of Ireland,Bulgaria,1979,3,0,3
Netherlands,Poland,1979,1,1,2
Northern Ireland,England,1979,1,5,6
Peru,Chile,1979,1,2,3
Scotland,Austria,1979,1,1,2
Benin,Burkina Faso,1979,3,2,5
Ivory Coast,Togo,1979,3,0,3
United Arab Emirates,India,1979,0,0,0
Guadeloupe,Saint Vincent and the Grenadines,1979,1,3,4
Saint Vincent and the Grenadines,Guadeloupe,1979,0,0,0
Luxembourg,Sweden,1979,1,1,2
Togo,Burkina Faso,1979,5,3,8
Chile,Peru,1979,0,0,0
Paraguay,Brazil,1979,2,1,3
Liberia,Nigeria,1979,2,2,4
Hungary,United States,1979,0,2,2
Ivory Coast,Benin,1979,3,1,4
Niger,Togo,1979,2,2,4
Sierra Leone,Nigeria,1979,0,0,0
Benin,Niger,1979,0,1,1
Haiti,Jamaica,1979,3,0,3
Ivory Coast,Togo,1979,0,1,1
Malta,Turkey,1979,1,2,3
Republic of Ireland,United States,1979,3,2,5
Brazil,Paraguay,1979,2,2,4
Bulgaria,Denmark,1979,3,0,3
Russia,Finland,1979,2,2,4
Yugoslavia,Romania,1979,2,1,3
Mexico,Peru,1979,1,0,1
Portugal,Norway,1979,3,1,4
Jamaica,Haiti,1979,0,4,4
Kenya,Tanzania,1979,0,0,0
Sierra Leone,Senegal,1979,1,0,1
Malawi,Zanzibar,1979,4,0,4
Nigeria,Benin,1979,5,0,5
Uganda,Zambia,1979,1,2,3
Tanzania,Zambia,1979,2,2,4
Kenya,Uganda,1979,3,1,4
Malawi,Sudan,1979,4,0,4
Sudan,Zanzibar,1979,1,1,2
Tanzania,Uganda,1979,5,3,8
Kenya,Zambia,1979,3,1,4
Haiti,Trinidad and Tobago,1979,1,0,1
Suriname,Saint Vincent and the Grenadines,1979,2,3,5
Malawi,Tanzania,1979,1,1,2
Haiti,Saint Vincent and the Grenadines,1979,3,1,4
Kenya,Zanzibar,1979,2,0,2
Malawi,Tanzania,1979,4,0,4
Malaysia,Sweden,1979,1,3,4
Spain,Denmark,1979,1,3,4
Yugoslavia,Cyprus,1979,5,0,5
Suriname,Trinidad and Tobago,1979,3,0,3
Tanzania,Zanzibar,1979,2,1,3
France,Czechoslovakia,1979,2,1,3
Italy,Switzerland,1979,2,0,2
Kenya,Malawi,1979,2,3,5
Singapore,Sweden,1979,0,5,5
Romania,Cyprus,1979,2,0,2
Suriname,Haiti,1979,0,1,1
Belgium,Scotland,1979,2,0,2
German DR,Netherlands,1979,2,3,5
Malaysia,Taiwan,1979,0,3,3
Northern Ireland,Republic of Ireland,1979,1,0,1
Portugal,Austria,1979,1,2,3
Russia,Germany,1979,1,3,4
Turkey,Wales,1979,1,0,1
England,Bulgaria,1979,2,0,2
Thailand,Sri Lanka,1979,5,1,6
Czechoslovakia,Luxembourg,1979,4,0,4
Thailand,Indonesia,1979,3,0,3
Angola,Gabon,1979,1,0,1
Bermuda,Finland,1979,0,2,2
Indonesia,Sri Lanka,1979,0,0,0
Angola,Cameroon,1979,0,1,1
Cameroon,Congo,1979,1,3,4
Paraguay,Chile,1979,3,0,3
Angola,Congo,1979,0,1,1
Cameroon,Gabon,1979,3,1,4
El Salvador,Mexico,1979,0,2,2
Chile,Paraguay,1979,1,0,1
Cyprus,Spain,1979,1,3,4
Chile,Paraguay,1979,0,0,0
Mexico,El Salvador,1979,1,1,2
Scotland,Belgium,1979,1,3,4
Germany,Turkey,1979,2,0,2
Basque Country,Bulgaria,1979,4,0,4
Tunisia,Senegal,1979,3,1,4
Sierra Leone,Ghana,1980,2,4,6
Cyprus,Greece,1980,1,1,2
Congo,Ivory Coast,1980,2,0,2
Congo,Ivory Coast,1980,0,2,2
Spain,Netherlands,1980,1,0,1
Nigeria,Liberia,1980,1,0,1
Australia,Czechoslovakia,1980,0,4,4
Cameroon,Ivory Coast,1980,1,1,2
Ghana,Tunisia,1980,4,1,5
Ivory Coast,Tunisia,1980,1,1,2
Saudi Arabia,South Korea,1980,1,3,4
Congo,Gabon,1980,3,0,3
Saudi Arabia,South Korea,1980,0,0,0
Nigeria,Cameroon,1980,0,0,0
Australia,Czechoslovakia,1980,0,5,5
England,Republic of Ireland,1980,2,0,2
Australia,Czechoslovakia,1980,2,2,4
Gambia,Guinea-Bissau,1980,2,0,2
Mali,Senegal,1980,1,0,1
Guinea-Bissau,Guinea,1980,1,2,3
Ivory Coast,Morocco,1980,4,4,8
Mali,Mauritania,1980,0,1,1
Gambia,Guinea,1980,0,0,0
Spain,German DR,1980,0,1,1
Mauritania,Senegal,1980,1,2,3
Gambia,Mauritania,1980,2,2,4
Guinea,Senegal,1980,1,2,3
Italy,Romania,1980,2,1,3
Guinea-Bissau,Mali,1980,2,4,6
Morocco,Poland,1980,1,0,1
Gambia,Senegal,1980,0,1,1
Fiji,New Zealand,1980,1,1,2
Fiji,New Zealand,1980,0,2,2
New Caledonia,Australia,1980,0,8,8
Vanuatu,Papua New Guinea,1980,3,4,7
Fiji,Solomon Islands,1980,3,1,4
Morocco,Senegal,1980,3,2,5
New Zealand,Tahiti,1980,1,3,4
Australia,Papua New Guinea,1980,11,2,13
Mexico,South Korea,1980,0,1,1
New Caledonia,Vanuatu,1980,4,3,7
Belgium,Luxembourg,1980,5,0,5
Fiji,New Zealand,1980,4,0,4
France,Greece,1980,5,1,6
Germany,Malta,1980,8,0,8
Iraq,Poland,1980,1,1,2
Morocco,Tunisia,1980,0,0,0
Solomon Islands,Tahiti,1980,1,12,13
Australia,Vanuatu,1980,1,0,1
New Caledonia,Papua New Guinea,1980,8,0,8
Fiji,Tahiti,1980,3,6,9
Iraq,Poland,1980,1,0,1
New Zealand,Solomon Islands,1980,6,1,7
Australia,Tahiti,1980,4,2,6
New Caledonia,Fiji,1980,2,1,3
Sierra Leone,Guinea,1980,3,2,5
Honduras,Costa Rica,1980,1,1,2
Egypt,Ivory Coast,1980,2,1,3
Kuwait,Bulgaria,1980,1,1,2
Nigeria,Tanzania,1980,3,1,4
Algeria,Ghana,1980,0,0,0
Guinea,Morocco,1980,1,1,2
Egypt,Tanzania,1980,2,1,3
Malaysia,Saudi Arabia,1980,3,0,3
Nigeria,Ivory Coast,1980,0,0,0
Algeria,Morocco,1980,1,0,1
Ghana,Guinea,1980,1,0,1
Italy,Uruguay,1980,1,0,1
Ivory Coast,Tanzania,1980,1,1,2
Nigeria,Egypt,1980,1,0,1
Algeria,Guinea,1980,3,2,5
Ghana,Morocco,1980,0,1,1
Malaysia,China PR,1980,3,1,4
Belgium,Uruguay,1980,2,0,2
Honduras,Mexico,1980,0,1,1
Algeria,Egypt,1980,2,2,4
Nigeria,Morocco,1980,1,0,1
Tahiti,Vanuatu,1980,1,0,1
Egypt,Morocco,1980,0,2,2
Nigeria,Algeria,1980,3,0,3
Yugoslavia,Uruguay,1980,2,1,3
Bulgaria,Russia,1980,1,3,4
Cyprus,Republic of Ireland,1980,2,3,5
France,Netherlands,1980,0,0,0
Hungary,Poland,1980,2,1,3
Israel,Northern Ireland,1980,0,0,0
Luxembourg,Uruguay,1980,0,1,1
Scotland,Portugal,1980,4,1,5
Spain,England,1980,0,2,2
Switzerland,Czechoslovakia,1980,2,0,2
Guyana,Grenada,1980,5,2,7
Yugoslavia,Romania,1980,2,0,2
Switzerland,Greece,1980,2,0,2
Belgium,Poland,1980,2,1,3
Germany,Austria,1980,1,0,1
Romania,German DR,1980,2,2,4
Senegal,Tunisia,1980,0,2,2
Ivory Coast,Gabon,1980,4,1,5
Mexico,Honduras,1980,5,0,5
Grenada,Guyana,1980,2,3,5
Guatemala,Mexico,1980,2,4,6
Costa Rica,Honduras,1980,1,1,2
German DR,Greece,1980,2,0,2
Spain,Czechoslovakia,1980,2,2,4
Italy,Poland,1980,2,2,4
Tanzania,Zambia,1980,0,2,2
Zimbabwe,Mozambique,1980,6,0,6
Mozambique,Tanzania,1980,0,2,2
Zimbabwe,Zambia,1980,2,1,3
Yugoslavia,Poland,1980,2,1,3
Malta,Libya,1980,0,3,3
Mexico,Guatemala,1980,2,2,4
Sweden,Russia,1980,1,5,6
Czechoslovakia,Hungary,1980,1,0,1
Republic of Ireland,Switzerland,1980,2,0,2
Senegal,Guinea,1980,1,0,1
Thailand,Luxembourg,1980,0,1,1
Zambia,Malawi,1980,1,1,2
Sweden,Denmark,1980,0,1,1
Libya,Gambia,1980,2,1,3
South Korea,Luxembourg,1980,2,3,5
Martinique,Guadeloupe,1980,1,0,1
Panama,El Salvador,1980,0,0,0
Japan,Luxembourg,1980,1,0,1
Myanmar,Luxembourg,1980,2,0,2
England,Argentina,1980,3,1,4
Germany,Poland,1980,3,1,4
Haiti,El Salvador,1980,2,0,2
Greece,Bulgaria,1980,0,0,0
South Korea,Luxembourg,1980,3,0,3
Republic of Ireland,Argentina,1980,0,1,1
Northern Ireland,Scotland,1980,1,0,1
Wales,England,1980,4,1,5
Ethiopia,Zambia,1980,0,0,0
England,Northern Ireland,1980,1,1,2
Guatemala,Costa Rica,1980,0,0,0
Austria,Argentina,1980,1,5,6
Denmark,Spain,1980,2,2,4
Scotland,Wales,1980,1,0,1
Finland,Sweden,1980,0,2,2
Norway,Bulgaria,1980,1,0,1
Russia,France,1980,1,0,1
Wales,Northern Ireland,1980,0,1,1
Scotland,England,1980,0,2,2
Poland,Scotland,1980,1,0,1
Costa Rica,Guatemala,1980,2,1,3
Australia,England,1980,1,2,3
Hungary,Scotland,1980,3,1,4
Sierra Leone,Algeria,1980,2,2,4
Macau,Hong Kong,1980,0,2,2
Zambia,Ethiopia,1980,4,0,4
Iceland,Wales,1980,0,4,4
Denmark,Norway,1980,3,1,4
El Salvador,Haiti,1980,3,0,3
Finland,Bulgaria,1980,0,2,2
Hungary,Austria,1980,1,1,2
Belgium,Romania,1980,2,1,3
Honduras,Haiti,1980,3,1,4
Zambia,Zimbabwe,1980,2,1,3
Brazil,Mexico,1980,2,0,2
Tunisia,Morocco,1980,0,1,1
Zambia,Zimbabwe,1980,1,3,4
Hong Kong,Japan,1980,1,3,4
Honduras,Haiti,1980,1,0,1
China PR,Japan,1980,1,0,1
Czechoslovakia,Germany,1980,0,1,1
Netherlands,Greece,1980,1,0,1
Belgium,England,1980,1,1,2
Guatemala,Haiti,1980,1,2,3
Italy,Spain,1980,0,0,0
Algeria,Sierra Leone,1980,3,1,4
China PR,Hong Kong,1980,7,0,7
Honduras,Panama,1980,0,0,0
Togo,Nigeria,1980,0,1,1
Germany,Netherlands,1980,3,2,5
Greece,Czechoslovakia,1980,1,3,4
Australia,Northern Ireland,1980,1,1,2
Belgium,Spain,1980,2,1,3
Brazil,Russia,1980,1,2,3
Honduras,Panama,1980,2,0,2
Italy,England,1980,1,0,1
Malawi,Zambia,1980,2,0,2
Greece,Germany,1980,0,0,0
Netherlands,Czechoslovakia,1980,1,1,2
Australia,Northern Ireland,1980,1,2,3
Hong Kong,Japan,1980,0,2,2
Italy,Belgium,1980,0,0,0
Spain,England,1980,1,2,3
Sweden,Israel,1980,1,1,2
Madagascar,Tanzania,1980,2,1,3
Italy,Czechoslovakia,1980,1,1,2
Belgium,Germany,1980,1,2,3
Guinea,Lesotho,1980,3,1,4
Madagascar,Tanzania,1980,1,1,2
Poland,Iraq,1980,3,0,3
Senegal,Morocco,1980,0,1,1
Brazil,Chile,1980,2,1,3
Congo,Guinea,1980,1,1,2
Costa Rica,Cuba,1980,3,0,3
DR Congo,Congo,1980,1,2,3
Iceland,Finland,1980,1,1,2
DR Congo,Gabon,1980,1,1,2
Brazil,Poland,1980,1,1,2
Cameroon,Malawi,1980,3,0,3
Tunisia,Nigeria,1980,2,0,2
Zambia,Kenya,1980,5,0,5
Iceland,Faroe Islands,1980,2,1,3
Bolivia,Poland,1980,0,1,1
Faroe Islands,Greenland,1980,6,0,6
Mauritania,Senegal,1980,1,3,4
Panama,Guatemala,1980,0,2,2
Iceland,Greenland,1980,4,1,5
Kenya,Tanzania,1980,3,1,4
Gambia,Libya,1980,0,0,0
Lesotho,Guinea,1980,1,1,2
Malawi,Zimbabwe,1980,0,1,1
Morocco,Senegal,1980,0,0,0
Malawi,Zimbabwe,1980,1,1,2
Colombia,Poland,1980,1,4,5
Fiji,Tahiti,1980,1,1,2
Nigeria,Tunisia,1980,2,0,2
Russia,Denmark,1980,2,0,2
DR Congo,Mozambique,1980,5,2,7
Norway,Iceland,1980,3,1,4
Guatemala,Honduras,1980,1,1,2
Niger,Somalia,1980,0,0,0
Sweden,Iceland,1980,1,1,2
Uruguay,Peru,1980,0,0,0
Tanzania,Kenya,1980,5,0,5
Malawi,Cameroon,1980,1,1,2
Mozambique,DR Congo,1980,1,2,3
Somalia,Niger,1980,1,1,2
Panama,Honduras,1980,0,2,2
Haiti,Trinidad and Tobago,1980,2,0,2
Basque Country,Hungary,1980,1,5,6
United Arab Emirates,Iran,1980,0,2,2
United Arab Emirates,Iran,1980,0,3,3
Mozambique,Lesotho,1980,6,1,7
Panama,Costa Rica,1980,1,1,2
Cuba,Suriname,1980,3,0,3
Guatemala,El Salvador,1980,1,1,2
Trinidad and Tobago,Haiti,1980,1,0,1
Hungary,Sweden,1980,2,0,2
New Zealand,Mexico,1980,4,0,4
Norway,Finland,1980,6,1,7
Uruguay,Chile,1980,0,0,0
Indonesia,Thailand,1980,2,1,3
South Korea,Malaysia,1980,2,0,2
Australia,Mexico,1980,2,2,4
Lesotho,Mozambique,1980,2,1,3
Panama,El Salvador,1980,1,3,4
Bahrain,Malaysia,1980,1,1,2
South Korea,Indonesia,1980,3,0,3
Australia,Mexico,1980,1,1,2
Bolivia,Paraguay,1980,1,1,2
Bahrain,Indonesia,1980,2,3,5
Brazil,Uruguay,1980,1,0,1
Hungary,Russia,1980,1,4,5
South Korea,Thailand,1980,4,0,4
Romania,Yugoslavia,1980,4,1,5
Switzerland,Denmark,1980,1,1,2
Bolivia,Paraguay,1980,1,3,4
South Korea,Bahrain,1980,5,0,5
Malaysia,Thailand,1980,1,4,5
Fiji,Mexico,1980,0,2,2
Zimbabwe,Zambia,1980,1,1,2
Bahrain,Thailand,1980,0,1,1
Indonesia,Malaysia,1980,1,1,2
Zimbabwe,Zambia,1980,1,2,3
South Korea,Indonesia,1980,2,0,2
Tahiti,Mexico,1980,0,1,1
Albania,Finland,1980,2,0,2
Iceland,Russia,1980,1,2,3
Suriname,Cuba,1980,0,0,0
Singapore,South Korea,1980,0,2,2
Bulgaria,Romania,1980,1,2,3
England,Norway,1980,4,0,4
Republic of Ireland,Netherlands,1980,2,1,3
Luxembourg,Yugoslavia,1980,0,5,5
Sweden,Scotland,1980,0,1,1
Switzerland,Germany,1980,2,3,5
Haiti,Curaçao,1980,1,0,1
Madagascar,Mauritius,1980,0,0,0
Canada,New Zealand,1980,4,0,4
Kuwait,United Arab Emirates,1980,1,1,2
North Korea,Bangladesh,1980,3,2,5
Malaysia,South Korea,1980,1,1,2
Canada,New Zealand,1980,3,0,3
Iran,Syria,1980,0,0,0
Qatar,United Arab Emirates,1980,2,1,3
Argentina,Chile,1980,2,2,4
North Korea,China PR,1980,2,1,3
Kuwait,Malaysia,1980,3,1,4
Paraguay,Bolivia,1980,2,1,3
Bangladesh,Syria,1980,0,1,1
Qatar,South Korea,1980,0,2,2
China PR,Iran,1980,2,2,4
United Arab Emirates,Malaysia,1980,0,2,2
Kuwait,South Korea,1980,0,3,3
Bangladesh,Iran,1980,0,7,7
Malaysia,Qatar,1980,1,1,2
Syria,China PR,1980,1,0,1
Bulgaria,Sweden,1980,2,3,5
Finland,Austria,1980,0,2,2
Hungary,Spain,1980,2,2,4
Iran,North Korea,1980,3,2,5
Italy,Portugal,1980,3,1,4
South Korea,United Arab Emirates,1980,4,1,5
Norway,Romania,1980,1,1,2
Poland,Czechoslovakia,1980,1,1,2
Turkey,Iceland,1980,1,3,4
China PR,Bangladesh,1980,6,0,6
Kuwait,Qatar,1980,4,0,4
Paraguay,Brazil,1980,1,2,3
Syria,North Korea,1980,1,2,3
Yugoslavia,Denmark,1980,2,1,3
Guyana,Suriname,1980,0,1,1
South Korea,North Korea,1980,2,1,3
Kuwait,Iran,1980,2,1,3
Mali,Mauritania,1980,2,0,2
Mauritius,Madagascar,1980,1,1,2
Turkey,Northern Cyprus,1980,5,0,5
Iran,North Korea,1980,3,0,3
El Salvador,Guatemala,1980,3,2,5
Kuwait,South Korea,1980,3,0,3
Northern Cyprus,Saudi Arabia,1980,0,2,2
Costa Rica,Honduras,1980,2,3,5
Turkey,Libya,1980,1,2,3
Turkey,Saudi Arabia,1980,3,0,3
Libya,Saudi Arabia,1980,2,0,2
Luxembourg,United States,1980,0,2,2
El Salvador,Panama,1980,4,1,5
Portugal,United States,1980,1,1,2
Austria,Hungary,1980,3,1,4
Czechoslovakia,German DR,1980,0,1,1
Argentina,Bulgaria,1980,2,0,2
Cyprus,France,1980,0,7,7
Luxembourg,Italy,1980,0,2,2
Netherlands,Germany,1980,1,1,2
Argentina,Poland,1980,2,1,3
Cameroon,Zimbabwe,1980,2,0,2
Guatemala,Costa Rica,1980,0,0,0
Mauritania,Mali,1980,2,1,3
Suriname,Guyana,1980,4,0,4
Argentina,Czechoslovakia,1980,1,0,1
Denmark,Greece,1980,0,1,1
German DR,Spain,1980,0,0,0
Republic of Ireland,Belgium,1980,1,1,2
Northern Ireland,Sweden,1980,3,0,3
Romania,England,1980,2,1,3
Russia,Iceland,1980,5,0,5
Scotland,Portugal,1980,0,0,0
Wales,Turkey,1980,4,0,4
South Korea,New Zealand,1980,1,2,3
South Korea,Indonesia,1980,1,0,1
Malaysia,Myanmar,1980,3,2,5
Morocco,Thailand,1980,2,1,3
South Korea,Kuwait,1980,3,0,3
Canada,Mexico,1980,1,1,2
Bulgaria,Albania,1980,2,1,3
Kuwait,New Zealand,1980,1,5,6
Myanmar,Morocco,1980,2,2,4
Malaysia,Thailand,1980,2,2,4
South Korea,Morocco,1980,1,1,2
Indonesia,New Zealand,1980,0,0,0
Myanmar,Thailand,1980,1,2,3
Trinidad and Tobago,Guyana,1980,1,1,2
Malaysia,South Korea,1980,1,1,2
Kuwait,Myanmar,1980,3,1,4
South Korea,Thailand,1980,0,0,0
Myanmar,New Zealand,1980,1,1,2
Kuwait,Thailand,1980,0,1,1
Trinidad and Tobago,Guyana,1980,2,0,2
Kuwait,Indonesia,1980,1,2,3
Liberia,Mali,1980,1,1,2
United States,Canada,1980,0,0,0
Honduras,Guatemala,1980,0,0,0
Indonesia,Thailand,1980,1,1,2
Malawi,Zimbabwe,1980,0,1,1
Morocco,New Zealand,1980,3,0,3
Kuwait,Morocco,1980,0,3,3
Malaysia,Indonesia,1980,1,1,2
France,Republic of Ireland,1980,2,0,2
New Zealand,Thailand,1980,1,1,2
Malaysia,Kuwait,1980,2,1,3
Indonesia,Morocco,1980,0,2,2
Switzerland,Norway,1980,1,2,3
Malaysia,New Zealand,1980,2,0,2
Myanmar,South Korea,1980,1,1,2
Brazil,Paraguay,1980,6,0,6
Myanmar,Indonesia,1980,1,0,1
Canada,United States,1980,2,1,3
Italy,Denmark,1980,2,0,2
Tanzania,Madagascar,1980,0,0,0
Zambia,Angola,1980,0,0,0
Malaysia,Morocco,1980,1,2,3
Zambia,Angola,1980,1,1,2
Costa Rica,Panama,1980,2,0,2
Bolivia,Uruguay,1980,1,3,4
Cuba,Guyana,1980,1,0,1
Guatemala,El Salvador,1980,0,0,0
Honduras,Canada,1980,2,0,2
Liberia,Gambia,1980,0,0,0
Mexico,United States,1980,5,1,6
Senegal,Mauritania,1980,3,0,3
Trinidad and Tobago,Curaçao,1980,0,0,0
Zimbabwe,Malawi,1980,1,1,2
Greece,Australia,1980,3,3,6
Guatemala,Canada,1980,0,1,1
Ethiopia,Mozambique,1980,3,2,5
Israel,Sweden,1980,0,0,0
Peru,Uruguay,1980,1,1,2
Spain,Poland,1980,1,2,3
Sudan,Tanzania,1980,0,1,1
Austria,Albania,1980,5,0,5
Benin,Niger,1980,1,0,1
Italy,Yugoslavia,1980,2,0,2
Brunei,Western Australia,1980,0,2,2
Guatemala,Panama,1980,5,0,5
Honduras,Costa Rica,1980,1,1,2
Madagascar,DR Congo,1980,1,1,2
Malawi,Zanzibar,1980,1,0,1
Mexico,Canada,1980,1,1,2
Morocco,Zambia,1980,2,0,2
Zimbabwe,Cameroon,1980,1,0,1
Angola,Congo,1980,1,1,2
Senegal,Sierra Leone,1980,2,0,2
Somalia,Tanzania,1980,1,1,2
Belgium,Netherlands,1980,1,0,1
Denmark,Luxembourg,1980,4,0,4
England,Switzerland,1980,2,1,3
German DR,Hungary,1980,2,0,2
Germany,France,1980,4,1,5
Republic of Ireland,Cyprus,1980,6,0,6
Kenya,Malawi,1980,0,1,1
Poland,Algeria,1980,5,1,6
Portugal,Northern Ireland,1980,1,0,1
Wales,Czechoslovakia,1980,1,0,1
Brunei,Singapore,1980,0,3,3
Sudan,Somalia,1980,2,0,2
Kenya,Zanzibar,1980,1,2,3
Trinidad and Tobago,Cuba,1980,2,2,4
El Salvador,Honduras,1980,2,1,3
Gambia,Liberia,1980,1,1,2
Guinea,DR Congo,1980,2,1,3
United States,Mexico,1980,2,1,3
Malawi,Tanzania,1980,0,1,1
Singapore,Western Australia,1980,1,1,2
Costa Rica,Guatemala,1980,0,3,3
Sudan,Tanzania,1980,1,0,1
Curaçao,Trinidad and Tobago,1980,0,0,0
Bolivia,Finland,1980,3,0,3
Congo,Angola,1980,0,0,0
Guyana,Cuba,1980,0,3,3
Honduras,El Salvador,1980,2,0,2
Sierra Leone,Senegal,1980,1,2,3
Zambia,Morocco,1980,2,0,2
Israel,Australia,1980,0,1,1
Bulgaria,Germany,1980,1,3,4
Czechoslovakia,Turkey,1980,2,0,2
Argentina,Russia,1980,1,1,2
Bolivia,Finland,1980,2,2,4
Hong Kong,Australia,1980,1,0,1
Albania,Austria,1980,0,1,1
Greece,Italy,1980,0,2,2
Nigeria,Tanzania,1980,1,1,2
Guatemala,Honduras,1980,0,1,1
Indonesia,Australia,1980,1,1,2
Kenya,Zambia,1980,1,1,2
Liberia,Guinea,1980,0,0,0
Mali,Togo,1980,1,2,3
Malta,Poland,1980,0,2,2
Uruguay,Finland,1980,6,0,6
Mali,Togo,1980,4,0,4
Costa Rica,El Salvador,1980,0,0,0
Kenya,Zambia,1980,2,0,2
Uruguay,Bolivia,1980,5,0,5
Algeria,Sudan,1980,2,0,2
Curaçao,Haiti,1980,1,1,2
Kenya,Zambia,1980,2,1,3
Saudi Arabia,Indonesia,1980,8,0,8
Honduras,Panama,1980,5,0,5
Niger,Togo,1980,0,1,1
Saudi Arabia,Indonesia,1980,3,0,3
Argentina,Switzerland,1980,5,0,5
Portugal,Israel,1980,3,0,3
Uruguay,Switzerland,1980,4,0,4
Tanzania,Nigeria,1980,0,2,2
Brazil,Switzerland,1980,2,0,2
DR Congo,Madagascar,1980,3,2,5
Cyprus,Belgium,1980,0,2,2
El Salvador,Guatemala,1980,1,0,1
Guinea,Liberia,1980,1,0,1
Hong Kong,China PR,1980,0,1,1
North Korea,Macau,1980,3,0,3
Singapore,Japan,1980,0,1,1
China PR,Macau,1980,3,0,3
Hong Kong,Singapore,1980,1,1,2
China PR,Japan,1980,1,0,1
Singapore,North Korea,1980,0,1,1
Hong Kong,North Korea,1980,2,2,4
Japan,Macau,1980,3,0,3
Sudan,Algeria,1980,1,1,2
Togo,Niger,1980,1,2,3
North Korea,Japan,1980,1,0,1
Uruguay,Netherlands,1980,2,0,2
Hong Kong,China PR,1980,0,0,0
Argentina,Germany,1981,2,1,3
Uruguay,Italy,1981,2,0,2
Argentina,Brazil,1981,1,1,2
North Korea,China PR,1981,2,4,6
Netherlands,Italy,1981,1,1,2
Brazil,Germany,1981,4,1,5
Uruguay,Brazil,1981,2,1,3
Curaçao,Venezuela,1981,3,1,4
Tunisia,Qatar,1981,4,0,4
Venezuela,Curaçao,1981,1,0,1
Mexico,Bulgaria,1981,1,1,2
Japan,Poland,1981,0,2,2
Ecuador,Bulgaria,1981,1,3,4
Japan,Poland,1981,2,4,6
Greece,Luxembourg,1981,2,0,2
Japan,Poland,1981,1,4,5
Bolivia,Bulgaria,1981,1,3,4
Colombia,Brazil,1981,1,1,2
Japan,Poland,1981,0,3,3
Gambia,Guinea,1981,1,1,2
Mali,Mauritania,1981,2,0,2
Cape Verde,Senegal,1981,0,1,1
Mali,Guinea,1981,1,1,2
Guinea-Bissau,Senegal,1981,0,1,1
Guinea,Mauritania,1981,2,1,3
Jordan,Iraq,1981,0,2,2
Mali,Gambia,1981,4,1,5
Cape Verde,Guinea-Bissau,1981,3,0,3
Jordan,Iraq,1981,0,2,2
Malaysia,Japan,1981,1,0,1
Venezuela,Brazil,1981,0,1,1
Mali,Cape Verde,1981,2,0,2
Guinea,Senegal,1981,1,0,1
Malaysia,Japan,1981,1,1,2
Guinea-Bissau,Mauritania,1981,4,3,7
Mexico,South Korea,1981,4,0,4
Peru,Bulgaria,1981,1,2,3
Cape Verde,Senegal,1981,1,5,6
Mali,Guinea,1981,0,0,0
Ecuador,Brazil,1981,0,6,6
Oman,Jordan,1981,0,1,1
Bolivia,Venezuela,1981,3,0,3
Morocco,Syria,1981,3,0,3
Oman,Jordan,1981,0,2,2
Singapore,Japan,1981,0,1,1
Belgium,Cyprus,1981,3,2,5
Spain,France,1981,1,0,1
Singapore,Japan,1981,0,0,0
Bolivia,Brazil,1981,1,2,3
Netherlands,Cyprus,1981,3,0,3
Indonesia,Japan,1981,2,0,2
Republic of Ireland,Wales,1981,1,3,4
Israel,Scotland,1981,0,1,1
Bahrain,Jordan,1981,1,0,1
Norway,Sweden,1981,2,4,6
Finland,Sweden,1981,2,1,3
Tahiti,Fiji,1981,1,0,1
Bahrain,Tunisia,1981,0,3,3
Japan,South Korea,1981,0,1,1
Liberia,Togo,1981,2,0,2
Morocco,Iraq,1981,1,1,2
Saudi Arabia,Tunisia,1981,1,2,3
Chile,Colombia,1981,1,0,1
Tahiti,Fiji,1981,2,1,3
Luxembourg,Greece,1981,0,2,2
Saudi Arabia,Jordan,1981,2,1,3
Brazil,Chile,1981,2,1,3
Paraguay,Colombia,1981,0,2,2
Venezuela,Bolivia,1981,1,0,1
Qatar,Iraq,1981,0,1,1
Colombia,Chile,1981,1,2,3
Syria,Bahrain,1981,0,1,1
Saudi Arabia,Iraq,1981,1,0,1
Brazil,Bolivia,1981,3,1,4
Morocco,Liberia,1981,3,1,4
Qatar,Bahrain,1981,3,0,3
Czechoslovakia,Switzerland,1981,0,1,1
Saudi Arabia,Syria,1981,2,0,2
Belgium,Republic of Ireland,1981,1,0,1
England,Spain,1981,1,2,3
Iraq,Bahrain,1981,2,0,2
Netherlands,France,1981,1,0,1
Romania,Poland,1981,2,0,2
Scotland,Northern Ireland,1981,1,1,2
Senegal,Guinea,1981,0,1,1
Turkey,Wales,1981,0,1,1
Yugoslavia,Bulgaria,1981,2,1,3
Qatar,Syria,1981,2,1,3
Saudi Arabia,Bahrain,1981,1,0,1
Brazil,Venezuela,1981,5,0,5
Iraq,Syria,1981,2,1,3
Saudi Arabia,Qatar,1981,1,0,1
Albania,Germany,1981,0,2,2
Cameroon,Niger,1981,2,0,2
Algeria,Senegal,1981,2,0,2
Kenya,Egypt,1981,3,5,8
Liberia,Morocco,1981,0,5,5
Malta,German DR,1981,1,2,3
Nigeria,Angola,1981,0,0,0
Cameroon,Togo,1981,4,0,4
DR Congo,Mozambique,1981,2,1,3
Singapore,Malaysia,1981,1,1,2
Zambia,Congo,1981,1,1,2
Israel,Romania,1981,2,1,3
Algeria,Mali,1981,5,1,6
Ghana,Congo,1981,1,1,2
Zimbabwe,Zambia,1981,0,1,1
DR Congo,Cameroon,1981,1,0,1
Ethiopia,Kenya,1981,0,0,0
Guinea,Nigeria,1981,1,1,2
Tunisia,Senegal,1981,1,0,1
Togo,Congo,1981,2,1,3
Cyprus,Greece,1981,0,1,1
Denmark,Romania,1981,2,1,3
Portugal,Bulgaria,1981,1,1,2
Spain,Hungary,1981,0,3,3
Turkey,Czechoslovakia,1981,0,3,3
Malaysia,Singapore,1981,1,2,3
Botswana,Malawi,1981,2,5,7
Egypt,Kenya,1981,2,0,2
Lesotho,Mozambique,1981,0,2,2
Eswatini,Zambia,1981,1,6,7
Chile,Peru,1981,3,0,3
Ethiopia,Sudan,1981,1,1,2
Italy,German DR,1981,0,0,0
Malawi,Zambia,1981,2,1,3
Mali,Algeria,1981,3,0,3
Mozambique,DR Congo,1981,3,3,6
Togo,Cameroon,1981,2,2,4
Zimbabwe,Malawi,1981,4,0,4
Ethiopia,Sudan,1981,2,0,2
South Korea,Malaysia,1981,2,1,3
Kuwait,Thailand,1981,6,0,6
South Korea,Thailand,1981,5,1,6
Kuwait,Malaysia,1981,4,0,4
New Zealand,Australia,1981,3,3,6
Nigeria,Guinea,1981,1,0,1
Zambia,Zimbabwe,1981,2,0,2
Cameroon,DR Congo,1981,6,1,7
Congo,Ghana,1981,0,1,1
Ethiopia,Rwanda,1981,1,0,1
Morocco,Egypt,1981,1,0,1
Senegal,Tunisia,1981,0,0,0
Malaysia,Thailand,1981,2,2,4
Scotland,Israel,1981,3,1,4
Switzerland,Hungary,1981,2,2,4
Bulgaria,Norway,1981,1,0,1
Chile,Uruguay,1981,1,2,3
Cyprus,Netherlands,1981,0,1,1
England,Romania,1981,0,0,0
France,Belgium,1981,3,2,5
Germany,Austria,1981,2,0,2
Republic of Ireland,Czechoslovakia,1981,3,1,4
Kuwait,South Korea,1981,2,0,2
Northern Ireland,Portugal,1981,1,0,1
Yugoslavia,Greece,1981,5,1,6
Algeria,Niger,1981,4,0,4
Luxembourg,Denmark,1981,1,2,3
Poland,German DR,1981,1,0,1
Fiji,New Zealand,1981,0,4,4
Liberia,Guinea,1981,2,1,3
Egypt,Morocco,1981,0,0,0
Rwanda,Ethiopia,1981,1,0,1
Indonesia,New Zealand,1981,0,2,2
England,Brazil,1981,0,1,1
Bulgaria,Finland,1981,4,0,4
Hungary,Romania,1981,1,0,1
Sweden,Denmark,1981,1,2,3
France,Brazil,1981,1,3,4
Australia,New Zealand,1981,0,2,2
Wales,Scotland,1981,2,0,2
Ecuador,Paraguay,1981,1,0,1
Ethiopia,Yemen DPR,1981,1,1,2
German DR,Cuba,1981,5,0,5
Germany,Brazil,1981,1,2,3
Scotland,Northern Ireland,1981,2,0,2
Australia,Indonesia,1981,2,0,2
England,Wales,1981,0,0,0
Norway,Hungary,1981,1,2,3
England,Scotland,1981,0,1,1
New Zealand,Indonesia,1981,5,0,5
Poland,Republic of Ireland,1981,3,0,3
Ecuador,Chile,1981,0,0,0
Finland,Germany,1981,0,4,4
Czechoslovakia,Iceland,1981,6,1,7
Austria,Bulgaria,1981,2,0,2
New Zealand,Taiwan,1981,2,0,2
Switzerland,England,1981,2,1,3
Wales,Russia,1981,0,0,0
Fiji,Indonesia,1981,0,0,0
Niger,Algeria,1981,1,0,1
Paraguay,Ecuador,1981,3,1,4
Equatorial Guinea,São Tomé and Príncipe,1981,1,1,2
Japan,China PR,1981,0,0,0
Denmark,Italy,1981,3,1,4
Romania,Norway,1981,1,0,1
Sweden,Northern Ireland,1981,1,0,1
Fiji,Taiwan,1981,2,1,3
Hungary,England,1981,1,3,4
Paraguay,Chile,1981,0,1,1
Suriname,French Guiana,1981,3,1,4
Australia,Taiwan,1981,3,2,5
Haiti,El Salvador,1981,0,0,0
Haiti,El Salvador,1981,0,0,0
Chile,Ecuador,1981,2,0,2
Liechtenstein,Malta,1981,1,1,2
Indonesia,Taiwan,1981,1,0,1
Liechtenstein,Thailand,1981,0,2,2
Austria,Finland,1981,5,1,6
South Korea,Malaysia,1981,2,0,2
Norway,Switzerland,1981,1,1,2
Indonesia,Malta,1981,0,1,1
Japan,Malaysia,1981,2,0,2
Malawi,Tanzania,1981,4,1,5
Indonesia,Thailand,1981,1,3,4
Portugal,Spain,1981,2,0,2
Chile,Paraguay,1981,3,0,3
French Guiana,Suriname,1981,3,1,4
Guadeloupe,Dominica,1981,5,0,5
South Korea,Japan,1981,2,0,2
Malawi,Tanzania,1981,3,1,4
Indonesia,Liechtenstein,1981,2,3,5
Malta,Thailand,1981,2,0,2
Malawi,Tanzania,1981,0,0,0
Hong Kong,Macau,1981,3,1,4
Sweden,Portugal,1981,3,0,3
Mozambique,Angola,1981,0,1,1
Zambia,DR Congo,1981,3,1,4
Angola,Zimbabwe,1981,1,1,2
Liberia,Ghana,1981,0,0,0
Guinea,Ethiopia,1981,2,2,4
Venezuela,Spain,1981,0,2,2
Zambia,DR Congo,1981,2,2,4
Colombia,Spain,1981,1,1,2
Finland,Norway,1981,3,1,4
Barbados,Trinidad and Tobago,1981,1,1,2
Chile,Spain,1981,1,1,2
Dominica,Guadeloupe,1981,2,3,5
Saint Vincent and the Grenadines,Martinique,1981,2,1,3
Malawi,Mozambique,1981,3,1,4
Brazil,Spain,1981,1,0,1
Mozambique,Zimbabwe,1981,2,4,6
Malawi,Zimbabwe,1981,2,0,2
Kenya,Mauritius,1981,2,1,3
Réunion,Madagascar,1981,2,3,5
Réunion,Madagascar,1981,0,3,3
Madagascar,Mauritius,1981,0,0,0
Réunion,Kenya,1981,1,3,4
Uruguay,Chile,1981,0,0,0
Benin,DR Congo,1981,1,2,3
Trinidad and Tobago,Barbados,1981,1,1,2
Nigeria,Burkina Faso,1981,1,0,1
Benin,Ghana,1981,1,2,3
Kenya,Madagascar,1981,1,0,1
Martinique,Saint Vincent and the Grenadines,1981,1,2,3
Réunion,Mauritius,1981,1,2,3
Suriname,French Guiana,1981,1,0,1
Ghana,DR Congo,1981,2,2,4
Colombia,Peru,1981,1,1,2
El Salvador,Haiti,1981,4,0,4
Fiji,Australia,1981,1,4,5
Congo,DR Congo,1981,2,2,4
Sweden,Finland,1981,1,0,1
Zimbabwe,Nigeria,1981,2,0,2
DR Congo,Ghana,1981,1,2,3
Guadeloupe,Saint Vincent and the Grenadines,1981,3,0,3
Suriname,Trinidad and Tobago,1981,1,1,2
Kenya,Nigeria,1981,1,3,4
Peru,Chile,1981,1,2,3
Uganda,Burundi,1981,2,2,4
Uruguay,Colombia,1981,3,2,5
Indonesia,Fiji,1981,3,3,6
Finland,Denmark,1981,1,2,3
Norway,Nigeria,1981,2,2,4
Sweden,Bulgaria,1981,1,0,1
Australia,Fiji,1981,10,0,10
Indonesia,Philippines,1981,3,0,3
Trinidad and Tobago,Suriname,1981,3,2,5
Cameroon,Madagascar,1981,5,1,6
Morocco,Zambia,1981,2,1,3
New Zealand,Fiji,1981,13,0,13
Peru,Colombia,1981,2,0,2
Saint Vincent and the Grenadines,Guadeloupe,1981,3,1,4
Indonesia,South Korea,1981,0,1,1
Iceland,Nigeria,1981,3,0,3
Iraq,Ghana,1981,4,0,4
Uruguay,Peru,1981,1,2,3
Iraq,Ghana,1981,2,2,4
Chile,Brazil,1981,0,0,0
Denmark,Iceland,1981,3,0,3
Algeria,Burkina Faso,1981,7,0,7
Indonesia,Australia,1981,1,0,1
Madagascar,Cameroon,1981,2,1,3
Malaysia,Japan,1981,0,2,2
Zambia,Morocco,1981,2,0,2
India,New Zealand,1981,0,0,0
Singapore,Thailand,1981,1,3,4
Switzerland,Netherlands,1981,2,1,3
Finland,Albania,1981,2,1,3
Indonesia,United Arab Emirates,1981,5,2,7
Poland,Germany,1981,0,2,2
India,Japan,1981,2,3,5
South Korea,Singapore,1981,2,0,2
Malawi,Zimbabwe,1981,1,2,3
Malaysia,New Zealand,1981,0,1,1
Eswatini,Lesotho,1981,1,1,2
India,United Arab Emirates,1981,2,0,2
Lesotho,Malawi,1981,1,4,5
Eswatini,Zimbabwe,1981,0,2,2
Lesotho,Zimbabwe,1981,2,5,7
Niger,Burkina Faso,1981,2,1,3
Peru,Uruguay,1981,0,0,0
Eswatini,Malawi,1981,0,0,0
Indonesia,New Zealand,1981,0,0,0
Japan,United Arab Emirates,1981,3,2,5
Belgium,France,1981,2,0,2
Czechoslovakia,Wales,1981,2,0,2
Denmark,Yugoslavia,1981,1,2,3
Iceland,Turkey,1981,2,0,2
Malaysia,Indonesia,1981,2,0,2
Netherlands,Republic of Ireland,1981,2,2,4
Norway,England,1981,2,1,3
Romania,Bulgaria,1981,1,2,3
Scotland,Sweden,1981,2,0,2
Iraq,Thailand,1981,7,1,8
New Zealand,United Arab Emirates,1981,0,1,1
India,Indonesia,1981,1,0,1
Japan,New Zealand,1981,0,1,1
Malaysia,United Arab Emirates,1981,0,1,1
Colombia,Uruguay,1981,1,1,2
Iraq,South Korea,1981,1,1,2
Saint Vincent and the Grenadines,Suriname,1981,2,1,3
Indonesia,Japan,1981,0,2,2
Malaysia,India,1981,2,2,4
Iraq,Singapore,1981,4,0,4
South Korea,Thailand,1981,1,1,2
Iraq,Japan,1981,2,0,2
Burkina Faso,Algeria,1981,1,1,2
Venezuela,Cuba,1981,1,0,1
Austria,Spain,1981,0,0,0
Denmark,Norway,1981,2,1,3
Germany,Finland,1981,7,1,8
Greece,Sweden,1981,2,1,3
Iceland,Czechoslovakia,1981,1,1,2
Italy,Bulgaria,1981,3,2,5
Portugal,Poland,1981,2,0,2
Romania,Hungary,1981,0,0,0
Russia,Turkey,1981,4,0,4
China PR,New Zealand,1981,0,0,0
Uganda,Nigeria,1981,1,0,1
Morocco,Tunisia,1981,2,2,4
Suriname,Saint Vincent and the Grenadines,1981,3,3,6
Botswana,Zimbabwe,1981,0,1,1
Trinidad and Tobago,Grenada,1981,3,1,4
Trinidad and Tobago,Grenada,1981,5,1,6
New Zealand,China PR,1981,1,0,1
Nigeria,Liberia,1981,3,0,3
Ethiopia,Guinea,1981,1,1,2
Turkey,Russia,1981,0,3,3
German DR,Poland,1981,2,3,5
New Zealand,Kuwait,1981,1,2,3
Nigeria,Algeria,1981,0,2,2
Romania,Switzerland,1981,1,2,3
Trinidad and Tobago,Canada,1981,2,4,6
Albania,Bulgaria,1981,0,2,2
Austria,Germany,1981,1,3,4
Greece,Denmark,1981,2,3,5
Hungary,Switzerland,1981,3,0,3
Republic of Ireland,France,1981,3,2,5
Netherlands,Belgium,1981,3,0,3
Northern Ireland,Scotland,1981,0,0,0
Portugal,Sweden,1981,1,2,3
Spain,Luxembourg,1981,3,0,3
Wales,Iceland,1981,2,2,4
Saudi Arabia,South Korea,1981,2,0,2
Yugoslavia,Italy,1981,1,1,2
China PR,Kuwait,1981,3,0,3
Puerto Rico,Guadeloupe,1981,1,1,2
Saint Vincent and the Grenadines,Trinidad and Tobago,1981,0,2,2
Guadeloupe,Trinidad and Tobago,1981,0,2,2
Puerto Rico,Saint Vincent and the Grenadines,1981,0,2,2
Guadeloupe,Saint Vincent and the Grenadines,1981,1,3,4
Tunisia,Malta,1981,0,1,1
United Arab Emirates,India,1981,2,0,2
Argentina,Poland,1981,1,2,3
Brazil,Bulgaria,1981,3,0,3
Israel,Portugal,1981,4,1,5
Russia,Czechoslovakia,1981,2,0,2
Saudi Arabia,Sweden,1981,1,2,3
United Arab Emirates,India,1981,3,1,4
Algeria,Nigeria,1981,2,1,3
Burundi,Tanzania,1981,1,2,3
Hungary,Norway,1981,4,1,5
Mexico,Cuba,1981,4,0,4
Senegal,Morocco,1981,2,0,2
Burundi,Tanzania,1981,0,1,1
Canada,El Salvador,1981,1,0,1
Honduras,Haiti,1981,4,0,4
Saudi Arabia,Kuwait,1981,0,1,1
Trinidad and Tobago,Barbados,1981,2,1,3
Canada,Haiti,1981,1,1,2
Mexico,El Salvador,1981,0,1,1
Trinidad and Tobago,Barbados,1981,0,0,0
Honduras,Cuba,1981,2,0,2
Tunisia,Cameroon,1981,1,1,2
Thailand,Singapore,1981,2,1,3
Argentina,Czechoslovakia,1981,1,1,2
Bulgaria,Austria,1981,0,0,0
Cuba,El Salvador,1981,0,0,0
German DR,Malta,1981,5,1,6
Haiti,Mexico,1981,1,1,2
Malaysia,Singapore,1981,0,1,1
Switzerland,Romania,1981,0,0,0
Thailand,Pakistan,1981,1,0,1
Honduras,Canada,1981,2,1,3
Saudi Arabia,China PR,1981,2,4,6
Malaysia,Pakistan,1981,2,3,5
Italy,Greece,1981,1,1,2
Kenya,Malawi,1981,1,0,1
Haiti,Cuba,1981,0,2,2
Mexico,Canada,1981,1,1,2
Morocco,Cameroon,1981,0,2,2
Poland,Malta,1981,6,0,6
Sudan,Uganda,1981,2,2,4
Tanzania,Zanzibar,1981,3,1,4
Thailand,Malaysia,1981,2,0,2
Honduras,El Salvador,1981,0,0,0
Kenya,Zanzibar,1981,2,1,3
Pakistan,Singapore,1981,1,0,1
Sudan,Zimbabwe,1981,0,0,0
Tanzania,Malawi,1981,2,2,4
Uganda,Zambia,1981,3,1,4
England,Hungary,1981,1,0,1
France,Netherlands,1981,2,0,2
Germany,Albania,1981,8,0,8
Northern Ireland,Israel,1981,1,0,1
Poland,Spain,1981,2,3,5
Portugal,Scotland,1981,2,1,3
Russia,Wales,1981,3,0,3
China PR,Saudi Arabia,1981,2,0,2
El Salvador,Haiti,1981,1,0,1
Zambia,Zimbabwe,1981,1,1,2
Malawi,Zanzibar,1981,4,1,5
Tanzania,Kenya,1981,1,0,1
Cuba,Canada,1981,2,2,4
Sudan,Zambia,1981,0,2,2
Yugoslavia,Luxembourg,1981,5,0,5
Germany,Bulgaria,1981,4,0,4
Honduras,Mexico,1981,0,0,0
Kenya,Uganda,1981,3,1,4
Tanzania,Zambia,1981,2,1,3
Uganda,Zambia,1981,0,1,1
New Zealand,Saudi Arabia,1981,2,2,4
Tanzania,Kenya,1981,0,1,1
Cameroon,Morocco,1981,2,1,3
Czechoslovakia,Russia,1981,1,1,2
Greece,Yugoslavia,1981,1,2,3
Kuwait,China PR,1981,1,0,1
France,Cyprus,1981,4,0,4
Italy,Luxembourg,1981,1,0,1
Kuwait,Saudi Arabia,1981,2,0,2
Kuwait,New Zealand,1981,2,2,4
Bulgaria,Portugal,1981,5,2,7
Spain,Belgium,1981,2,0,2
Saudi Arabia,New Zealand,1981,0,5,5
United Arab Emirates,Tunisia,1981,1,4,5
China PR,New Zealand,1982,1,2,3
Cameroon,Congo,1982,2,1,3
Ethiopia,Tanzania,1982,0,2,2
Singapore,Bahrain,1982,2,0,2
Ethiopia,Tanzania,1982,0,0,0
Greece,Portugal,1982,1,2,3
Benin,Mali,1982,2,3,5
Burkina Faso,Senegal,1982,0,0,0
Brazil,German DR,1982,3,1,4
Senegal,Benin,1982,1,0,1
Libya,Guinea,1982,3,0,3
Mali,Niger,1982,2,2,4
Tunisia,Algeria,1982,0,1,1
Greece,German DR,1982,0,1,1
Cape Verde,Gambia,1982,2,0,2
Guinea,Senegal,1982,1,1,2
Guinea-Bissau,Sierra Leone,1982,1,2,3
Mali,Mauritania,1982,4,0,4
New Zealand,Hungary,1982,1,2,3
Benin,Ghana,1982,0,4,4
Cape Verde,Mali,1982,1,0,1
Gambia,Mauritania,1982,3,1,4
Guinea,Sierra Leone,1982,1,0,1
Guinea-Bissau,Senegal,1982,0,1,1
Liberia,Togo,1982,0,1,1
Ethiopia,Uganda,1982,1,2,3
New Zealand,Hungary,1982,1,2,3
Benin,Niger,1982,2,0,2
Cape Verde,Mauritania,1982,1,2,3
Gambia,Mali,1982,1,1,2
Ghana,Ivory Coast,1982,5,5,10
Guinea-Bissau,Guinea,1982,0,0,0
Liberia,Burkina Faso,1982,1,2,3
Senegal,Sierra Leone,1982,2,0,2
Bangladesh,Nepal,1982,1,1,2
India,China PR,1982,1,1,2
Benin,Ivory Coast,1982,3,3,6
Cape Verde,Guinea,1982,0,1,1
Germany,Portugal,1982,3,1,4
Ghana,Niger,1982,2,2,4
Mali,Senegal,1982,0,1,1
Nepal,Oman,1982,0,1,1
Togo,Burkina Faso,1982,2,1,3
Ethiopia,Uganda,1982,1,0,1
India,South Korea,1982,2,2,4
Zambia,Botswana,1982,2,0,2
Bangladesh,Oman,1982,1,3,4
Cape Verde,Mali,1982,1,2,3
Ghana,Burkina Faso,1982,1,0,1
Guinea,Senegal,1982,3,0,3
Ivory Coast,Niger,1982,1,1,2
Libya,Qatar,1982,2,1,3
Finland,Sweden,1982,2,2,4
South Korea,Uruguay,1982,2,2,4
Finland,Sweden,1982,2,1,3
Ivory Coast,Togo,1982,1,1,2
China PR,Uruguay,1982,0,0,0
Ivory Coast,Burkina Faso,1982,1,1,2
England,Northern Ireland,1982,4,0,4
France,Italy,1982,2,0,2
Ghana,Togo,1982,2,1,3
Spain,Scotland,1982,3,0,3
India,Uruguay,1982,1,3,4
China PR,South Korea,1982,1,1,2
United Arab Emirates,Honduras,1982,0,1,1
Iraq,German DR,1982,0,0,0
Brazil,Czechoslovakia,1982,1,1,2
United Arab Emirates,Honduras,1982,0,0,0
China PR,Uruguay,1982,0,2,2
Cameroon,Tunisia,1982,1,1,2
Libya,Ghana,1982,2,2,4
Iran,North Korea,1982,2,0,2
Algeria,Zambia,1982,1,0,1
Ethiopia,Nigeria,1982,0,3,3
Iraq,South Korea,1982,3,0,3
Argentina,Czechoslovakia,1982,0,0,0
Cameroon,Ghana,1982,0,0,0
Libya,Tunisia,1982,2,0,2
Liechtenstein,Switzerland,1982,0,1,1
Algeria,Nigeria,1982,2,1,3
Ethiopia,Zambia,1982,0,1,1
Greece,Russia,1982,0,2,2
Iraq,South Korea,1982,1,1,2
United Arab Emirates,Singapore,1982,3,0,3
Ghana,Tunisia,1982,1,0,1
Libya,Cameroon,1982,0,0,0
United Arab Emirates,Singapore,1982,5,3,8
Algeria,Ethiopia,1982,0,0,0
Nigeria,Zambia,1982,0,3,3
Kuwait,Iceland,1982,0,0,0
Algeria,Ghana,1982,2,3,5
Libya,Zambia,1982,2,1,3
Algeria,Zambia,1982,0,2,2
Libya,Ghana,1982,1,1,2
United Arab Emirates,Qatar,1982,1,0,1
Bahrain,Kuwait,1982,0,2,2
Brazil,Germany,1982,1,0,1
South Korea,Japan,1982,3,0,3
Trinidad and Tobago,United States,1982,1,2,3
United Arab Emirates,Saudi Arabia,1982,1,0,1
Oman,Qatar,1982,0,3,3
Chile,Peru,1982,2,1,3
Scotland,Netherlands,1982,2,1,3
Argentina,Germany,1982,1,1,2
Belgium,Romania,1982,4,1,5
Czechoslovakia,Greece,1982,2,1,3
France,Northern Ireland,1982,4,0,4
Hungary,Austria,1982,2,3,5
Spain,Wales,1982,1,1,2
Switzerland,Portugal,1982,2,1,3
United Arab Emirates,Kuwait,1982,0,2,2
Bahrain,Oman,1982,4,1,5
Saudi Arabia,Kuwait,1982,0,1,1
United Arab Emirates,Bahrain,1982,2,3,5
Kuwait,Oman,1982,2,0,2
Saudi Arabia,Qatar,1982,1,0,1
Peru,Chile,1982,1,0,1
Bahrain,Qatar,1982,1,0,1
Saudi Arabia,Oman,1982,3,0,3
Nepal,Bhutan,1982,3,1,4
Bahrain,Saudi Arabia,1982,2,2,4
United Arab Emirates,Oman,1982,3,1,4
Kuwait,Qatar,1982,1,2,3
India,Thailand,1982,1,1,2
Argentina,Russia,1982,1,1,2
Bulgaria,Romania,1982,1,2,3
German DR,Italy,1982,1,0,1
Germany,Czechoslovakia,1982,2,1,3
Netherlands,Greece,1982,1,0,1
El Salvador,Honduras,1982,3,2,5
Hungary,Peru,1982,1,2,3
Nepal,Thailand,1982,1,0,1
Honduras,El Salvador,1982,1,1,2
Algeria,Peru,1982,1,1,2
Wales,England,1982,0,1,1
Algeria,Republic of Ireland,1982,2,0,2
Austria,Czechoslovakia,1982,2,1,3
Belgium,Bulgaria,1982,2,1,3
France,Peru,1982,0,1,1
Northern Ireland,Scotland,1982,1,1,2
Norway,Finland,1982,1,1,2
Spain,Switzerland,1982,2,0,2
Cameroon,Senegal,1982,2,1,3
Romania,Cyprus,1982,3,1,4
Thailand,Singapore,1982,1,1,2
Cameroon,Guinea,1982,1,1,2
Ghana,Senegal,1982,0,0,0
Argentina,Bulgaria,1982,2,1,3
Brazil,Portugal,1982,3,1,4
Cameroon,Ghana,1982,0,0,0
Denmark,Sweden,1982,1,1,2
Guinea,Senegal,1982,1,1,2
South Korea,Malaysia,1982,5,0,5
Nepal,Singapore,1982,0,2,2
Russia,German DR,1982,1,0,1
Philippines,Singapore,1982,0,1,1
Ghana,Guinea,1982,0,0,0
Trinidad and Tobago,Bermuda,1982,2,2,4
Macau,Hong Kong,1982,1,0,1
Thailand,South Korea,1982,0,3,3
Argentina,Romania,1982,1,0,1
Morocco,Senegal,1982,2,1,3
Norway,Germany,1982,2,4,6
Trinidad and Tobago,Bermuda,1982,4,2,6
Thailand,Singapore,1982,1,0,1
Barbados,Bermuda,1982,2,1,3
Thailand,Singapore,1982,2,2,4
Barbados,Bermuda,1982,0,0,0
Thailand,South Korea,1982,0,0,0
Austria,Denmark,1982,1,0,1
Brazil,Switzerland,1982,1,1,2
Sweden,German DR,1982,2,2,4
Chile,Republic of Ireland,1982,1,0,1
Scotland,Wales,1982,1,0,1
England,Netherlands,1982,2,0,2
Brazil,Republic of Ireland,1982,7,0,7
Denmark,Belgium,1982,1,0,1
Wales,Northern Ireland,1982,3,0,3
Switzerland,Italy,1982,1,1,2
Scotland,England,1982,0,1,1
Trinidad and Tobago,Republic of Ireland,1982,2,1,3
France,Wales,1982,0,1,1
Iceland,England,1982,1,1,2
Japan,Singapore,1982,2,0,2
Finland,England,1982,1,4,5
Sweden,Russia,1982,1,1,2
Malta,Iceland,1982,2,1,3
Liechtenstein,China PR,1982,2,0,2
Zimbabwe,Uganda,1982,2,1,3
South Korea,India,1982,1,0,1
Malaysia,Thailand,1982,1,1,2
South Korea,Bahrain,1982,3,0,3
Argentina,Belgium,1982,0,1,1
Bahrain,India,1982,0,0,0
Zimbabwe,Uganda,1982,1,1,2
Brazil,Russia,1982,2,1,3
Italy,Poland,1982,0,0,0
Hungary,El Salvador,1982,10,1,11
Norway,Denmark,1982,2,1,3
Peru,Cameroon,1982,0,0,0
Scotland,New Zealand,1982,5,2,7
England,France,1982,3,1,4
Germany,Algeria,1982,1,2,3
Spain,Honduras,1982,1,1,2
Chile,Austria,1982,0,1,1
Czechoslovakia,Kuwait,1982,1,1,2
Yugoslavia,Northern Ireland,1982,0,0,0
Argentina,Hungary,1982,4,1,5
Brazil,Scotland,1982,4,1,5
Italy,Peru,1982,1,1,2
Belgium,El Salvador,1982,1,0,1
Poland,Cameroon,1982,0,0,0
Russia,New Zealand,1982,3,0,3
England,Czechoslovakia,1982,2,0,2
Germany,Chile,1982,4,1,5
Spain,Yugoslavia,1982,2,1,3
Algeria,Austria,1982,0,2,2
France,Kuwait,1982,4,1,5
Honduras,Northern Ireland,1982,1,1,2
Belgium,Hungary,1982,1,1,2
Poland,Peru,1982,5,1,6
Russia,Scotland,1982,2,2,4
Tunisia,China PR,1982,1,0,1
Argentina,El Salvador,1982,2,0,2
Brazil,New Zealand,1982,4,0,4
Italy,Cameroon,1982,1,1,2
Algeria,Chile,1982,3,2,5
France,Czechoslovakia,1982,1,1,2
Honduras,Yugoslavia,1982,0,1,1
England,Kuwait,1982,1,0,1
Germany,Austria,1982,1,0,1
Spain,Northern Ireland,1982,0,1,1
Tunisia,China PR,1982,1,2,3
Mozambique,Zimbabwe,1982,1,1,2
Trinidad and Tobago,Suriname,1982,2,3,5
Austria,France,1982,0,1,1
Poland,Belgium,1982,3,0,3
Germany,England,1982,0,0,0
Italy,Argentina,1982,2,1,3
Austria,Northern Ireland,1982,2,2,4
Belgium,Russia,1982,0,1,1
Argentina,Brazil,1982,1,3,4
Spain,Germany,1982,1,2,3
France,Northern Ireland,1982,4,1,5
Poland,Russia,1982,0,0,0
Italy,Brazil,1982,3,2,5
Spain,England,1982,0,0,0
Malawi,Tanzania,1982,0,1,1
Germany,France,1982,3,3,6
Malawi,Tanzania,1982,2,0,2
Poland,Italy,1982,0,2,2
Poland,France,1982,3,2,5
Finland,Iceland,1982,3,2,5
Italy,Germany,1982,3,1,4
China PR,Hong Kong,1982,2,0,2
China PR,Morocco,1982,3,3,6
Hong Kong,Morocco,1982,0,0,0
Zimbabwe,Réunion,1982,2,3,5
Faroe Islands,Iceland,1982,1,4,5
Faroe Islands,Iceland,1982,0,4,4
Malaysia,Indonesia,1982,0,2,2
India,Thailand,1982,0,0,0
South Korea,Senegal,1982,0,2,2
Singapore,Ghana,1982,0,3,3
Malaysia,United Arab Emirates,1982,1,0,1
South Korea,Indonesia,1982,4,0,4
Ghana,India,1982,1,0,1
Malaysia,Pakistan,1982,4,1,5
Senegal,United Arab Emirates,1982,3,1,4
Malaysia,South Korea,1982,1,2,3
Denmark,Finland,1982,3,2,5
Indonesia,Senegal,1982,2,2,4
Norway,Sweden,1982,1,0,1
Thailand,Ghana,1982,1,4,5
Singapore,India,1982,3,0,3
South Korea,United Arab Emirates,1982,3,2,5
Malaysia,Senegal,1982,1,0,1
Singapore,Thailand,1982,2,0,2
Indonesia,United Arab Emirates,1982,1,2,3
Ghana,Senegal,1982,2,2,4
Mauritius,Zimbabwe,1982,2,0,2
Burundi,Rwanda,1982,1,0,1
France,Poland,1982,0,4,4
Iceland,Netherlands,1982,1,1,2
Réunion,Zimbabwe,1982,0,1,1
Romania,Denmark,1982,1,0,1
Réunion,Mauritius,1982,1,1,2
Switzerland,Bulgaria,1982,3,2,5
Finland,Poland,1982,2,3,5
Iceland,German DR,1982,0,1,1
Romania,Sweden,1982,2,0,2
Malawi,Zimbabwe,1982,2,0,2
Tanzania,Uganda,1982,1,1,2
Somalia,Rwanda,1982,0,1,1
Austria,Albania,1982,5,0,5
Bulgaria,German DR,1982,2,2,4
Denmark,England,1982,2,2,4
Finland,Portugal,1982,0,2,2
Germany,Belgium,1982,0,0,0
Hungary,Turkey,1982,5,0,5
Netherlands,Republic of Ireland,1982,2,1,3
Wales,Norway,1982,1,0,1
Uganda,Tanzania,1982,3,2,5
Egypt,Zambia,1982,3,5,8
Burkina Faso,Niger,1982,1,1,2
Egypt,Zambia,1982,0,0,0
Saudi Arabia,Morocco,1982,2,1,3
Zimbabwe,Malawi,1982,0,2,2
Singapore,Malaysia,1982,0,1,1
Belgium,Switzerland,1982,3,0,3
Czechoslovakia,Sweden,1982,2,2,4
France,Hungary,1982,1,0,1
Singapore,Brunei,1982,7,0,7
Luxembourg,Greece,1982,0,2,2
Brunei,Malaysia,1982,0,4,4
Portugal,Poland,1982,2,1,3
Australia,Indonesia,1982,2,0,2
Saudi Arabia,Cameroon,1982,0,0,0
Austria,Northern Ireland,1982,2,0,2
England,Germany,1982,1,2,3
Republic of Ireland,Iceland,1982,2,0,2
Norway,Yugoslavia,1982,3,1,4
Russia,Finland,1982,2,0,2
Scotland,German DR,1982,2,0,2
Gabon,Angola,1982,2,2,4
Australia,Malaysia,1982,5,0,5
Bulgaria,Malta,1982,7,0,7
Indonesia,Malaysia,1982,0,0,0
Bulgaria,Norway,1982,2,2,4
Cyprus,Greece,1982,1,1,2
Denmark,Czechoslovakia,1982,1,3,4
Italy,Switzerland,1982,0,1,1
Senegal,Togo,1982,1,2,3
Spain,Iceland,1982,1,0,1
Turkey,Albania,1982,1,0,1
Liberia,Sierra Leone,1982,1,0,1
Togo,Benin,1982,2,2,4
Luxembourg,Denmark,1982,1,2,3
Netherlands,France,1982,1,2,3
Singapore,Malaysia,1982,3,1,4
Angola,Ghana,1982,1,2,3
Cyprus,Sweden,1982,0,1,1
Italy,Czechoslovakia,1982,2,2,4
Kuwait,Norway,1982,1,0,1
Uganda,Malawi,1982,2,1,3
Kenya,Sudan,1982,2,0,2
Angola,Gabon,1982,4,0,4
Mali,Gambia,1982,3,1,4
Niger,Senegal,1982,0,0,0
Tanzania,Zimbabwe,1982,0,3,3
Togo,Sierra Leone,1982,3,0,3
Malawi,Zimbabwe,1982,1,1,2
Austria,Turkey,1982,4,0,4
Bulgaria,Yugoslavia,1982,0,1,1
German DR,Romania,1982,4,1,5
Greece,England,1982,0,3,3
Republic of Ireland,Spain,1982,3,3,6
Northern Ireland,Germany,1982,1,0,1
Switzerland,Scotland,1982,2,0,2
Uganda,Tanzania,1982,1,0,1
Sudan,Zanzibar,1982,0,1,1
Malawi,Tanzania,1982,2,0,2
Uganda,Zimbabwe,1982,1,1,2
Kenya,Zanzibar,1982,2,2,4
Kenya,Zimbabwe,1982,2,1,3
Uganda,Zanzibar,1982,3,0,3
Zanzibar,Zimbabwe,1982,0,3,3
Uganda,Kenya,1982,1,1,2
Gambia,Mali,1982,1,0,1
Senegal,Niger,1982,1,0,1
Sierra Leone,Togo,1982,0,1,1
Greece,Switzerland,1982,1,3,4
Italy,Romania,1982,0,0,0
Tunisia,Angola,1982,3,1,4
Albania,Northern Ireland,1982,0,0,0
Belgium,Scotland,1982,3,2,5
England,Luxembourg,1982,9,0,9
Yugoslavia,Wales,1982,4,4,8
Malta,Netherlands,1982,0,6,6
Tunisia,Algeria,1982,0,1,1
Greece,Cyprus,1982,1,0,1
Bermuda,Trinidad and Tobago,1982,2,2,4
Malta,Bulgaria,1982,0,0,0
Malta,Bulgaria,1982,1,7,8
Bermuda,Trinidad and Tobago,1982,2,2,4
Ivory Coast,Mali,1983,0,1,1
Benin,Mauritania,1983,1,1,2
Egypt,Hungary,1983,1,0,1
Egypt,Hungary,1983,0,2,2
Niger,Senegal,1983,2,0,2
Turkey,Romania,1983,1,1,2
Malta,Tunisia,1983,1,2,3
Senegal,Guinea,1983,1,0,1
Greece,Romania,1983,1,3,4
Mauritania,Benin,1983,2,0,2
Senegal,Niger,1983,2,0,2
Sierra Leone,Gambia,1983,0,1,1
Tunisia,German DR,1983,1,0,1
Tunisia,German DR,1983,0,2,2
Cyprus,Italy,1983,1,1,2
Syria,Japan,1983,2,2,4
Guinea,Mali,1983,1,1,2
Portugal,France,1983,0,3,3
Spain,Netherlands,1983,1,0,1
Nigeria,Egypt,1983,0,0,0
Gambia,Sierra Leone,1983,0,1,1
Guadeloupe,Dominica,1983,1,0,1
Nigeria,Egypt,1983,1,1,2
Saint Vincent and the Grenadines,Martinique,1983,1,3,4
New Zealand,Australia,1983,2,1,3
Cameroon,Egypt,1983,2,0,2
England,Wales,1983,2,1,3
German DR,Greece,1983,2,1,3
Ivory Coast,Guinea,1983,3,2,5
Portugal,Germany,1983,1,0,1
Cameroon,Egypt,1983,1,1,2
Australia,New Zealand,1983,0,2,2
Mali,Guinea,1983,1,1,2
Gabon,Nigeria,1983,0,0,0
Barbados,Suriname,1983,1,0,1
Dominica,Guadeloupe,1983,1,2,3
Japan,South Korea,1983,1,1,2
Barbados,Suriname,1983,0,0,0
Romania,Turkey,1983,3,1,4
Senegal,Morocco,1983,1,0,1
Senegal,Morocco,1983,0,0,0
Costa Rica,Mexico,1983,0,1,1
German DR,Finland,1983,3,1,4
Gabon,Congo,1983,2,3,5
Benin,Congo,1983,0,2,2
Ethiopia,Kenya,1983,2,2,4
Ethiopia,Kenya,1983,0,0,0
Mexico,Costa Rica,1983,1,0,1
France,Russia,1983,1,1,2
Poland,Bulgaria,1983,3,1,4
Tunisia,Morocco,1983,1,0,1
Togo,Congo,1983,0,2,2
Cyprus,Czechoslovakia,1983,1,1,2
Ethiopia,Djibouti,1983,8,1,9
Luxembourg,Hungary,1983,2,6,8
Ethiopia,Djibouti,1983,4,2,6
Albania,Germany,1983,1,2,3
Benin,Togo,1983,0,2,2
England,Greece,1983,0,0,0
German DR,Belgium,1983,1,2,3
Malta,Republic of Ireland,1983,0,1,1
Northern Ireland,Turkey,1983,2,1,3
Romania,Yugoslavia,1983,0,2,2
Scotland,Switzerland,1983,2,2,4
Ethiopia,Uganda,1983,0,1,1
Guadeloupe,Antigua and Barbuda,1983,2,3,5
Congo,Angola,1983,1,0,1
Ethiopia,Uganda,1983,2,1,3
Mozambique,Cameroon,1983,3,0,3
Guatemala,Mexico,1983,0,2,2
Algeria,Benin,1983,6,2,8
Haiti,United States,1983,0,2,2
Libya,Senegal,1983,2,1,3
Nigeria,Angola,1983,2,0,2
Congo,Egypt,1983,2,0,2
Ethiopia,Mauritius,1983,1,0,1
Guinea,Togo,1983,0,1,1
Madagascar,Uganda,1983,1,0,1
Morocco,Mali,1983,4,0,4
Sudan,Zambia,1983,2,1,3
Tunisia,Rwanda,1983,5,0,5
German DR,Bulgaria,1983,3,0,3
Portugal,Hungary,1983,0,0,0
Switzerland,Russia,1983,0,1,1
Czechoslovakia,Cyprus,1983,6,0,6
Romania,Italy,1983,1,0,1
Guinea-Bissau,Togo,1983,2,0,2
Hungary,Luxembourg,1983,6,2,8
Mali,Ivory Coast,1983,1,2,3
Poland,Finland,1983,1,1,2
Sierra Leone,Jordan,1983,2,1,3
Egypt,Congo,1983,2,0,2
France,Yugoslavia,1983,4,0,4
Turkey,Germany,1983,0,3,3
Angola,Nigeria,1983,1,0,1
Barbados,Guyana,1983,1,1,2
Cameroon,Mozambique,1983,4,0,4
Mali,Morocco,1983,2,0,2
Mauritius,Ethiopia,1983,1,0,1
Rwanda,Tunisia,1983,0,1,1
Senegal,Libya,1983,1,0,1
Togo,Guinea,1983,2,0,2
Uganda,Madagascar,1983,1,2,3
Zambia,Sudan,1983,0,0,0
Benin,Algeria,1983,6,2,8
Austria,Germany,1983,0,0,0
Belgium,German DR,1983,2,1,3
Denmark,Greece,1983,1,0,1
England,Hungary,1983,2,0,2
Netherlands,Sweden,1983,0,3,3
Northern Ireland,Albania,1983,1,0,1
Russia,Portugal,1983,5,0,5
Spain,Republic of Ireland,1983,2,0,2
Wales,Bulgaria,1983,1,0,1
Brazil,Chile,1983,3,2,5
Ghana,Libya,1983,1,0,1
Iraq,Egypt,1983,2,1,3
Ethiopia,Nigeria,1983,0,1,1
Ethiopia,Libya,1983,1,0,1
Ghana,Nigeria,1983,1,0,1
Guinea,Guinea-Bissau,1983,3,0,3
Ethiopia,Libya,1983,0,1,1
Guatemala,Honduras,1983,0,2,2
Indonesia,Taiwan,1983,0,2,2
Antigua and Barbuda,Guadeloupe,1983,3,3,6
Guyana,Barbados,1983,2,0,2
Togo,Guinea-Bissau,1983,3,0,3
Albania,Turkey,1983,1,1,2
Chile,Argentina,1983,2,2,4
Switzerland,German DR,1983,0,0,0
Hungary,Greece,1983,2,3,5
Malta,Spain,1983,2,3,5
Romania,Czechoslovakia,1983,0,1,1
Sweden,Cyprus,1983,5,0,5
Austria,Russia,1983,2,2,4
Poland,Russia,1983,1,1,2
Kenya,Madagascar,1983,1,2,3
Scotland,Northern Ireland,1983,0,0,0
Martinique,Saint Kitts and Nevis,1983,7,0,7
Northern Ireland,England,1983,0,0,0
Wales,Scotland,1983,0,2,2
Egypt,Cameroon,1983,4,0,4
Guyana,Antigua and Barbuda,1983,0,0,0
Iceland,Spain,1983,0,1,1
Sweden,Italy,1983,2,0,2
Belgium,France,1983,1,1,2
Northern Ireland,Wales,1983,0,1,1
Denmark,Hungary,1983,3,1,4
England,Scotland,1983,2,0,2
Finland,Russia,1983,0,1,1
Yugoslavia,Romania,1983,1,0,1
Paraguay,Uruguay,1983,0,0,0
Nigeria,Thailand,1983,0,0,0
Antigua and Barbuda,Guyana,1983,4,0,4
Iceland,Malta,1983,1,0,1
Saint Kitts and Nevis,Martinique,1983,0,5,5
South Korea,Thailand,1983,4,0,4
Germany,Yugoslavia,1983,4,2,6
Ghana,New Zealand,1983,0,2,2
Japan,Syria,1983,1,0,1
Albania,Austria,1983,1,2,3
Indonesia,Thailand,1983,0,3,3
South Korea,Nigeria,1983,1,0,1
Portugal,Brazil,1983,0,4,4
New Zealand,Sudan,1983,1,1,2
Sweden,Romania,1983,0,1,1
Uruguay,Paraguay,1983,3,0,3
Indonesia,Nigeria,1983,1,2,3
Australia,England,1983,0,0,0
Canada,Scotland,1983,0,2,2
South Korea,Indonesia,1983,3,0,3
Wales,Brazil,1983,1,1,2
Ghana,Sudan,1983,3,1,4
Australia,England,1983,0,1,1
South Korea,Ghana,1983,1,0,1
Canada,Scotland,1983,0,3,3
Malawi,Mozambique,1983,2,0,2
Switzerland,Brazil,1983,1,2,3
Malawi,Mozambique,1983,0,0,0
Australia,England,1983,1,1,2
Réunion,Seychelles,1983,2,1,3
Sweden,Brazil,1983,3,3,6
Argentina,Chile,1983,1,0,1
Réunion,Seychelles,1983,0,0,0
Niger,Mauritania,1983,1,0,1
Greenland,Faroe Islands,1983,0,0,0
Hong Kong,Macau,1983,1,0,1
Ethiopia,Togo,1983,2,1,3
Gambia,Mali,1983,1,1,2
Greenland,Faroe Islands,1983,2,3,5
Seychelles,Mauritius,1983,1,2,3
Malawi,Zimbabwe,1983,0,0,0
Malawi,Zimbabwe,1983,1,0,1
Qatar,Sudan,1983,3,1,4
Madagascar,Mauritius,1983,1,1,2
Qatar,Sudan,1983,2,0,2
Réunion,Madagascar,1983,0,3,3
Colombia,Chile,1983,2,2,4
Mauritania,Niger,1983,0,0,0
Paraguay,Argentina,1983,1,0,1
Réunion,Mauritius,1983,1,1,2
Hong Kong,Thailand,1983,1,1,2
Uruguay,Peru,1983,1,1,2
Bolivia,Chile,1983,1,2,3
China PR,Thailand,1983,2,1,3
Guinea-Bissau,Senegal,1983,1,1,2
Mauritania,Cape Verde,1983,2,0,2
Argentina,Paraguay,1983,0,0,0
Gambia,Guinea,1983,4,1,5
Peru,Chile,1983,0,1,1
Cape Verde,Mali,1983,1,0,1
Guinea-Bissau,Guinea,1983,2,1,3
Antigua and Barbuda,Martinique,1983,0,2,2
French Guiana,Trinidad and Tobago,1983,0,1,1
Gambia,Senegal,1983,1,2,3
Guinea,Senegal,1983,1,1,2
Mauritania,Mali,1983,0,2,2
Paraguay,Chile,1983,1,0,1
French Guiana,Antigua and Barbuda,1983,1,0,1
Gambia,Guinea-Bissau,1983,2,2,4
Martinique,Trinidad and Tobago,1983,3,1,4
Ecuador,Colombia,1983,0,0,0
El Salvador,Guatemala,1983,0,0,0
German DR,Russia,1983,1,3,4
Antigua and Barbuda,Trinidad and Tobago,1983,1,2,3
French Guiana,Martinique,1983,0,0,0
Mali,Senegal,1983,1,2,3
Mauritania,Guinea-Bissau,1983,1,2,3
Panama,Cuba,1983,0,0,0
Chile,Brazil,1983,0,0,0
Mauritania,Mali,1983,0,2,2
Colombia,Ecuador,1983,0,0,0
Guatemala,South Korea,1983,1,1,2
Guinea-Bissau,Senegal,1983,0,3,3
Panama,Cuba,1983,1,0,1
Congo,Cameroon,1983,2,2,4
Costa Rica,Cuba,1983,3,0,3
Bolivia,Paraguay,1983,2,1,3
Chile,Peru,1983,2,0,2
Guatemala,South Korea,1983,2,1,3
Costa Rica,Cuba,1983,2,0,2
Bolivia,Paraguay,1983,1,3,4
Algeria,Bulgaria,1983,2,3,5
Vanuatu,Tahiti,1983,1,5,6
Iceland,Faroe Islands,1983,6,0,6
Costa Rica,South Korea,1983,1,1,2
Ecuador,Argentina,1983,2,2,4
Norway,Romania,1983,0,0,0
Peru,Uruguay,1983,1,1,2
Vanuatu,Tahiti,1983,1,6,7
Mauritania,Togo,1983,0,4,4
Senegal,Algeria,1983,1,1,2
Bolivia,Colombia,1983,0,1,1
Cameroon,Sudan,1983,5,0,5
Egypt,Tunisia,1983,1,0,1
Madagascar,Malawi,1983,0,1,1
Nigeria,Morocco,1983,0,0,0
Vanuatu,Tahiti,1983,1,1,2
Fiji,New Zealand,1983,2,0,2
Chile,Paraguay,1983,3,2,5
Ecuador,Brazil,1983,0,1,1
Iceland,Sweden,1983,0,4,4
Peru,Colombia,1983,1,0,1
Fiji,New Zealand,1983,0,1,1
Greece,Libya,1983,3,2,5
Niue,Tahiti,1983,0,14,14
Tonga,Wallis Islands and Futuna,1983,0,3,3
Samoa,American Samoa,1983,3,1,4
Bolivia,Peru,1983,1,1,2
American Samoa,Wallis Islands and Futuna,1983,3,0,3
Niue,Papua New Guinea,1983,0,19,19
Samoa,Tonga,1983,3,3,6
Fiji,Solomon Islands,1983,10,0,10
American Samoa,Tonga,1983,2,3,5
Argentina,Brazil,1983,1,0,1
Chile,Bolivia,1983,4,2,6
Romania,German DR,1983,1,0,1
Samoa,Wallis Islands and Futuna,1983,1,2,3
Turkey,Libya,1983,0,0,0
Papua New Guinea,Tahiti,1983,1,2,3
Algeria,Ivory Coast,1983,3,0,3
Uruguay,Paraguay,1983,0,0,0
Fiji,Vanuatu,1983,6,0,6
Algeria,Senegal,1983,2,0,2
Colombia,Peru,1983,2,2,4
Malawi,Madagascar,1983,1,1,2
Morocco,Nigeria,1983,0,0,0
Sudan,Cameroon,1983,2,0,2
Togo,Ethiopia,1983,3,0,3
Tunisia,Egypt,1983,0,0,0
Libya,Zimbabwe,1983,3,1,4
Colombia,Bolivia,1983,2,2,4
Greece,Bulgaria,1983,2,3,5
Brazil,Ecuador,1983,5,0,5
Uruguay,Chile,1983,2,1,3
Malaysia,Singapore,1983,0,0,0
Peru,Bolivia,1983,2,1,3
Uruguay,Venezuela,1983,3,0,3
Argentina,Ecuador,1983,2,2,4
Denmark,France,1983,3,1,4
Finland,Sweden,1983,0,3,3
Hungary,Germany,1983,1,1,2
Netherlands,Iceland,1983,3,0,3
Norway,Bulgaria,1983,1,2,3
Poland,Romania,1983,2,2,4
Switzerland,Czechoslovakia,1983,0,0,0
Chile,Venezuela,1983,5,0,5
Singapore,Malaysia,1983,0,1,1
Chile,Uruguay,1983,2,0,2
New Caledonia,Vanuatu,1983,6,2,8
New Caledonia,Solomon Islands,1983,1,0,1
Fiji,New Caledonia,1983,5,1,6
Brazil,Argentina,1983,0,0,0
Fiji,New Caledonia,1983,3,2,5
Fiji,Papua New Guinea,1983,2,0,2
New Caledonia,Wallis Islands and Futuna,1983,4,0,4
Papua New Guinea,Tahiti,1983,1,6,7
Samoa,Tahiti,1983,0,2,2
Fiji,Tahiti,1983,0,1,1
New Caledonia,Papua New Guinea,1983,2,1,3
Venezuela,Uruguay,1983,1,2,3
Ghana,Thailand,1983,2,1,3
Malaysia,Nepal,1983,7,0,7
Belgium,Netherlands,1983,1,1,2
England,Denmark,1983,0,1,1
Iceland,Republic of Ireland,1983,0,3,3
Northern Ireland,Austria,1983,3,1,4
Norway,Wales,1983,0,0,0
Portugal,Finland,1983,5,0,5
Scotland,Uruguay,1983,2,0,2
Sweden,Czechoslovakia,1983,1,0,1
Venezuela,Chile,1983,0,0,0
Bangladesh,Nepal,1983,1,0,1
Ivory Coast,Liberia,1983,0,0,0
Israel,Uruguay,1983,2,2,4
Ghana,Togo,1983,1,1,2
Ghana,Liberia,1983,1,0,1
Ivory Coast,Togo,1983,3,0,3
Malaysia,Bangladesh,1983,1,0,1
Ivory Coast,Ghana,1983,0,2,2
Liberia,Togo,1983,0,4,4
Ghana,Togo,1983,3,1,4
Ivory Coast,Liberia,1983,2,1,3
France,Spain,1983,1,1,2
Germany,Austria,1983,3,0,3
Italy,Greece,1983,3,0,3
Peru,Paraguay,1983,0,2,2
Paraguay,Peru,1983,4,1,5
Sierra Leone,Mali,1983,1,0,1
Libya,Malta,1983,4,0,4
Russia,Poland,1983,2,0,2
Denmark,Luxembourg,1983,6,0,6
German DR,Switzerland,1983,3,0,3
Hungary,England,1983,0,3,3
Republic of Ireland,Netherlands,1983,2,3,5
Scotland,Belgium,1983,1,1,2
Turkey,Northern Ireland,1983,1,0,1
Wales,Romania,1983,5,0,5
Yugoslavia,Norway,1983,2,1,3
Paraguay,Brazil,1983,1,1,2
Peru,Uruguay,1983,0,1,1
Italy,Sweden,1983,0,3,3
Brazil,Paraguay,1983,0,0,0
Uruguay,Peru,1983,1,1,2
Tanzania,Malawi,1983,1,1,2
Tanzania,Malawi,1983,0,0,0
El Salvador,Mexico,1983,0,5,5
Czechoslovakia,Bulgaria,1983,1,2,3
Germany,Turkey,1983,5,1,6
Hungary,Denmark,1983,1,0,1
Switzerland,Yugoslavia,1983,2,0,2
Zanzibar,Malawi,1983,0,1,1
Uruguay,Brazil,1983,2,0,2
Poland,Portugal,1983,0,1,1
Tanzania,Malawi,1983,1,0,1
Brazil,Uruguay,1983,1,1,2
Israel,Romania,1983,1,1,2
Switzerland,Belgium,1983,3,1,4
Cyprus,Romania,1983,0,1,1
Kenya,Uganda,1983,2,1,3
Yugoslavia,France,1983,0,0,0
Ethiopia,Tanzania,1983,1,1,2
Malawi,Zimbabwe,1983,0,1,1
Niger,Mali,1983,1,1,2
Portugal,Russia,1983,1,0,1
Niger,Mali,1983,1,1,2
Somalia,Zanzibar,1983,1,1,2
Sudan,Uganda,1983,1,2,3
Kenya,Ethiopia,1983,2,0,2
Nigeria,Senegal,1983,1,0,1
Bulgaria,Wales,1983,1,0,1
Czechoslovakia,Italy,1983,2,0,2
German DR,Scotland,1983,2,1,3
Germany,Northern Ireland,1983,0,1,1
Greece,Denmark,1983,0,2,2
Republic of Ireland,Malta,1983,8,0,8
Luxembourg,England,1983,0,4,4
Netherlands,Spain,1983,2,1,3
Sudan,Tanzania,1983,1,0,1
Trinidad and Tobago,Sweden,1983,0,5,5
Turkey,Austria,1983,3,1,4
Zanzibar,Zimbabwe,1983,1,2,3
Ethiopia,Uganda,1983,1,2,3
Malawi,Somalia,1983,2,1,3
Kenya,Tanzania,1983,0,0,0
Barbados,Sweden,1983,0,4,4
Ethiopia,Sudan,1983,0,2,2
Senegal,Nigeria,1983,0,1,1
Somalia,Zimbabwe,1983,1,2,3
Germany,Albania,1983,2,1,3
Malawi,Zanzibar,1983,3,1,4
Sri Lanka,Singapore,1983,0,4,4
Tanzania,Uganda,1983,1,1,2
Kenya,Sudan,1983,1,0,1
Mexico,Sweden,1983,2,0,2
Kenya,Malawi,1983,2,0,2
Uganda,Zimbabwe,1983,0,1,1
Malawi,Uganda,1983,1,2,3
Kenya,Zimbabwe,1983,1,0,1
Martinique,Mexico,1983,4,4,8
Algeria,Switzerland,1983,1,2,3
Czechoslovakia,Romania,1983,1,1,2
Ivory Coast,Switzerland,1983,1,0,1
Greece,Hungary,1983,2,2,4
Australia,China PR,1983,1,2,3
Zimbabwe,Switzerland,1983,3,2,5
Kenya,Switzerland,1983,0,0,0
Mexico,Canada,1983,5,0,5
Belize,Canada,1983,0,2,2
Kenya,Ethiopia,1983,2,2,4
Kenya,Ethiopia,1983,1,0,1
Honduras,Canada,1983,3,1,4
Singapore,Brunei,1983,4,0,4
Kenya,Ethiopia,1983,2,1,3
Northern Ireland,Scotland,1983,2,0,2
Greece,Luxembourg,1983,1,0,1
Honduras,Canada,1983,1,0,1
Singapore,China PR,1983,1,0,1
Wales,Yugoslavia,1983,1,1,2
Ivory Coast,Mali,1983,1,1,2
Nigeria,Togo,1983,2,5,7
Netherlands,Malta,1983,5,0,5
Singapore,Australia,1983,2,4,6
Ivory Coast,Togo,1983,2,1,3
Mali,Nigeria,1983,0,0,0
Ivory Coast,Togo,1983,1,0,1
Spain,Malta,1983,12,1,13
Yugoslavia,Bulgaria,1983,3,2,5
Italy,Cyprus,1983,3,1,4
Gambia,Senegal,1984,2,2,4
Mauritania,Sierra Leone,1984,0,1,1
Gambia,Sierra Leone,1984,1,0,1
Mauritania,Senegal,1984,0,2,2
Ivory Coast,Sierra Leone,1984,1,0,1
India,Poland,1984,1,2,3
India,Argentina,1984,0,1,1
China PR,Poland,1984,0,1,1
Ivory Coast,Morocco,1984,3,3,6
Argentina,Poland,1984,1,1,2
Gambia,Guinea,1984,1,0,1
Senegal,Guinea,1984,1,0,1
Spain,Hungary,1984,0,1,1
Argentina,China PR,1984,0,1,1
Egypt,Turkey,1984,1,0,1
Egypt,Turkey,1984,0,1,1
Ivory Coast,Guinea,1984,3,0,3
India,China PR,1984,0,3,3
China PR,Poland,1984,0,1,1
Gambia,Ghana,1984,0,1,1
Ivory Coast,Mali,1984,4,1,5
Liberia,Senegal,1984,0,0,0
Guinea,Ghana,1984,1,2,3
Ivory Coast,Senegal,1984,1,0,1
Liberia,Mali,1984,2,2,4
Ivory Coast,Liberia,1984,4,1,5
Mali,Senegal,1984,1,1,2
Italy,Mexico,1984,5,0,5
Ivory Coast,Senegal,1984,4,3,7
Liberia,Mali,1984,0,1,1
Morocco,Bulgaria,1984,1,1,2
Algeria,Romania,1984,1,1,2
Congo,Ivory Coast,1984,2,3,5
Gambia,Guinea,1984,2,2,4
Sierra Leone,Cape Verde,1984,2,0,2
Guinea-Bissau,Senegal,1984,2,3,5
Mali,Mauritania,1984,1,0,1
Cape Verde,Guinea,1984,1,1,2
Sierra Leone,Gambia,1984,1,0,1
Guinea-Bissau,Mauritania,1984,2,1,3
Mali,Senegal,1984,1,0,1
Cape Verde,Gambia,1984,0,2,2
Malawi,Zambia,1984,1,0,1
Sierra Leone,Guinea,1984,0,0,0
Guinea-Bissau,Mali,1984,1,0,1
Mauritania,Senegal,1984,0,6,6
Bulgaria,Germany,1984,2,3,5
Gambia,Senegal,1984,0,1,1
Greece,German DR,1984,1,3,4
Malawi,Zambia,1984,0,0,0
Togo,Ghana,1984,2,1,3
Sierra Leone,Mali,1984,0,0,0
Gambia,Mali,1984,0,2,2
Gabon,Togo,1984,1,1,2
Sierra Leone,Senegal,1984,0,0,0
Saudi Arabia,Algeria,1984,4,2,6
Peru,Honduras,1984,1,3,4
Egypt,Iraq,1984,1,2,3
Scotland,Wales,1984,2,1,3
Belgium,Germany,1984,0,1,1
Egypt,Iraq,1984,0,0,0
France,England,1984,2,0,2
Luxembourg,Spain,1984,0,1,1
Turkey,Italy,1984,1,2,3
Cameroon,Egypt,1984,0,1,1
Ivory Coast,Togo,1984,3,0,3
Algeria,Malawi,1984,3,0,3
Ghana,Nigeria,1984,1,2,3
Brunei,Japan,1984,1,7,8
Cameroon,Togo,1984,4,1,5
Ivory Coast,Egypt,1984,1,2,3
Romania,Greece,1984,2,0,2
Algeria,Ghana,1984,2,0,2
Malawi,Nigeria,1984,2,2,4
Kuwait,Finland,1984,1,0,1
Oman,Bahrain,1984,0,1,1
Egypt,Togo,1984,0,0,0
Ivory Coast,Cameroon,1984,0,2,2
Kuwait,United Arab Emirates,1984,0,2,2
Saudi Arabia,Qatar,1984,1,2,3
Algeria,Nigeria,1984,0,0,0
Ghana,Malawi,1984,1,0,1
Luxembourg,Turkey,1984,1,3,4
Oman,Iraq,1984,1,2,3
Bahrain,Kuwait,1984,0,1,1
Panama,Cuba,1984,1,1,2
Qatar,United Arab Emirates,1984,0,1,1
Algeria,Cameroon,1984,0,0,0
Egypt,Nigeria,1984,2,2,4
Netherlands,Denmark,1984,6,0,6
Iraq,United Arab Emirates,1984,0,0,0
Oman,Saudi Arabia,1984,1,3,4
Kuwait,Qatar,1984,1,2,3
Algeria,Egypt,1984,3,1,4
Iraq,Saudi Arabia,1984,4,0,4
Bahrain,United Arab Emirates,1984,1,1,2
Cameroon,Nigeria,1984,3,1,4
Oman,Qatar,1984,0,2,2
Panama,Cuba,1984,0,1,1
Bahrain,Iraq,1984,0,1,1
Saudi Arabia,Kuwait,1984,1,1,2
Oman,United Arab Emirates,1984,1,1,2
Bahrain,Qatar,1984,1,1,2
Iraq,Kuwait,1984,3,1,4
Djibouti,Ethiopia,1984,0,2,2
Saudi Arabia,United Arab Emirates,1984,2,0,2
Panama,Costa Rica,1984,1,1,2
Iraq,Qatar,1984,1,2,3
Oman,Kuwait,1984,0,0,0
Bahrain,Saudi Arabia,1984,0,2,2
Switzerland,Poland,1984,1,1,2
France,Austria,1984,1,0,1
German DR,Czechoslovakia,1984,2,1,3
Germany,Russia,1984,2,1,3
Haiti,Canada,1984,0,1,1
Iraq,Qatar,1984,1,1,2
New Zealand,Malaysia,1984,2,0,2
Yugoslavia,Hungary,1984,2,1,3
Kuwait,Bulgaria,1984,1,1,2
New Zealand,Malaysia,1984,6,1,7
England,Northern Ireland,1984,1,0,1
Israel,Republic of Ireland,1984,3,0,3
Turkey,Hungary,1984,0,6,6
Italy,Czechoslovakia,1984,1,1,2
New Zealand,Malaysia,1984,0,0,0
Greece,Cyprus,1984,1,1,2
Romania,Israel,1984,0,0,0
Spain,Denmark,1984,2,1,3
Kenya,China PR,1984,1,0,1
Poland,Belgium,1984,0,1,1
Austria,Greece,1984,0,0,0
France,Germany,1984,1,0,1
Panama,Nicaragua,1984,2,0,2
Jamaica,Haiti,1984,0,1,1
Luxembourg,Norway,1984,0,2,2
Cyprus,Austria,1984,1,2,3
Switzerland,Sweden,1984,0,0,0
Wales,England,1984,1,0,1
Finland,Russia,1984,1,3,4
Czechoslovakia,Denmark,1984,1,0,1
Réunion,Tanzania,1984,1,1,2
Germany,Italy,1984,1,0,1
Wales,Northern Ireland,1984,1,1,2
Hungary,Norway,1984,0,0,0
Republic of Ireland,Poland,1984,0,0,0
Sweden,Malta,1984,4,0,4
Canada,Italy,1984,0,2,2
Scotland,England,1984,1,1,2
Switzerland,Spain,1984,0,4,4
Finland,Northern Ireland,1984,1,0,1
El Salvador,Panama,1984,2,1,3
United States,Italy,1984,0,0,0
Hungary,Spain,1984,1,1,2
Japan,China PR,1984,1,0,1
France,Scotland,1984,2,0,2
England,Russia,1984,0,2,2
Portugal,Yugoslavia,1984,2,3,5
China PR,Republic of Ireland,1984,0,1,1
Ethiopia,Djibouti,1984,2,0,2
South Korea,Guatemala,1984,2,0,2
Belgium,Hungary,1984,2,2,4
Norway,Wales,1984,1,0,1
Sweden,Denmark,1984,0,1,1
Djibouti,Zimbabwe,1984,1,3,4
Liechtenstein,Austria,1984,0,6,6
Spain,Yugoslavia,1984,0,1,1
Denmark,Bulgaria,1984,1,1,2
Luxembourg,Portugal,1984,1,2,3
Trinidad and Tobago,India,1984,1,2,3
Brazil,England,1984,0,2,2
Israel,Wales,1984,0,0,0
Zambia,Zimbabwe,1984,1,1,2
Ethiopia,Zimbabwe,1984,2,0,2
Trinidad and Tobago,India,1984,3,0,3
France,Denmark,1984,1,0,1
Belgium,Yugoslavia,1984,2,0,2
Uruguay,England,1984,2,0,2
Germany,Portugal,1984,0,0,0
Romania,Spain,1984,1,1,2
Panama,Honduras,1984,0,3,3
Suriname,India,1984,6,2,8
Denmark,Yugoslavia,1984,5,0,5
France,Belgium,1984,5,0,5
Brazil,Argentina,1984,0,0,0
Chile,England,1984,0,0,0
Germany,Romania,1984,2,1,3
Macau,Hong Kong,1984,0,3,3
Portugal,Spain,1984,1,1,2
Suriname,India,1984,4,1,5
Guyana,India,1984,3,0,3
Denmark,Belgium,1984,3,2,5
France,Yugoslavia,1984,3,2,5
Germany,Spain,1984,0,1,1
Iceland,Norway,1984,0,1,1
Portugal,Romania,1984,1,0,1
Brazil,Uruguay,1984,1,0,1
China PR,India,1984,2,0,2
Trinidad and Tobago,India,1984,3,0,3
France,Portugal,1984,3,2,5
Morocco,Senegal,1984,2,1,3
Denmark,Spain,1984,1,1,2
Honduras,Panama,1984,1,0,1
El Salvador,Guatemala,1984,3,1,4
France,Spain,1984,2,0,2
Kenya,Cameroon,1984,1,3,4
Sierra Leone,Morocco,1984,0,1,1
Angola,Senegal,1984,1,0,1
Eswatini,Lesotho,1984,3,1,4
Zimbabwe,Zambia,1984,2,1,3
Egypt,Cameroon,1984,2,1,3
Malawi,Kenya,1984,2,1,3
Malawi,Kenya,1984,1,1,2
Malawi,Kenya,1984,2,1,3
Mauritius,Malawi,1984,0,1,1
Morocco,Sierra Leone,1984,4,0,4
Senegal,Angola,1984,1,0,1
Zambia,Congo,1984,2,1,3
Uruguay,Argentina,1984,1,0,1
Norway,Yugoslavia,1984,1,1,2
Guyana,Trinidad and Tobago,1984,0,2,2
Zimbabwe,Uganda,1984,1,0,1
Mauritania,Gambia,1984,0,0,0
Gambia,Guinea,1984,1,1,2
Mauritania,Guinea,1984,1,1,2
Benin,Congo,1984,2,0,2
Malawi,Mauritius,1984,4,0,4
Trinidad and Tobago,Guyana,1984,3,1,4
El Salvador,Puerto Rico,1984,5,0,5
Gambia,Guinea,1984,0,1,1
Romania,China PR,1984,4,2,6
Zambia,Uganda,1984,3,0,3
Ghana,Niger,1984,1,0,1
Mauritania,Gambia,1984,1,1,2
Mauritania,Guinea,1984,0,2,2
Romania,China PR,1984,1,0,1
Burkina Faso,Benin,1984,3,1,4
Faroe Islands,Iceland,1984,0,0,0
Argentina,Uruguay,1984,0,0,0
Mauritania,Guinea,1984,0,0,0
Burkina Faso,Ghana,1984,0,2,2
Greenland,Iceland,1984,0,1,1
Haiti,Antigua and Barbuda,1984,4,0,4
Tanzania,Uganda,1984,0,1,1
Faroe Islands,Greenland,1984,1,0,1
Puerto Rico,El Salvador,1984,0,3,3
Indonesia,Thailand,1984,2,1,3
Faroe Islands,Greenland,1984,4,2,6
Haiti,Antigua and Barbuda,1984,1,2,3
Iran,Bangladesh,1984,5,0,5
Syria,Philippines,1984,2,0,2
Republic of Ireland,Mexico,1984,0,0,0
Indonesia,Bangladesh,1984,2,1,3
Iran,Syria,1984,3,1,4
Peru,Colombia,1984,0,0,0
Thailand,Philippines,1984,3,0,3
German DR,Mexico,1984,1,1,2
Indonesia,Philippines,1984,1,0,1
Iran,Thailand,1984,5,0,5
Syria,Bangladesh,1984,2,1,3
Malaysia,Singapore,1984,1,0,1
Bangladesh,Philippines,1984,3,2,5
Indonesia,Iran,1984,0,1,1
Syria,Thailand,1984,2,3,5
Indonesia,Syria,1984,1,2,3
Iran,Philippines,1984,7,1,8
Suriname,Guyana,1984,1,0,1
Thailand,Bangladesh,1984,2,1,3
Finland,Mexico,1984,0,3,3
Iran,Syria,1984,1,0,1
Singapore,Malaysia,1984,1,1,2
Uganda,Tanzania,1984,1,3,4
Russia,Mexico,1984,3,0,3
Hungary,Switzerland,1984,3,0,3
Sweden,Mexico,1984,1,1,2
Colombia,Argentina,1984,1,0,1
Hungary,Mexico,1984,0,2,2
Liberia,Papua New Guinea,1984,1,2,3
Uganda,Zambia,1984,1,0,1
Malaysia,Indonesia,1984,2,2,4
Egypt,Zimbabwe,1984,1,0,1
German DR,Romania,1984,2,1,3
Guyana,Suriname,1984,1,1,2
Malaysia,Liberia,1984,3,1,4
Norway,Poland,1984,1,1,2
Cyprus,Greece,1984,0,2,2
Indonesia,Papua New Guinea,1984,0,1,1
Switzerland,Argentina,1984,0,2,2
Indonesia,Liberia,1984,1,2,3
Malaysia,Papua New Guinea,1984,5,1,6
Singapore,Qatar,1984,0,1,1
Belgium,Argentina,1984,0,2,2
Greece,Czechoslovakia,1984,0,1,1
Israel,Malta,1984,2,1,3
Jordan,Hong Kong,1984,1,1,2
Qatar,Afghanistan,1984,8,0,8
China PR,Afghanistan,1984,6,0,6
Denmark,Austria,1984,3,1,4
England,German DR,1984,1,0,1
Finland,Poland,1984,0,2,2
German DR,Greece,1984,1,0,1
Germany,Argentina,1984,1,3,4
Iceland,Wales,1984,1,0,1
Republic of Ireland,Russia,1984,1,0,1
Northern Ireland,Romania,1984,3,2,5
Norway,Switzerland,1984,0,1,1
Qatar,Hong Kong,1984,1,0,1
Scotland,Yugoslavia,1984,6,1,7
Sweden,Portugal,1984,0,1,1
China PR,Jordan,1984,6,0,6
Hong Kong,Afghanistan,1984,0,0,0
Mauritius,Mozambique,1984,0,0,0
China PR,Hong Kong,1984,2,0,2
Qatar,Jordan,1984,2,0,2
Mexico,Argentina,1984,1,1,2
Uruguay,Peru,1984,2,0,2
China PR,Qatar,1984,1,0,1
Jordan,Afghanistan,1984,6,1,7
Ghana,Gambia,1984,3,1,4
Niger,Ivory Coast,1984,1,3,4
Saudi Arabia,Iceland,1984,1,2,3
Denmark,Norway,1984,1,0,1
Hungary,Austria,1984,3,1,4
Italy,Sweden,1984,1,0,1
Poland,Turkey,1984,2,0,2
Tunisia,Nigeria,1984,5,0,5
Curaçao,United States,1984,0,0,0
Yugoslavia,Bulgaria,1984,0,0,0
Botswana,Angola,1984,1,3,4
South Korea,Japan,1984,1,2,3
Mozambique,Mauritius,1984,3,0,3
Zimbabwe,Egypt,1984,1,1,2
Honduras,Guatemala,1984,1,0,1
Peru,Uruguay,1984,1,3,4
South Korea,Cameroon,1984,5,0,5
United States,Curaçao,1984,4,0,4
Saudi Arabia,Thailand,1984,2,1,3
Greece,Israel,1984,2,2,4
Mexico,Colombia,1984,1,0,1
United States,El Salvador,1984,3,1,4
German DR,Algeria,1984,5,2,7
South Korea,Yemen,1984,6,0,6
Norway,Russia,1984,1,1,2
Saudi Arabia,Thailand,1984,1,3,4
El Salvador,Mexico,1984,0,1,1
Ivory Coast,Liberia,1984,3,0,3
Malaysia,Pakistan,1984,5,0,5
United States,Colombia,1984,1,0,1
India,Yemen,1984,4,0,4
Kenya,Ethiopia,1984,2,1,3
South Korea,Pakistan,1984,6,0,6
Luxembourg,France,1984,0,4,4
Tanzania,Sudan,1984,1,1,2
Guatemala,United States,1984,4,0,4
India,Malaysia,1984,2,1,3
Portugal,Czechoslovakia,1984,2,1,3
Zimbabwe,Eswatini,1984,3,0,3
Congo,Benin,1984,0,2,2
Pakistan,Yemen,1984,4,1,5
Algeria,Canada,1984,1,0,1
South Korea,Malaysia,1984,0,0,0
Northern Ireland,Israel,1984,3,0,3
Turkey,Bulgaria,1984,0,0,0
Belgium,Albania,1984,3,1,4
England,Finland,1984,5,0,5
Germany,Sweden,1984,2,0,2
India,Pakistan,1984,2,0,2
Mexico,United States,1984,2,1,3
Netherlands,Hungary,1984,1,2,3
Norway,Republic of Ireland,1984,1,0,1
Poland,Greece,1984,3,1,4
Scotland,Iceland,1984,3,0,3
Spain,Wales,1984,3,0,3
Switzerland,Denmark,1984,1,0,1
Fiji,New Zealand,1984,1,2,3
Malaysia,Yemen,1984,4,1,5
India,South Korea,1984,0,1,1
Saudi Arabia,Nepal,1984,7,0,7
Fiji,New Zealand,1984,1,1,2
German DR,Yugoslavia,1984,2,3,5
Nigeria,Liberia,1984,3,0,3
Oman,Sri Lanka,1984,1,1,2
Ivory Coast,Gambia,1984,4,0,4
Tunisia,Canada,1984,2,0,2
Saudi Arabia,United Arab Emirates,1984,1,0,1
Sri Lanka,Nepal,1984,4,0,4
Morocco,Canada,1984,3,2,5
Saudi Arabia,Sri Lanka,1984,5,0,5
United Arab Emirates,Oman,1984,8,0,8
Argentina,Mexico,1984,1,1,2
Saudi Arabia,Oman,1984,6,0,6
United Arab Emirates,Nepal,1984,11,0,11
Sudan,Tanzania,1984,0,0,0
Benin,Tunisia,1984,0,2,2
Chile,Mexico,1984,1,0,1
Ethiopia,Kenya,1984,3,3,6
Oman,Nepal,1984,8,0,8
United Arab Emirates,Sri Lanka,1984,5,1,6
Czechoslovakia,Malta,1984,4,0,4
Poland,Albania,1984,2,2,4
Turkey,Finland,1984,1,2,3
Uruguay,Mexico,1984,1,1,2
Egypt,Canada,1984,1,0,1
China PR,Australia,1984,3,2,5
Switzerland,Italy,1984,1,1,2
Gambia,Ivory Coast,1984,3,2,5
Liberia,Nigeria,1984,0,1,1
Eswatini,Zimbabwe,1984,1,5,6
Guyana,Suriname,1984,1,1,2
Somalia,Kenya,1984,1,0,1
Angola,Congo,1984,1,0,1
Burkina Faso,Mali,1984,1,0,1
DR Congo,Gabon,1984,2,0,2
Guyana,Suriname,1984,1,1,2
Liberia,Mauritania,1984,3,1,4
Trinidad and Tobago,Mexico,1984,0,2,2
Tunisia,Benin,1984,4,0,4
Austria,Netherlands,1984,1,0,1
Denmark,Republic of Ireland,1984,3,0,3
Northern Ireland,Finland,1984,2,1,3
Portugal,Sweden,1984,1,3,4
Scotland,Spain,1984,3,1,4
Turkey,England,1984,0,8,8
Wales,Iceland,1984,2,1,3
Burkina Faso,Togo,1984,1,1,2
Cyprus,Hungary,1984,1,2,3
Luxembourg,German DR,1984,0,5,5
Malawi,Zimbabwe,1984,3,0,3
Gambia,Sierra Leone,1984,3,2,5
Ghana,Ivory Coast,1984,2,0,2
Mali,Benin,1984,1,0,1
Malawi,Zimbabwe,1984,1,0,1
Burkina Faso,Ivory Coast,1984,2,2,4
Saudi Arabia,Finland,1984,2,1,3
France,Bulgaria,1984,1,0,1
Ghana,Togo,1984,2,2,4
Israel,Romania,1984,1,1,2
Burkina Faso,Benin,1984,2,1,3
Qatar,Finland,1984,2,2,4
Ivory Coast,Togo,1984,1,1,2
Kenya,Somalia,1984,1,0,1
Mauritania,Liberia,1984,3,0,3
Benin,Ivory Coast,1984,1,2,3
Burkina Faso,Ghana,1984,1,1,2
Qatar,Finland,1984,1,1,2
Benin,Togo,1984,0,2,2
Gabon,DR Congo,1984,1,1,2
United Arab Emirates,Syria,1984,2,1,3
Benin,Ghana,1984,1,3,4
Burkina Faso,Ivory Coast,1984,0,2,2
Ghana,Togo,1984,1,1,2
United States,Ecuador,1984,0,0,0
Iran,United Arab Emirates,1984,3,0,3
Qatar,Syria,1984,1,1,2
Uganda,Tanzania,1984,1,1,2
Benin,Mali,1984,2,2,4
Dominica,Grenada,1984,0,4,4
Kenya,Malawi,1984,1,2,3
Saudi Arabia,South Korea,1984,1,1,2
Sierra Leone,Gambia,1984,2,0,2
Singapore,India,1984,2,0,2
Saint Lucia,Saint Vincent and the Grenadines,1984,2,0,2
United States,Ecuador,1984,2,2,4
Zambia,Zimbabwe,1984,2,0,2
China PR,Iran,1984,0,2,2
Kuwait,Qatar,1984,1,0,1
Somalia,Zanzibar,1984,2,1,3
El Salvador,Guatemala,1984,2,1,3
Mexico,Ecuador,1984,3,2,5
Syria,Saudi Arabia,1984,0,1,1
Uganda,Zimbabwe,1984,4,1,5
United Arab Emirates,India,1984,2,0,2
Bulgaria,Luxembourg,1984,4,0,4
Greece,Romania,1984,2,1,3
South Korea,Kuwait,1984,0,0,0
Malawi,Somalia,1984,1,0,1
Singapore,China PR,1984,0,2,2
Tanzania,Zambia,1984,1,2,3
Kenya,Zanzibar,1984,1,0,1
Honduras,Ecuador,1984,0,0,0
Iran,India,1984,0,0,0
Syria,South Korea,1984,1,0,1
Uganda,Zambia,1984,1,1,2
France,German DR,1984,2,0,2
Italy,Poland,1984,2,0,2
Kenya,Somalia,1984,1,1,2
Qatar,Saudi Arabia,1984,1,1,2
Singapore,United Arab Emirates,1984,0,1,1
Tanzania,Zimbabwe,1984,2,2,4
Congo,Equatorial Guinea,1984,5,0,5
Guatemala,Ecuador,1984,1,0,1
India,China PR,1984,0,3,3
Ivory Coast,Guinea,1984,2,2,4
Kuwait,Syria,1984,3,1,4
Malawi,Zanzibar,1984,1,0,1
Chad,Cameroon,1984,0,2,2
South Korea,Qatar,1984,0,1,1
Singapore,Iran,1984,1,1,2
China PR,United Arab Emirates,1984,5,0,5
Saudi Arabia,Kuwait,1984,1,0,1
Chad,Gabon,1984,3,3,6
Congo,Central African Republic,1984,2,1,3
El Salvador,Ecuador,1984,0,0,0
Kenya,Zambia,1984,0,2,2
Uganda,Malawi,1984,0,2,2
Saudi Arabia,Iran,1984,1,1,2
Cameroon,Gabon,1984,0,0,0
Central African Republic,Equatorial Guinea,1984,1,1,2
Kuwait,China PR,1984,0,1,1
Malawi,Zambia,1984,0,0,0
Uganda,Kenya,1984,3,1,4
Chad,Equatorial Guinea,1984,1,1,2
Guatemala,Honduras,1984,1,0,1
Iran,Kuwait,1984,1,1,2
Malta,Germany,1984,2,3,5
Saudi Arabia,China PR,1984,2,0,2
Central African Republic,Cameroon,1984,1,7,8
Congo,Gabon,1984,3,0,3
Cyprus,Luxembourg,1984,1,0,1
Egypt,Norway,1984,0,1,1
Central African Republic,Gabon,1984,2,2,4
Greece,Belgium,1984,0,0,0
Israel,Luxembourg,1984,2,0,2
Congo,Cameroon,1984,2,2,4
Egypt,Norway,1984,0,1,1
Albania,Belgium,1984,2,0,2
Turkey,Luxembourg,1984,1,0,1
Cyprus,Netherlands,1984,0,1,1
Guatemala,El Salvador,1984,2,0,2
Algeria,Ghana,1984,1,2,3
Ivory Coast,Tunisia,1984,3,1,4
Algeria,Tunisia,1984,3,1,4
Ivory Coast,Ghana,1984,2,0,2
Ghana,Tunisia,1985,0,2,2
Ivory Coast,Algeria,1985,1,1,2
Libya,Morocco,1985,0,0,0
Israel,Greece,1985,0,2,2
Barbados,Saint Lucia,1985,4,1,5
Singapore,North Korea,1985,1,1,2
Guyana,Cuba,1985,2,1,3
Iran,Yugoslavia,1985,1,3,4
China PR,Russia,1985,2,3,5
Spain,Finland,1985,3,1,4
Russia,Yugoslavia,1985,1,2,3
Guyana,Cuba,1985,1,1,2
Honduras,Denmark,1985,1,0,1
Iran,Russia,1985,0,2,2
China PR,Yugoslavia,1985,1,1,2
Germany,Hungary,1985,0,1,1
Uruguay,German DR,1985,3,0,3
Portugal,Romania,1985,2,3,5
India,Morocco,1985,0,1,1
Ivory Coast,Egypt,1985,0,1,1
Colombia,Switzerland,1985,2,2,4
Morocco,Russia,1985,0,1,1
Zimbabwe,Zambia,1985,1,1,2
Bolivia,German DR,1985,2,1,3
Cameroon,Egypt,1985,1,0,1
Uruguay,Paraguay,1985,1,0,1
Zimbabwe,Zambia,1985,2,3,5
Yugoslavia,Russia,1985,1,2,3
Bulgaria,Switzerland,1985,1,0,1
Iran,North Korea,1985,1,0,1
Republic of Ireland,Italy,1985,1,2,3
Mexico,Poland,1985,5,0,5
Bolivia,Uruguay,1985,0,1,1
Bulgaria,Poland,1985,2,2,4
Cameroon,Egypt,1985,0,0,0
Chile,Paraguay,1985,1,0,1
Costa Rica,El Salvador,1985,2,1,3
Ecuador,German DR,1985,2,3,5
Mexico,Switzerland,1985,1,2,3
Chile,Finland,1985,2,0,2
United States,Switzerland,1985,1,1,2
Colombia,Poland,1985,1,2,3
Ecuador,German DR,1985,3,2,5
Guinea,Tunisia,1985,1,0,1
Malta,Portugal,1985,1,3,4
Paraguay,Uruguay,1985,1,3,4
Gambia,Cape Verde,1985,1,2,3
Guinea-Bissau,Sierra Leone,1985,0,0,0
Guinea,Senegal,1985,0,2,2
Mali,Mauritania,1985,3,0,3
Cape Verde,Sierra Leone,1985,2,2,4
El Salvador,Costa Rica,1985,1,0,1
Gambia,Guinea-Bissau,1985,1,0,1
Colombia,Poland,1985,1,0,1
Guinea,Mali,1985,1,3,4
Mauritania,Senegal,1985,0,2,2
Uruguay,Finland,1985,2,1,3
Cape Verde,Guinea-Bissau,1985,2,0,2
Gambia,Sierra Leone,1985,1,1,2
Guinea,Mauritania,1985,1,0,1
Mali,Senegal,1985,2,2,4
Ecuador,Finland,1985,3,1,4
Guatemala,Costa Rica,1985,1,0,1
Hong Kong,China PR,1985,0,0,0
Macau,Brunei,1985,2,0,2
Peru,Bolivia,1985,3,0,3
Cape Verde,Senegal,1985,0,1,1
Gambia,Mali,1985,1,0,1
Ivory Coast,Congo,1985,2,1,3
Macau,China PR,1985,0,4,4
Cape Verde,Mali,1985,0,1,1
Chile,Colombia,1985,1,1,2
Ecuador,Bolivia,1985,3,0,3
Gambia,Senegal,1985,0,1,1
Sudan,Libya,1985,0,0,0
Hong Kong,Brunei,1985,8,0,8
Singapore,Japan,1985,1,3,4
Antigua and Barbuda,Dominica,1985,2,1,3
Chile,Peru,1985,1,2,3
El Salvador,Suriname,1985,3,0,3
Portugal,Germany,1985,1,2,3
Saint Vincent and the Grenadines,Trinidad and Tobago,1985,1,1,2
Tunisia,Guinea,1985,2,0,2
Uruguay,Colombia,1985,3,0,3
China PR,Brunei,1985,8,0,8
Mexico,Finland,1985,2,1,3
Wales,Norway,1985,1,1,2
El Salvador,Suriname,1985,3,0,3
Greece,Albania,1985,2,0,2
Israel,Republic of Ireland,1985,0,0,0
Netherlands,Cyprus,1985,7,1,8
Northern Ireland,England,1985,0,1,1
Spain,Scotland,1985,1,0,1
Uruguay,Peru,1985,2,2,4
Paraguay,Colombia,1985,0,3,3
Brunei,China PR,1985,0,4,4
Nepal,South Korea,1985,0,2,2
Antigua and Barbuda,Guadeloupe,1985,0,1,1
Dominica,Cayman Islands,1985,2,1,3
Ecuador,Chile,1985,1,1,2
Grenada,Trinidad and Tobago,1985,1,5,6
Honduras,Suriname,1985,1,1,2
Madagascar,Zimbabwe,1985,0,1,1
Ivory Coast,DR Congo,1985,2,1,3
Costa Rica,Guatemala,1985,2,0,2
Honduras,Suriname,1985,2,1,3
Algeria,Mauritania,1985,4,0,4
Libya,Sudan,1985,4,0,4
Saint Vincent and the Grenadines,Canada,1985,1,2,3
Peru,Chile,1985,1,1,2
El Salvador,Honduras,1985,1,2,3
French Guiana,Guyana,1985,0,1,1
Malaysia,South Korea,1985,1,0,1
Trinidad and Tobago,Canada,1985,1,2,3
Uruguay,Ecuador,1985,2,1,3
Algeria,German DR,1985,1,1,2
Greece,Italy,1985,0,0,0
Jamaica,Canada,1985,1,1,2
Honduras,El Salvador,1985,0,0,0
Indonesia,Thailand,1985,1,0,1
Iraq,Lebanon,1985,6,0,6
Jordan,Qatar,1985,1,0,1
Nepal,Malaysia,1985,0,0,0
Chile,Ecuador,1985,6,2,8
French Guiana,Suriname,1985,0,1,1
Jamaica,Canada,1985,0,0,0
Indonesia,Bangladesh,1985,2,0,2
Iraq,Lebanon,1985,6,0,6
Costa Rica,Canada,1985,1,0,1
Indonesia,India,1985,2,1,3
Japan,North Korea,1985,1,0,1
Peru,Ecuador,1985,1,0,1
Mauritania,Algeria,1985,1,1,2
Qatar,Lebanon,1985,7,0,7
Syria,Kuwait,1985,1,0,1
Zimbabwe,Madagascar,1985,5,2,7
Thailand,Bangladesh,1985,3,0,3
Zambia,Malawi,1985,1,1,2
Brunei,Philippines,1985,4,1,5
Chile,Uruguay,1985,2,0,2
Costa Rica,Canada,1985,0,0,0
Guyana,Suriname,1985,0,1,1
Saint Vincent and the Grenadines,Grenada,1985,3,0,3
Zambia,Malawi,1985,2,2,4
England,Republic of Ireland,1985,2,1,3
Thailand,India,1985,0,0,0
Belgium,Greece,1985,2,0,2
Germany,Malta,1985,6,0,6
Qatar,Lebanon,1985,8,0,8
Romania,Poland,1985,0,0,0
Russia,Austria,1985,2,0,2
Scotland,Wales,1985,0,1,1
Spain,Northern Ireland,1985,0,0,0
Switzerland,Czechoslovakia,1985,2,0,2
Yugoslavia,Luxembourg,1985,1,0,1
Albania,Turkey,1985,0,0,0
Egypt,Cameroon,1985,2,0,2
Jordan,Iraq,1985,2,3,5
Libya,Tunisia,1985,2,0,2
Panama,Guatemala,1985,0,0,0
Thailand,Indonesia,1985,0,1,1
Yemen,Syria,1985,0,1,1
Yemen DPR,Bahrain,1985,1,4,5
Bangladesh,India,1985,1,2,3
Angola,Algeria,1985,0,0,0
Congo,DR Congo,1985,2,5,7
Ecuador,Uruguay,1985,0,2,2
Egypt,Cameroon,1985,2,1,3
Ghana,Guinea,1985,1,1,2
Ivory Coast,Mali,1985,6,0,6
Kuwait,Iceland,1985,1,1,2
Malaysia,Nepal,1985,5,0,5
Togo,Senegal,1985,0,1,1
Malawi,Mozambique,1985,1,1,2
Bangladesh,Indonesia,1985,2,1,3
Canada,United States,1985,2,0,2
Syria,United Arab Emirates,1985,2,1,3
Guadeloupe,Trinidad and Tobago,1985,1,1,2
Hungary,Cyprus,1985,2,0,2
Italy,Portugal,1985,2,0,2
Malta,Jordan,1985,3,1,4
Romania,Turkey,1985,3,0,3
Yugoslavia,France,1985,0,0,0
United States,Canada,1985,1,1,2
Bahrain,United Arab Emirates,1985,3,2,5
Bangladesh,Thailand,1985,1,0,1
Egypt,Madagascar,1985,1,0,1
Kuwait,Yemen,1985,5,0,5
Qatar,Iraq,1985,3,0,3
Brunei,Hong Kong,1985,1,5,6
Bulgaria,German DR,1985,1,0,1
India,Indonesia,1985,1,1,2
Kenya,Nigeria,1985,0,3,3
South Korea,Nepal,1985,4,0,4
Ivory Coast,Ghana,1985,0,0,0
Mali,Togo,1985,4,0,4
Morocco,Malawi,1985,2,0,2
Syria,United Arab Emirates,1985,0,4,4
Uruguay,Chile,1985,2,1,3
Zambia,Cameroon,1985,4,1,5
India,Thailand,1985,1,1,2
Bahrain,Yemen DPR,1985,3,3,6
India,Bangladesh,1985,2,1,3
Kuwait,Syria,1985,0,0,0
Qatar,Jordan,1985,2,0,2
Saudi Arabia,United Arab Emirates,1985,0,0,0
Brunei,Macau,1985,1,2,3
Canada,Haiti,1985,2,0,2
DR Congo,Congo,1985,0,0,0
Guinea,Ghana,1985,1,4,5
Mali,Ivory Coast,1985,1,1,2
Panama,Trinidad and Tobago,1985,0,0,0
Senegal,Togo,1985,1,1,2
Tunisia,Libya,1985,1,0,1
Mozambique,Malawi,1985,1,1,2
Austria,Hungary,1985,0,3,3
Colombia,Paraguay,1985,2,0,2
German DR,Norway,1985,1,0,1
Germany,Bulgaria,1985,4,1,5
Panama,Trinidad and Tobago,1985,1,1,2
Poland,Finland,1985,2,1,3
Switzerland,Russia,1985,2,2,4
Algeria,Angola,1985,3,2,5
Colombia,Paraguay,1985,2,2,4
Iraq,Jordan,1985,2,0,2
Syria,Yemen,1985,3,0,3
United Arab Emirates,Saudi Arabia,1985,1,0,1
Barbados,Jamaica,1985,2,2,4
Canada,Guatemala,1985,2,1,3
Nigeria,Kenya,1985,3,1,4
Bolivia,Venezuela,1985,4,0,4
Cameroon,Zambia,1985,1,1,2
Ghana,Ivory Coast,1985,2,0,2
Madagascar,Egypt,1985,1,0,1
Malawi,Morocco,1985,0,0,0
Malta,Czechoslovakia,1985,0,0,0
Togo,Mali,1985,3,0,3
Peru,Uruguay,1985,2,1,3
Costa Rica,Trinidad and Tobago,1985,3,0,3
Luxembourg,Iceland,1985,0,0,0
Brazil,Colombia,1985,2,1,3
Haiti,Guatemala,1985,0,1,1
Yemen,Kuwait,1985,1,3,4
Suriname,Guadeloupe,1985,0,1,1
Bangladesh,Indonesia,1985,1,1,2
Brazil,Peru,1985,0,1,1
Colombia,Uruguay,1985,2,1,3
Costa Rica,Trinidad and Tobago,1985,1,1,2
Macau,Hong Kong,1985,0,2,2
Pakistan,North Korea,1985,0,0,0
Paraguay,Argentina,1985,1,0,1
North Korea,Nepal,1985,8,1,9
Czechoslovakia,Germany,1985,1,5,6
North Korea,Japan,1985,0,0,0
Pakistan,Nepal,1985,1,0,1
Wales,Spain,1985,3,0,3
Belgium,Poland,1985,2,0,2
Bolivia,Peru,1985,0,0,0
Republic of Ireland,Norway,1985,0,0,0
Israel,Sweden,1985,1,1,2
Luxembourg,Yugoslavia,1985,0,1,1
Netherlands,Austria,1985,1,1,2
Northern Ireland,Turkey,1985,2,0,2
Romania,England,1985,0,0,0
Tunisia,Algeria,1985,1,0,1
Brazil,Uruguay,1985,2,0,2
Bulgaria,France,1985,2,0,2
Indonesia,North Korea,1985,0,7,7
Pakistan,Bangladesh,1985,1,3,4
Russia,Switzerland,1985,4,0,4
Zimbabwe,Malawi,1985,1,3,4
Bangladesh,North Korea,1985,0,1,1
Hong Kong,Macau,1985,2,0,2
Pakistan,Indonesia,1985,1,3,4
Brazil,Argentina,1985,2,1,3
Guatemala,Canada,1985,1,1,2
Iraq,Qatar,1985,2,1,3
Trinidad and Tobago,Suriname,1985,0,1,1
Austria,Cyprus,1985,4,0,4
Denmark,German DR,1985,4,1,5
Haiti,Canada,1985,0,2,2
Argentina,Paraguay,1985,1,1,2
Mauritania,Senegal,1985,0,0,0
China PR,Macau,1985,6,0,6
Argentina,Chile,1985,2,0,2
Hungary,Netherlands,1985,0,1,1
Colombia,Brazil,1985,1,0,1
Guatemala,Haiti,1985,4,0,4
United States,Trinidad and Tobago,1985,2,1,3
German DR,Luxembourg,1985,3,1,4
Japan,Singapore,1985,5,0,5
China PR,Hong Kong,1985,1,2,3
Greece,Poland,1985,1,4,5
South Korea,Malaysia,1985,2,0,2
United States,Trinidad and Tobago,1985,1,0,1
Chile,Brazil,1985,2,1,3
Finland,England,1985,1,1,2
Sweden,Norway,1985,1,0,1
North Korea,Singapore,1985,2,0,2
Scotland,England,1985,1,0,1
Bolivia,Paraguay,1985,1,1,2
Colombia,Peru,1985,1,0,1
Costa Rica,United States,1985,1,1,2
Japan,Uruguay,1985,1,4,5
Republic of Ireland,Spain,1985,0,0,0
Venezuela,Argentina,1985,2,3,5
Iceland,Scotland,1985,0,1,1
Albania,Poland,1985,0,1,1
United States,Costa Rica,1985,0,1,1
Bulgaria,Yugoslavia,1985,2,1,3
Hong Kong,Macau,1985,2,0,2
Bolivia,Brazil,1985,0,2,2
Canada,Ghana,1985,2,1,3
Colombia,Argentina,1985,1,3,4
Republic of Ireland,Switzerland,1985,3,0,3
Mexico,Italy,1985,1,1,2
Venezuela,Peru,1985,0,1,1
Bahrain,Malaysia,1985,3,1,4
New Zealand,Fiji,1985,5,0,5
Denmark,Russia,1985,4,2,6
New Zealand,Fiji,1985,3,0,3
Norway,Wales,1985,4,2,6
Sweden,Czechoslovakia,1985,2,0,2
England,Italy,1985,1,2,3
Finland,Romania,1985,1,1,2
South Korea,Thailand,1985,3,2,5
New Zealand,Fiji,1985,2,0,2
Brazil,Chile,1985,3,1,4
South Korea,Bahrain,1985,3,0,3
Argentina,Venezuela,1985,3,0,3
Canada,Iraq,1985,1,6,7
Mexico,England,1985,1,0,1
Paraguay,Bolivia,1985,3,0,3
Peru,Colombia,1985,0,0,0
England,Germany,1985,3,0,3
Iceland,Spain,1985,1,2,3
South Korea,Iraq,1985,2,0,2
Mexico,Germany,1985,2,0,2
Nigeria,Ivory Coast,1985,0,0,0
Argentina,Colombia,1985,1,0,1
Paraguay,Brazil,1985,0,2,2
Peru,Venezuela,1985,4,1,5
United States,England,1985,0,5,5
Nigeria,Ivory Coast,1985,2,0,2
Brazil,Paraguay,1985,1,1,2
Ivory Coast,Nigeria,1985,1,1,2
Peru,Argentina,1985,1,0,1
Venezuela,Colombia,1985,2,2,4
Guinea,Gambia,1985,1,0,1
Barbados,Suriname,1985,0,0,0
Guadeloupe,Martinique,1985,1,2,3
Ivory Coast,Nigeria,1985,1,1,2
Barbados,Guadeloupe,1985,1,1,2
Martinique,Suriname,1985,2,0,2
Angola,São Tomé and Príncipe,1985,3,2,5
Argentina,Peru,1985,2,2,4
Barbados,Martinique,1985,1,1,2
Brazil,Bolivia,1985,1,1,2
Colombia,Venezuela,1985,2,0,2
Guadeloupe,Suriname,1985,2,2,4
Réunion,DR Congo,1985,1,2,3
Saudi Arabia,Jordan,1985,4,0,4
Bahrain,Iraq,1985,1,1,2
Fiji,Tahiti,1985,0,1,1
Malawi,DR Congo,1985,0,1,1
Jordan,Qatar,1985,0,2,2
Bahrain,Mauritania,1985,2,0,2
Malawi,Tanzania,1985,0,0,0
Nigeria,Tunisia,1985,1,0,1
Réunion,Malawi,1985,2,8,10
Saudi Arabia,Qatar,1985,1,0,1
Iraq,Mauritania,1985,2,0,2
Malawi,Tanzania,1985,2,0,2
Cape Verde,Angola,1985,0,0,0
Kenya,DR Congo,1985,0,1,1
Angola,Guinea-Bissau,1985,3,1,4
Bahrain,Qatar,1985,1,1,2
Iceland,Faroe Islands,1985,9,0,9
Malawi,Tanzania,1985,0,0,0
Saudi Arabia,Iraq,1985,2,3,5
Fiji,Tahiti,1985,0,1,1
Bahrain,Iraq,1985,0,1,1
Egypt,Morocco,1985,0,0,0
Iceland,Faroe Islands,1985,1,0,1
Saudi Arabia,Qatar,1985,0,0,0
Algeria,Zambia,1985,2,0,2
Fiji,Tahiti,1985,1,2,3
Ghana,Libya,1985,0,0,0
Costa Rica,Trinidad and Tobago,1985,3,1,4
Tunisia,Nigeria,1985,2,0,2
South Korea,Indonesia,1985,2,0,2
Libya,Ghana,1985,2,0,2
Kenya,Uganda,1985,0,1,1
Morocco,Egypt,1985,2,0,2
Tunisia,Saudi Arabia,1985,1,0,1
Zambia,Algeria,1985,0,1,1
Indonesia,South Korea,1985,1,4,5
Kenya,Algeria,1985,0,0,0
Thailand,Hong Kong,1985,1,2,3
Russia,Romania,1985,2,0,2
Nigeria,Zambia,1985,0,0,0
Costa Rica,Honduras,1985,2,2,4
Guinea,Mali,1985,1,1,2
Japan,Hong Kong,1985,3,0,3
Indonesia,Thailand,1985,1,2,3
Algeria,Kenya,1985,3,0,3
Norway,German DR,1985,0,1,1
Canada,Costa Rica,1985,1,1,2
Ivory Coast,Ghana,1985,2,0,2
Zambia,Nigeria,1985,1,0,1
Zimbabwe,Senegal,1985,1,0,1
France,Uruguay,1985,2,0,2
Sweden,Poland,1985,1,0,1
Libya,Mozambique,1985,2,1,3
Honduras,Canada,1985,0,1,1
Mali,Guinea,1985,1,1,2
Morocco,DR Congo,1985,1,0,1
Mexico,Bulgaria,1985,1,1,2
Romania,Finland,1985,2,0,2
Russia,Germany,1985,1,0,1
Switzerland,Turkey,1985,0,0,0
Costa Rica,Canada,1985,0,0,0
Ghana,Ivory Coast,1985,0,0,0
Senegal,Zimbabwe,1985,3,0,3
Israel,Taiwan,1985,6,0,6
Czechoslovakia,Poland,1985,3,1,4
Netherlands,Bulgaria,1985,1,0,1
Bahrain,Syria,1985,1,1,2
DR Congo,Morocco,1985,0,0,0
Honduras,Costa Rica,1985,3,1,4
Norway,Egypt,1985,3,0,3
Wales,Scotland,1985,1,1,2
Denmark,Sweden,1985,0,3,3
England,Romania,1985,1,1,2
German DR,France,1985,2,0,2
Poland,Belgium,1985,0,0,0
Switzerland,Republic of Ireland,1985,0,0,0
Turkey,Northern Ireland,1985,0,0,0
Canada,Honduras,1985,2,1,3
Cameroon,Saudi Arabia,1985,4,1,5
Mozambique,Libya,1985,2,1,3
Papua New Guinea,China PR,1985,1,4,5
Papua New Guinea,China PR,1985,1,1,2
Mexico,Peru,1985,0,0,0
Syria,Bahrain,1985,1,0,1
United Arab Emirates,Iraq,1985,2,3,5
New Zealand,Australia,1985,0,0,0
Hong Kong,Japan,1985,1,2,3
Mexico,Peru,1985,1,0,1
Czechoslovakia,Portugal,1985,1,0,1
Finland,Turkey,1985,1,0,1
Italy,Norway,1985,1,2,3
Luxembourg,Bulgaria,1985,1,3,4
Russia,Denmark,1985,1,0,1
Spain,Iceland,1985,2,1,3
Sweden,Germany,1985,2,2,4
Australia,China PR,1985,3,0,3
Iraq,United Arab Emirates,1985,1,2,3
Yugoslavia,German DR,1985,1,2,3
Malawi,Uganda,1985,1,0,1
Saudi Arabia,Cameroon,1985,2,1,3
Zimbabwe,Tanzania,1985,1,0,1
New Zealand,Taiwan,1985,5,1,6
Malawi,Zambia,1985,2,2,4
Morocco,Libya,1985,3,0,3
Tunisia,Algeria,1985,1,4,5
Zimbabwe,Kenya,1985,1,1,2
Israel,Australia,1985,1,2,3
Kenya,Tanzania,1985,3,2,5
Uganda,Zambia,1985,3,0,3
Denmark,Switzerland,1985,0,0,0
Paraguay,Chile,1985,0,0,0
Kenya,Uganda,1985,0,0,0
Libya,Mexico,1985,3,1,4
Zimbabwe,Malawi,1985,1,0,1
Malawi,Uganda,1985,3,1,4
Portugal,Malta,1985,3,2,5
Brunei,Malaysia,1985,0,4,4
Zimbabwe,Kenya,1985,2,0,2
Yemen,Mexico,1985,0,2,2
Austria,Yugoslavia,1985,0,3,3
Belgium,Netherlands,1985,1,0,1
Czechoslovakia,Sweden,1985,2,1,3
England,Turkey,1985,5,0,5
Germany,Portugal,1985,0,1,1
Greece,Bulgaria,1985,0,2,2
Norway,Denmark,1985,1,5,6
Peru,Paraguay,1985,0,1,1
Romania,Northern Ireland,1985,0,1,1
Russia,Republic of Ireland,1985,2,0,2
Scotland,German DR,1985,0,0,0
Singapore,Brunei,1985,2,1,3
Wales,Hungary,1985,0,3,3
Algeria,Tunisia,1985,3,0,3
Jordan,Mexico,1985,0,0,0
Libya,Morocco,1985,1,0,1
Australia,Israel,1985,1,1,2
Egypt,Mexico,1985,2,1,3
Singapore,Malaysia,1985,2,0,2
Australia,Taiwan,1985,7,0,7
Singapore,Malaysia,1985,4,0,4
Kuwait,Mexico,1985,0,0,0
Myanmar,Indonesia,1985,2,1,3
Japan,South Korea,1985,1,2,3
New Zealand,Israel,1985,3,1,4
Chile,Peru,1985,4,2,6
Paraguay,Colombia,1985,3,0,3
Albania,Greece,1985,1,1,2
France,Luxembourg,1985,6,0,6
Russia,Norway,1985,1,0,1
Australia,New Zealand,1985,2,0,2
Colombia,Paraguay,1985,2,1,3
South Korea,Japan,1985,1,0,1
Peru,Chile,1985,0,1,1
Anguilla,British Virgin Islands,1985,0,1,1
Angola,Mozambique,1985,0,0,0
Angola,Zimbabwe,1985,2,3,5
Israel,New Zealand,1985,3,0,3
Paraguay,Chile,1985,3,0,3
Mozambique,Zimbabwe,1985,1,2,3
England,Northern Ireland,1985,0,0,0
Republic of Ireland,Denmark,1985,1,4,5
Switzerland,Norway,1985,1,1,2
Turkey,Romania,1985,1,3,4
Mexico,Argentina,1985,1,1,2
Syria,Iraq,1985,0,0,0
France,Yugoslavia,1985,2,0,2
German DR,Bulgaria,1985,2,1,3
Poland,Italy,1985,1,0,1
Chile,Paraguay,1985,2,2,4
Germany,Czechoslovakia,1985,2,2,4
Grenada,Dominica,1985,0,0,0
Malta,Sweden,1985,1,2,3
Mexico,Argentina,1985,1,1,2
Saint Lucia,Saint Vincent and the Grenadines,1985,0,0,0
Dominica,Saint Vincent and the Grenadines,1985,0,0,0
DR Congo,Zambia,1985,0,1,1
Egypt,Ivory Coast,1985,0,1,1
Netherlands,Belgium,1985,2,1,3
Scotland,Australia,1985,2,0,2
Spain,Austria,1985,0,0,0
DR Congo,Egypt,1985,3,2,5
Ivory Coast,Zambia,1985,0,1,1
Egypt,Zambia,1985,1,0,1
DR Congo,Ivory Coast,1985,1,2,3
Saint Kitts and Nevis,Dominica,1985,2,1,3
Congo,Ivory Coast,1985,2,1,3
Congo,Ivory Coast,1985,0,1,1
Iraq,Syria,1985,3,1,4
Dominica,Saint Kitts and Nevis,1985,0,1,1
Mexico,South Korea,1985,2,1,3
Australia,Scotland,1985,0,0,0
Gabon,Congo,1985,1,0,1
Mexico,Algeria,1985,2,0,2
Cameroon,Equatorial Guinea,1985,2,0,2
Tunisia,Poland,1985,1,0,1
Central African Republic,Congo,1985,1,4,5
Hungary,South Korea,1985,1,0,1
Chad,Equatorial Guinea,1985,1,1,2
Mexico,South Korea,1985,2,1,3
Algeria,Hungary,1985,1,3,4
Gabon,Central African Republic,1985,4,0,4
Turkey,Poland,1985,1,1,2
Chad,Cameroon,1985,2,2,4
Algeria,South Korea,1985,0,2,2
Gabon,Chad,1985,3,0,3
Mexico,Hungary,1985,2,0,2
Congo,Cameroon,1985,1,0,1
Gambia,Guinea,1985,0,0,0
Chad,Cameroon,1985,1,2,3
Spain,Bulgaria,1985,2,0,2
Gabon,Congo,1985,3,0,3
Senegal,Guinea,1985,3,1,4
Ivory Coast,Guinea,1985,1,0,1
Senegal,Ivory Coast,1985,2,0,2
Qatar,China PR,1986,1,1,2
Qatar,Greece,1986,0,1,1
Gabon,Senegal,1986,0,1,1
Portugal,Finland,1986,1,1,2
Spain,Russia,1986,2,0,2
Qatar,Tunisia,1986,2,1,3
India,China PR,1986,0,0,0
Oman,Tunisia,1986,0,0,0
China PR,Peru,1986,3,1,4
Israel,Scotland,1986,0,1,1
Canada,Paraguay,1986,0,0,0
Egypt,England,1986,0,4,4
India,Peru,1986,0,1,1
Senegal,Guinea,1986,2,1,3
Canada,Uruguay,1986,1,3,4
Gambia,Guinea-Bissau,1986,3,0,3
Mauritania,Sierra Leone,1986,0,1,1
Qatar,Hungary,1986,0,3,3
Guinea,Mali,1986,1,1,2
Gambia,Sierra Leone,1986,1,2,3
Guinea-Bissau,Mauritania,1986,1,0,1
Italy,Germany,1986,1,2,3
Jamaica,Paraguay,1986,1,4,5
Portugal,Luxembourg,1986,2,0,2
Senegal,Mali,1986,1,0,1
United States,Canada,1986,0,0,0
Gambia,Mauritania,1986,3,1,4
Guinea-Bissau,Sierra Leone,1986,2,3,5
United States,Uruguay,1986,1,1,2
Guinea,Sierra Leone,1986,1,2,3
Senegal,Gambia,1986,1,0,1
Bulgaria,German DR,1986,1,2,3
Senegal,Sierra Leone,1986,3,1,4
South Korea,Paraguay,1986,1,3,4
Mexico,German DR,1986,1,2,3
Zambia,Botswana,1986,6,0,6
Indonesia,Paraguay,1986,2,3,5
Iran,Pakistan,1986,2,0,2
Uruguay,Poland,1986,2,2,4
Zambia,Botswana,1986,3,0,3
Saudi Arabia,Algeria,1986,0,0,0
Greece,Cyprus,1986,0,0,0
Mexico,Russia,1986,1,0,1
Morocco,Bulgaria,1986,0,0,0
Portugal,German DR,1986,1,3,4
Spain,Belgium,1986,3,0,3
Iran,Ghana,1986,2,0,2
Bahrain,Finland,1986,0,0,0
Saudi Arabia,Algeria,1986,1,1,2
Liberia,Burkina Faso,1986,0,1,1
Bahrain,Finland,1986,0,4,4
Burkina Faso,Togo,1986,0,1,1
Ghana,Niger,1986,2,0,2
Algeria,Mozambique,1986,4,1,5
Ghana,Togo,1986,2,2,4
Liberia,Niger,1986,3,0,3
Saudi Arabia,Wales,1986,1,2,3
Burkina Faso,Niger,1986,0,0,0
France,Northern Ireland,1986,0,0,0
Ghana,Liberia,1986,3,0,3
Grenada,Norway,1986,1,2,3
Israel,England,1986,1,2,3
Qatar,Paraguay,1986,1,1,2
Tunisia,Cameroon,1986,1,1,2
Ghana,Burkina Faso,1986,2,0,2
Togo,Liberia,1986,1,0,1
Egypt,Romania,1986,2,2,4
Niger,Togo,1986,3,1,4
Saudi Arabia,Finland,1986,0,1,1
Ghana,Burkina Faso,1986,2,0,2
Qatar,Paraguay,1986,0,3,3
Saint Lucia,Norway,1986,0,6,6
Togo,Niger,1986,3,1,4
Burkina Faso,Niger,1986,1,2,3
Egypt,Romania,1986,0,1,1
Ghana,Togo,1986,1,0,1
Guadeloupe,Norway,1986,1,2,3
Martinique,Norway,1986,0,1,1
Thailand,Indonesia,1986,1,1,2
Mexico,Denmark,1986,1,1,2
Egypt,Senegal,1986,0,1,1
Ivory Coast,Mozambique,1986,3,0,3
Algeria,Morocco,1986,0,0,0
Bahrain,Paraguay,1986,1,2,3
Cameroon,Zambia,1986,3,2,5
Egypt,Ivory Coast,1986,2,0,2
Mozambique,Senegal,1986,0,2,2
Algeria,Zambia,1986,0,0,0
Bahrain,Iceland,1986,2,1,3
Cameroon,Morocco,1986,1,1,2
German DR,Netherlands,1986,0,1,1
Germany,Brazil,1986,2,0,2
Saudi Arabia,Paraguay,1986,0,0,0
Turkey,Switzerland,1986,1,0,1
Egypt,Mozambique,1986,2,0,2
Ivory Coast,Senegal,1986,1,0,1
Algeria,Cameroon,1986,2,3,5
Djibouti,Ethiopia,1986,1,5,6
Iraq,Romania,1986,1,1,2
Morocco,Zambia,1986,1,0,1
Bahrain,Iceland,1986,0,2,2
Hungary,Brazil,1986,3,0,3
Cameroon,Ivory Coast,1986,1,0,1
Egypt,Morocco,1986,1,0,1
Djibouti,Ethiopia,1986,1,1,2
Kuwait,Iceland,1986,1,0,1
Ivory Coast,Morocco,1986,3,2,5
Egypt,Cameroon,1986,0,0,0
Bahrain,Iraq,1986,0,0,0
Qatar,Oman,1986,2,1,3
Saudi Arabia,Kuwait,1986,1,3,4
United Arab Emirates,Iraq,1986,2,2,4
Bahrain,Saudi Arabia,1986,2,1,3
Kuwait,Oman,1986,2,0,2
France,Argentina,1986,2,0,2
Greece,German DR,1986,2,0,2
Republic of Ireland,Wales,1986,0,1,1
Italy,Austria,1986,2,1,3
Northern Ireland,Denmark,1986,1,1,2
Russia,England,1986,0,1,1
Scotland,Romania,1986,3,0,3
Spain,Poland,1986,3,0,3
Qatar,Iraq,1986,1,1,2
Saudi Arabia,Oman,1986,3,1,4
United Arab Emirates,Kuwait,1986,0,1,1
Bahrain,Qatar,1986,0,0,0
Iraq,Saudi Arabia,1986,1,2,3
Oman,United Arab Emirates,1986,0,1,1
Brazil,Peru,1986,4,0,4
Kuwait,Qatar,1986,2,1,3
Bahrain,Oman,1986,0,0,0
Saudi Arabia,United Arab Emirates,1986,0,2,2
Iraq,Kuwait,1986,1,2,3
Bahrain,United Arab Emirates,1986,1,3,4
Qatar,Saudi Arabia,1986,0,2,2
Oman,Iraq,1986,2,3,5
Bahrain,Kuwait,1986,1,1,2
Qatar,United Arab Emirates,1986,3,2,5
Brazil,German DR,1986,3,0,3
Bulgaria,Denmark,1986,3,0,3
Switzerland,Germany,1986,0,1,1
Mexico,Uruguay,1986,1,0,1
Brazil,Finland,1986,3,0,3
Wales,Uruguay,1986,0,0,0
Belgium,Bulgaria,1986,2,0,2
Czechoslovakia,German DR,1986,2,0,2
England,Scotland,1986,2,1,3
Republic of Ireland,Uruguay,1986,1,1,2
Northern Ireland,Morocco,1986,2,1,3
Romania,Russia,1986,2,1,3
China PR,Nepal,1986,5,0,5
Pakistan,Sri Lanka,1986,1,0,1
Pakistan,South Korea,1986,1,0,1
Eswatini,Botswana,1986,0,1,1
Mexico,Canada,1986,3,0,3
Nepal,Sri Lanka,1986,2,2,4
Pakistan,China PR,1986,0,3,3
South Korea,Nepal,1986,5,0,5
Netherlands,Scotland,1986,0,0,0
Brazil,Yugoslavia,1986,4,2,6
Bulgaria,North Korea,1986,3,0,3
South Korea,Sri Lanka,1986,4,0,4
Norway,Argentina,1986,1,0,1
China PR,Sri Lanka,1986,3,0,3
Sweden,Greece,1986,0,0,0
China PR,South Korea,1986,1,1,2
Pakistan,Nepal,1986,5,0,5
Switzerland,Algeria,1986,2,0,2
Brazil,Chile,1986,1,1,2
Russia,Finland,1986,0,0,0
French Guiana,Réunion,1986,0,0,0
Canada,Wales,1986,2,0,2
Germany,Yugoslavia,1986,1,1,2
Italy,China PR,1986,2,0,2
Japan,Algeria,1986,2,1,3
Norway,Denmark,1986,1,0,1
Austria,Sweden,1986,1,0,1
Germany,Netherlands,1986,3,1,4
Denmark,Poland,1986,1,0,1
Mexico,England,1986,0,3,3
Belgium,Yugoslavia,1986,1,3,4
Canada,Wales,1986,0,3,3
Panama,Dominican Republic,1986,2,1,3
Canada,England,1986,0,1,1
Iceland,Republic of Ireland,1986,1,2,3
Czechoslovakia,Republic of Ireland,1986,0,1,1
China PR,Iran,1986,2,1,3
Iceland,Czechoslovakia,1986,1,2,3
Bulgaria,Italy,1986,1,1,2
Macau,Hong Kong,1986,2,3,5
Canada,France,1986,0,1,1
Spain,Brazil,1986,0,1,1
Argentina,South Korea,1986,3,1,4
Morocco,Poland,1986,0,0,0
Russia,Hungary,1986,6,0,6
Algeria,Northern Ireland,1986,1,1,2
Djibouti,Ethiopia,1986,0,2,2
Mexico,Belgium,1986,2,1,3
Portugal,England,1986,1,0,1
Nepal,Hong Kong,1986,4,2,6
Paraguay,Iraq,1986,1,0,1
Romania,Norway,1986,3,1,4
Scotland,Denmark,1986,0,1,1
Uruguay,Germany,1986,1,1,2
France,Russia,1986,1,1,2
Italy,Argentina,1986,1,1,2
South Korea,Bulgaria,1986,1,1,2
Brazil,Algeria,1986,1,0,1
England,Morocco,1986,0,0,0
Hungary,Canada,1986,2,0,2
Mauritius,Réunion,1986,0,1,1
Mexico,Paraguay,1986,1,1,2
Nepal,Bhutan,1986,4,0,4
Northern Ireland,Spain,1986,1,2,3
Poland,Portugal,1986,1,0,1
Denmark,Uruguay,1986,6,1,7
Germany,Scotland,1986,2,1,3
Iraq,Belgium,1986,1,2,3
Hungary,France,1986,0,3,3
Russia,Canada,1986,2,0,2
Argentina,Bulgaria,1986,2,0,2
South Korea,Italy,1986,2,3,5
England,Poland,1986,3,0,3
Guyana,Barbados,1986,2,1,3
Mexico,Iraq,1986,1,0,1
Paraguay,Belgium,1986,2,2,4
Portugal,Morocco,1986,1,3,4
Algeria,Spain,1986,0,3,3
Northern Ireland,Brazil,1986,0,3,3
Denmark,Germany,1986,2,0,2
Réunion,Mauritius,1986,0,0,0
Scotland,Uruguay,1986,0,0,0
Mexico,Bulgaria,1986,2,0,2
Russia,Belgium,1986,3,4,7
Argentina,Uruguay,1986,1,0,1
Brazil,Poland,1986,4,0,4
Italy,France,1986,0,2,2
Morocco,Germany,1986,0,1,1
Denmark,Spain,1986,1,5,6
England,Paraguay,1986,3,0,3
Brazil,France,1986,1,1,2
Malawi,Zambia,1986,0,2,2
Mexico,Germany,1986,0,0,0
Argentina,England,1986,2,1,3
Malawi,Zambia,1986,0,1,1
Spain,Belgium,1986,1,1,2
Argentina,Belgium,1986,2,0,2
France,Germany,1986,0,2,2
France,Belgium,1986,4,2,6
Argentina,Germany,1986,3,2,5
Myanmar,India,1986,3,1,4
Malawi,Uganda,1986,2,1,3
Malawi,Uganda,1986,0,0,0
Malawi,Uganda,1986,0,0,0
Malaysia,India,1986,3,0,3
Japan,Syria,1986,2,1,3
Liberia,Guinea,1986,0,0,0
Malaysia,Thailand,1986,2,0,2
Nigeria,Togo,1986,2,2,4
Guinea,Ivory Coast,1986,0,2,2
Ghana,Nigeria,1986,2,0,2
India,Thailand,1986,3,1,4
Liberia,Ivory Coast,1986,0,2,2
China PR,Congo,1986,1,1,2
Ghana,Togo,1986,1,1,2
Liberia,Guinea,1986,2,1,3
Malaysia,Japan,1986,2,1,3
Ghana,Ivory Coast,1986,0,1,1
Liberia,Togo,1986,1,0,1
Australia,Czechoslovakia,1986,1,1,2
Australia,Czechoslovakia,1986,0,1,1
Finland,Sweden,1986,1,3,4
Australia,Czechoslovakia,1986,0,3,3
Bahrain,Oman,1986,2,3,5
Senegal,Gabon,1986,1,0,1
Bahrain,Oman,1986,2,0,2
Guinea,Gambia,1986,2,1,3
Switzerland,France,1986,2,0,2
Finland,German DR,1986,1,0,1
Indonesia,Algeria,1986,0,1,1
Norway,Romania,1986,2,2,4
Sweden,Russia,1986,0,0,0
Malaysia,Algeria,1986,2,2,4
China PR,North Korea,1986,0,0,0
Oman,Bahrain,1986,1,0,1
Singapore,Canada,1986,0,1,1
Oman,Bahrain,1986,1,2,3
Austria,Switzerland,1986,1,1,2
Canada,North Korea,1986,0,0,0
Gambia,Guinea,1986,0,1,1
Singapore,North Korea,1986,0,2,2
China PR,Canada,1986,1,0,1
Singapore,China PR,1986,0,3,3
Singapore,China PR,1986,1,2,3
Canada,North Korea,1986,0,2,2
China PR,North Korea,1986,2,1,3
Singapore,Canada,1986,0,1,1
Singapore,Saudi Arabia,1986,0,4,4
Norway,Hungary,1986,0,0,0
Belgium,Republic of Ireland,1986,2,2,4
Czechoslovakia,Netherlands,1986,1,0,1
Finland,Wales,1986,1,1,2
German DR,Denmark,1986,0,1,1
Iceland,France,1986,0,0,0
Romania,Austria,1986,4,0,4
Scotland,Bulgaria,1986,0,0,0
Sweden,England,1986,1,0,1
Fiji,New Zealand,1986,2,4,6
Fiji,New Zealand,1986,1,2,3
Iran,Thailand,1986,4,0,4
Uganda,Rwanda,1986,1,0,1
Denmark,Germany,1986,0,2,2
Iceland,Russia,1986,1,1,2
Norway,German DR,1986,0,0,0
Spain,Greece,1986,3,1,4
Sweden,Switzerland,1986,2,0,2
Zambia,DR Congo,1986,2,2,4
Zambia,DR Congo,1986,0,1,1
Botswana,Malawi,1986,2,0,2
Sierra Leone,Liberia,1986,2,1,3
Angola,Gabon,1986,1,0,1
Uganda,Somalia,1986,5,0,5
Central African Republic,Congo,1986,1,2,3
Ethiopia,Tanzania,1986,4,2,6
Kenya,Somalia,1986,2,1,3
Poland,North Korea,1986,2,2,4
Israel,Romania,1986,2,4,6
Italy,Greece,1986,2,0,2
France,Russia,1986,0,2,2
Uganda,Kenya,1986,3,1,4
Portugal,Sweden,1986,1,1,2
Luxembourg,Belgium,1986,0,6,6
Austria,Albania,1986,3,0,3
Czechoslovakia,Finland,1986,3,0,3
England,Northern Ireland,1986,3,0,3
Germany,Spain,1986,2,2,4
Hungary,Netherlands,1986,0,1,1
Republic of Ireland,Scotland,1986,0,0,0
Poland,Greece,1986,2,1,3
Congo,Central African Republic,1986,5,1,6
Gabon,Angola,1986,1,0,1
Liberia,Sierra Leone,1986,1,1,2
Somalia,Uganda,1986,0,0,0
New Zealand,Australia,1986,1,1,2
Honduras,Panama,1986,1,0,1
Austria,Germany,1986,4,1,5
Denmark,Finland,1986,1,0,1
German DR,Iceland,1986,2,0,2
Russia,Norway,1986,4,0,4
Switzerland,Portugal,1986,1,1,2
Tunisia,Bulgaria,1986,3,3,6
Yugoslavia,Turkey,1986,4,0,4
Cuba,Panama,1986,1,1,2
Australia,New Zealand,1986,2,1,3
Czechoslovakia,Denmark,1986,0,0,0
England,Yugoslavia,1986,2,0,2
Greece,Hungary,1986,2,1,3
Poland,Republic of Ireland,1986,1,0,1
Scotland,Luxembourg,1986,3,0,3
Spain,Romania,1986,1,0,1
Turkey,Northern Ireland,1986,0,0,0
Italy,Switzerland,1986,3,2,5
Malta,Sweden,1986,0,5,5
Belgium,Bulgaria,1986,1,1,2
German DR,France,1986,0,0,0
Netherlands,Poland,1986,0,0,0
China PR,Australia,1986,0,2,2
Kenya,Rwanda,1986,2,3,5
Albania,Spain,1986,1,2,3
Cyprus,Greece,1986,2,4,6
Nepal,Bangladesh,1986,1,0,1
South Korea,Malaysia,1986,2,1,3
Malta,Italy,1986,0,2,2
Angola,Tanzania,1986,1,0,1
Equatorial Guinea,Cameroon,1986,0,2,2
Angola,Zambia,1986,0,1,1
Congo,Gabon,1986,0,1,1
Algeria,Ivory Coast,1986,2,1,3
Chad,Cameroon,1986,1,3,4
Nepal,South Korea,1986,1,2,3
Saint Lucia,Saint Vincent and the Grenadines,1986,5,1,6
Central African Republic,Congo,1986,1,3,4
Equatorial Guinea,Chad,1986,0,1,1
Algeria,Ivory Coast,1986,2,1,3
Central African Republic,Gabon,1986,0,1,1
Congo,Cameroon,1986,0,1,1
Chad,Gabon,1986,0,0,0
Chad,Cameroon,1986,1,4,5
Cyprus,Netherlands,1986,0,2,2
Barbados,Saint Vincent and the Grenadines,1987,3,0,3
Portugal,Greece,1987,1,1,2
El Salvador,Mexico,1987,1,3,4
Greece,Cyprus,1987,3,1,4
India,China PR,1987,1,1,2
Mali,Burkina Faso,1987,2,0,2
Guinea,Mali,1987,1,0,1
Spain,Netherlands,1987,1,1,2
Italy,Malta,1987,5,0,5
Niger,Mali,1987,1,0,1
Nigeria,Syria,1987,1,0,1
Saint Lucia,Guyana,1987,1,3,4
Ivory Coast,Ghana,1987,0,2,2
Liberia,Burkina Faso,1987,2,0,2
Niger,Ghana,1987,0,4,4
Liberia,Benin,1987,0,0,0
Niger,Ivory Coast,1987,0,1,1
Portugal,Belgium,1987,1,0,1
Burkina Faso,Benin,1987,3,2,5
Cayman Islands,Jamaica,1987,1,3,4
Tunisia,Austria,1987,1,3,4
Cyprus,Hungary,1987,0,1,1
Liberia,Ghana,1987,1,2,3
Portugal,Italy,1987,0,1,1
Kuwait,Algeria,1987,2,0,2
Israel,Northern Ireland,1987,1,1,2
Scotland,Republic of Ireland,1987,0,1,1
Spain,England,1987,2,4,6
Wales,Russia,1987,0,0,0
Panama,Cuba,1987,1,0,1
Thailand,Oman,1987,2,0,2
North Korea,Russia,1987,1,0,1
Kuwait,Iraq,1987,2,0,2
Guinea,Mauritania,1987,1,0,1
Guinea-Bissau,Mali,1987,0,0,0
Panama,Cuba,1987,1,3,4
Senegal,Sierra Leone,1987,0,1,1
Guinea,Mali,1987,0,0,0
Guinea-Bissau,Mauritania,1987,1,1,2
Cape Verde,Senegal,1987,0,2,2
Dominican Republic,Panama,1987,0,2,2
Guinea,Guinea-Bissau,1987,0,0,0
Kuwait,Iceland,1987,1,1,2
Mali,Mauritania,1987,1,0,1
Cape Verde,Sierra Leone,1987,0,2,2
Dominican Republic,Panama,1987,1,2,3
Dominican Republic,Panama,1987,1,1,2
Kuwait,Iceland,1987,0,1,1
Guinea,Senegal,1987,1,0,1
Mali,Sierra Leone,1987,0,0,0
Senegal,Sierra Leone,1987,0,0,0
Dominican Republic,Panama,1987,0,1,1
Guinea,Mali,1987,1,0,1
Turkey,Romania,1987,1,3,4
Palau,Vanuatu,1987,2,6,8
Greece,Romania,1987,1,1,2
Barbados,Guyana,1987,2,2,4
Mexico,China PR,1987,3,2,5
Ivory Coast,DR Congo,1987,2,1,3
Poland,Finland,1987,3,1,4
United Arab Emirates,Syria,1987,1,1,2
Guatemala,El Salvador,1987,2,0,2
Ivory Coast,DR Congo,1987,1,3,4
United Arab Emirates,Syria,1987,2,1,3
Poland,Norway,1987,4,1,5
Israel,Germany,1987,0,2,2
Jordan,Cyprus,1987,2,1,3
Netherlands,Greece,1987,1,1,2
Panama,Cuba,1987,0,0,0
Romania,Albania,1987,5,1,6
Switzerland,Czechoslovakia,1987,1,2,3
Turkey,German DR,1987,3,1,4
Yugoslavia,Austria,1987,4,0,4
Algeria,Tunisia,1987,1,0,1
Botswana,Mauritius,1987,0,0,0
Kenya,Madagascar,1987,2,0,2
Nigeria,Togo,1987,2,0,2
Cameroon,Uganda,1987,5,1,6
DR Congo,Angola,1987,3,0,3
Ivory Coast,Congo,1987,2,0,2
Mozambique,Zimbabwe,1987,1,1,2
Portugal,Malta,1987,2,2,4
Senegal,Guinea,1987,4,0,4
Sudan,Tanzania,1987,1,0,1
Ghana,Sierra Leone,1987,1,2,3
Ecuador,Cuba,1987,0,1,1
Austria,Spain,1987,2,3,5
Belgium,Scotland,1987,4,1,5
Bulgaria,Republic of Ireland,1987,2,1,3
Northern Ireland,England,1987,0,2,2
Wales,Finland,1987,4,0,4
Ecuador,Cuba,1987,0,0,0
Congo,Ivory Coast,1987,1,2,3
Bahrain,Iraq,1987,1,3,4
Gabon,Ivory Coast,1987,1,0,1
Romania,Israel,1987,3,2,5
Bahrain,Iraq,1987,1,2,3
Angola,DR Congo,1987,1,0,1
Zimbabwe,Mozambique,1987,1,0,1
Uganda,Cameroon,1987,3,1,4
Sierra Leone,Ghana,1987,0,0,0
Tanzania,Sudan,1987,1,1,2
Guinea,Senegal,1987,0,0,0
Madagascar,Kenya,1987,2,1,3
Poland,Cyprus,1987,0,0,0
Togo,Nigeria,1987,1,1,2
Tunisia,Algeria,1987,1,1,2
Netherlands,Czechoslovakia,1987,1,0,1
Switzerland,Malta,1987,4,1,5
Germany,Italy,1987,0,0,0
Russia,Sweden,1987,1,3,4
Zimbabwe,Zambia,1987,0,1,1
Albania,Austria,1987,0,1,1
Finland,Denmark,1987,0,1,1
France,Iceland,1987,2,0,2
Greece,Poland,1987,1,0,1
Honduras,El Salvador,1987,1,0,1
Republic of Ireland,Belgium,1987,0,0,0
Jamaica,Cuba,1987,2,0,2
Netherlands,Hungary,1987,2,0,2
Northern Ireland,Yugoslavia,1987,1,2,3
Romania,Spain,1987,3,1,4
Russia,German DR,1987,2,0,2
Turkey,England,1987,0,0,0
Wales,Czechoslovakia,1987,1,1,2
Luxembourg,Bulgaria,1987,1,4,5
El Salvador,Honduras,1987,1,2,3
New Caledonia,Tahiti,1987,0,0,0
German DR,Czechoslovakia,1987,2,0,2
Hungary,Poland,1987,5,3,8
England,Brazil,1987,1,1,2
Switzerland,Israel,1987,1,0,1
Bulgaria,Luxembourg,1987,3,0,3
Burkina Faso,Mauritania,1987,2,1,3
Republic of Ireland,Brazil,1987,1,0,1
Scotland,England,1987,0,0,0
Sweden,Malta,1987,1,0,1
Scotland,Brazil,1987,0,2,2
Japan,Senegal,1987,2,2,4
Finland,Brazil,1987,2,3,5
Guadeloupe,French Guiana,1987,4,1,5
Luxembourg,Republic of Ireland,1987,0,2,2
Norway,Italy,1987,0,0,0
Guadeloupe,Réunion,1987,3,0,3
Hong Kong,Macau,1987,5,0,5
Israel,Brazil,1987,0,4,4
Denmark,Czechoslovakia,1987,1,1,2
Iceland,German DR,1987,0,6,6
Norway,Russia,1987,0,1,1
Sweden,Italy,1987,1,0,1
Egypt,United States,1987,3,1,4
Australia,Morocco,1987,1,0,1
Argentina,Italy,1987,1,3,4
South Korea,Egypt,1987,0,0,0
Colombia,Ecuador,1987,1,0,1
Egypt,Thailand,1987,1,1,2
South Korea,United States,1987,1,0,1
Malawi,Zimbabwe,1987,1,4,5
Bolivia,Paraguay,1987,0,2,2
Congo,Seychelles,1987,1,1,2
Ecuador,Colombia,1987,3,0,3
South Korea,Thailand,1987,4,2,6
Malawi,Zimbabwe,1987,2,1,3
Norway,France,1987,2,0,2
Thailand,United States,1987,0,1,1
Switzerland,Sweden,1987,1,1,2
Madagascar,Seychelles,1987,2,0,2
Australia,Egypt,1987,0,0,0
Peru,Chile,1987,1,3,4
Uruguay,Ecuador,1987,2,1,3
Argentina,Paraguay,1987,0,1,1
Brazil,Ecuador,1987,4,1,5
South Korea,Australia,1987,1,1,2
Madagascar,Congo,1987,3,2,5
Peru,Chile,1987,2,0,2
Uruguay,Bolivia,1987,2,1,3
Chile,Peru,1987,1,0,1
Argentina,Peru,1987,1,1,2
Brazil,Venezuela,1987,5,0,5
Paraguay,Bolivia,1987,0,0,0
Zambia,Ivory Coast,1987,2,0,2
Venezuela,Chile,1987,1,3,4
Bolivia,Colombia,1987,0,2,2
Argentina,Ecuador,1987,3,0,3
Chile,Brazil,1987,4,0,4
Malawi,Ivory Coast,1987,1,2,3
Nigeria,Sierra Leone,1987,3,0,3
Peru,Ecuador,1987,1,1,2
Cameroon,Sudan,1987,2,0,2
Colombia,Paraguay,1987,3,0,3
Senegal,DR Congo,1987,0,0,0
Zimbabwe,Kenya,1987,1,1,2
Malawi,Burundi,1987,1,1,2
Chile,Colombia,1987,2,1,3
Malawi,Burundi,1987,1,1,2
Argentina,Uruguay,1987,0,1,1
Argentina,Colombia,1987,1,2,3
Malawi,Burundi,1987,2,4,6
Chile,Uruguay,1987,0,1,1
Kenya,Zimbabwe,1987,0,0,0
Sierra Leone,Nigeria,1987,2,0,2
Sudan,Cameroon,1987,1,0,1
DR Congo,Senegal,1987,0,0,0
Ivory Coast,Malawi,1987,2,0,2
São Tomé and Príncipe,Guinea-Bissau,1987,0,2,2
Angola,Guinea-Bissau,1987,0,0,0
Liberia,Morocco,1987,2,1,3
Liberia,Ghana,1987,0,0,0
São Tomé and Príncipe,Angola,1987,1,1,2
German DR,Hungary,1987,0,0,0
Indonesia,Algeria,1987,2,1,3
Indonesia,South Korea,1987,1,1,2
Algeria,South Korea,1987,2,0,2
Indonesia,Algeria,1987,2,1,3
Germany,France,1987,2,1,3
Norway,Sweden,1987,0,0,0
Switzerland,Austria,1987,2,2,4
Poland,German DR,1987,2,0,2
Sweden,Denmark,1987,1,0,1
Yugoslavia,Russia,1987,0,1,1
Australia,New Zealand,1987,1,1,2
Poland,Romania,1987,3,1,4
Guyana,Grenada,1987,1,1,2
Guyana,Grenada,1987,3,0,3
Finland,Czechoslovakia,1987,3,0,3
Germany,England,1987,3,1,4
Iceland,Norway,1987,2,1,3
Republic of Ireland,Luxembourg,1987,2,1,3
Netherlands,Belgium,1987,0,0,0
New Zealand,Australia,1987,1,0,1
Russia,France,1987,1,1,2
Scotland,Hungary,1987,2,0,2
Wales,Denmark,1987,1,0,1
Guyana,Trinidad and Tobago,1987,1,2,3
Bulgaria,Belgium,1987,2,0,2
German DR,Tunisia,1987,2,0,2
Germany,Denmark,1987,1,0,1
Italy,Yugoslavia,1987,1,0,1
Norway,Iceland,1987,0,1,1
Poland,Hungary,1987,3,2,5
Russia,Greece,1987,3,0,3
Spain,Luxembourg,1987,2,0,2
Sweden,Portugal,1987,0,1,1
El Salvador,Canada,1987,2,1,3
Honduras,Canada,1987,1,1,2
Mexico,Canada,1987,4,0,4
El Salvador,Guatemala,1987,1,0,1
Romania,Greece,1987,2,2,4
German DR,Russia,1987,1,1,2
Denmark,Wales,1987,1,0,1
England,Turkey,1987,8,0,8
France,Norway,1987,1,1,2
Germany,Sweden,1987,1,1,2
Hungary,Greece,1987,3,0,3
Republic of Ireland,Bulgaria,1987,2,0,2
Poland,Netherlands,1987,0,2,2
Scotland,Belgium,1987,2,0,2
Spain,Austria,1987,2,0,2
Yugoslavia,Northern Ireland,1987,3,0,3
Switzerland,Italy,1987,0,0,0
Zambia,Angola,1987,2,0,2
Barbados,Martinique,1987,1,1,2
Czechoslovakia,Poland,1987,3,1,4
Albania,Romania,1987,0,1,1
German DR,Norway,1987,3,1,4
Netherlands,Cyprus,1987,8,0,8
Russia,Iceland,1987,2,0,2
Liberia,Ghana,1987,0,2,2
Kuwait,Egypt,1987,0,2,2
Mali,Central African Republic,1987,3,1,4
Republic of Ireland,Israel,1987,5,0,5
Belgium,Luxembourg,1987,3,0,3
Bulgaria,Scotland,1987,0,1,1
Cyprus,Poland,1987,0,1,1
Czechoslovakia,Wales,1987,2,0,2
French Guiana,Suriname,1987,1,1,2
Northern Ireland,Turkey,1987,1,0,1
Portugal,Switzerland,1987,0,0,0
Yugoslavia,England,1987,1,4,5
Italy,Sweden,1987,2,1,3
Malta,Switzerland,1987,1,1,2
Austria,Romania,1987,0,0,0
France,German DR,1987,0,1,1
Hungary,Germany,1987,0,0,0
Spain,Albania,1987,5,0,5
Togo,Central African Republic,1987,1,0,1
Burkina Faso,Nigeria,1987,0,0,0
Ivory Coast,Togo,1987,3,0,3
Barbados,Trinidad and Tobago,1987,0,4,4
Gabon,Angola,1987,0,0,0
Hungary,Cyprus,1987,1,0,1
Israel,Malta,1987,1,1,2
Luxembourg,Scotland,1987,0,0,0
Tunisia,Malawi,1987,2,3,5
Italy,Portugal,1987,3,0,3
Suriname,French Guiana,1987,1,0,1
Mali,Burkina Faso,1987,1,2,3
Trinidad and Tobago,Barbados,1987,5,1,6
Chad,Central African Republic,1987,2,1,3
Angola,Cuba,1987,3,2,5
Benin,Ghana,1987,1,1,2
Cameroon,Equatorial Guinea,1987,1,0,1
Brazil,Chile,1987,2,1,3
Central African Republic,Gabon,1987,1,1,2
Netherlands,Cyprus,1987,4,0,4
New Caledonia,American Samoa,1987,10,0,10
Papua New Guinea,Tahiti,1987,0,0,0
Vanuatu,Wallis Islands and Futuna,1987,6,1,7
American Samoa,Vanuatu,1987,0,7,7
Angola,Benin,1987,0,0,0
Burkina Faso,Mali,1987,1,2,3
Cameroon,Equatorial Guinea,1987,0,0,0
Cuba,Ghana,1987,1,1,2
New Caledonia,Papua New Guinea,1987,2,0,2
Tahiti,Wallis Islands and Futuna,1987,4,0,4
Algeria,Tunisia,1987,0,0,0
Chad,Gabon,1987,1,1,2
American Samoa,Wallis Islands and Futuna,1987,1,5,6
Brazil,Germany,1987,1,1,2
New Caledonia,Tahiti,1987,2,3,5
Papua New Guinea,Vanuatu,1987,1,1,2
Burkina Faso,Mali,1987,2,1,3
Ethiopia,Tanzania,1987,0,0,0
Malawi,Zimbabwe,1987,1,1,2
Mauritania,Tunisia,1987,1,2,3
Togo,Ivory Coast,1987,1,0,1
Kenya,Zanzibar,1987,0,0,0
Uganda,Zambia,1987,4,0,4
Algeria,Mauritania,1987,3,0,3
American Samoa,Papua New Guinea,1987,0,20,20
Chad,Equatorial Guinea,1987,4,0,4
New Caledonia,Wallis Islands and Futuna,1987,5,1,6
Tahiti,Vanuatu,1987,2,1,3
Argentina,Germany,1987,1,0,1
Cameroon,Gabon,1987,1,0,1
Greece,Netherlands,1987,0,3,3
Israel,Switzerland,1987,0,2,2
Kenya,Tanzania,1987,3,2,5
Turkey,Yugoslavia,1987,2,3,5
Uganda,Zimbabwe,1987,0,0,0
Ethiopia,Zanzibar,1987,0,0,0
Malawi,Zambia,1987,2,1,3
Malaysia,South Korea,1987,0,1,1
New Caledonia,Vanuatu,1987,6,0,6
Papua New Guinea,Wallis Islands and Futuna,1987,2,0,2
Chad,Cameroon,1987,0,1,1
Equatorial Guinea,Gabon,1987,0,0,0
Ivory Coast,Senegal,1987,1,0,1
New Caledonia,Tahiti,1987,1,0,1
Papua New Guinea,Vanuatu,1987,3,1,4
Tanzania,Zanzibar,1987,0,2,2
Ethiopia,Kenya,1987,2,1,3
Liberia,Burkina Faso,1987,1,0,1
Malawi,Uganda,1987,0,2,2
Malta,Portugal,1987,0,1,1
Burkina Faso,Senegal,1987,0,1,1
Liberia,Ivory Coast,1987,1,2,3
Zanzibar,Zimbabwe,1987,0,1,1
Ethiopia,Uganda,1987,3,0,3
Uganda,Zanzibar,1987,2,0,2
Ethiopia,Zimbabwe,1987,1,1,2
Gambia,Ghana,1988,0,2,2
Algeria,Congo,1988,4,1,5
Gambia,Ghana,1988,0,0,0
Guatemala,Costa Rica,1988,1,2,3
South Korea,Egypt,1988,1,1,2
Guatemala,United States,1988,1,0,1
Czechoslovakia,Finland,1988,0,2,2
German DR,Sweden,1988,1,4,5
Guatemala,United States,1988,0,1,1
Honduras,Mexico,1988,0,1,1
Thailand,Indonesia,1988,3,3,6
Czechoslovakia,German DR,1988,1,0,1
Finland,Sweden,1988,0,1,1
Jordan,United Arab Emirates,1988,0,1,1
Indonesia,Oman,1988,3,0,3
Jordan,United Arab Emirates,1988,2,0,2
Israel,Belgium,1988,2,3,5
Thailand,Oman,1988,3,1,4
Malaysia,South Korea,1988,0,0,0
Qatar,Bulgaria,1988,2,3,5
United Arab Emirates,Bulgaria,1988,0,3,3
Israel,France,1988,1,1,2
Spain,German DR,1988,0,0,0
United Arab Emirates,Japan,1988,1,1,2
United Arab Emirates,Japan,1988,2,0,2
Austria,Morocco,1988,1,3,4
France,Switzerland,1988,2,1,3
Oman,Japan,1988,1,1,2
Egypt,Bulgaria,1988,1,0,1
Israel,Romania,1988,0,2,2
United Arab Emirates,Thailand,1988,3,0,3
Austria,Switzerland,1988,1,2,3
China PR,Yemen,1988,0,0,0
France,Morocco,1988,2,1,3
Bangladesh,India,1988,0,0,0
Poland,Romania,1988,2,2,4
Malta,Finland,1988,2,0,2
United Arab Emirates,Yemen,1988,2,1,3
China PR,Bangladesh,1988,4,0,4
Thailand,India,1988,1,0,1
Israel,Poland,1988,1,3,4
Malta,Tunisia,1988,2,1,3
United Arab Emirates,China PR,1988,0,0,0
Yemen,India,1988,1,0,1
Thailand,Bangladesh,1988,1,1,2
Finland,Tunisia,1988,3,0,3
United Arab Emirates,India,1988,3,0,3
Benin,Mali,1988,1,2,3
China PR,Thailand,1988,5,0,5
Yemen,Bangladesh,1988,0,0,0
China PR,India,1988,1,1,2
Yemen,Thailand,1988,3,3,6
Greece,Northern Ireland,1988,3,2,5
Israel,England,1988,0,0,0
Saudi Arabia,Scotland,1988,2,2,4
United Arab Emirates,Bangladesh,1988,4,0,4
Bermuda,Canada,1988,0,0,0
Italy,Russia,1988,4,1,5
United Arab Emirates,Egypt,1988,1,2,3
Spain,Czechoslovakia,1988,1,2,3
Djibouti,Yemen DPR,1988,4,1,5
Iraq,Tunisia,1988,2,0,2
United Arab Emirates,Egypt,1988,1,1,2
Costa Rica,Guatemala,1988,2,1,3
Saudi Arabia,Oman,1988,2,0,2
Morocco,German DR,1988,2,1,3
Qatar,Kuwait,1988,1,1,2
United Arab Emirates,Bahrain,1988,2,0,2
Iraq,Oman,1988,1,1,2
Kuwait,United Arab Emirates,1988,0,1,1
Saudi Arabia,Qatar,1988,0,0,0
Dominica,Antigua and Barbuda,1988,0,0,0
Oman,Bahrain,1988,0,2,2
Iraq,Kuwait,1988,1,0,1
Qatar,United Arab Emirates,1988,2,1,3
Saudi Arabia,Bahrain,1988,1,0,1
Libya,Malta,1988,1,0,1
Oman,Qatar,1988,2,1,3
United Arab Emirates,Iraq,1988,0,0,0
Guadeloupe,Suriname,1988,0,2,2
Kuwait,Bahrain,1988,0,1,1
Algeria,Ivory Coast,1988,1,1,2
Gambia,Mali,1988,2,1,3
Morocco,DR Congo,1988,1,1,2
Qatar,Iraq,1988,0,3,3
Saudi Arabia,United Arab Emirates,1988,2,2,4
Cameroon,Egypt,1988,1,0,1
Kenya,Nigeria,1988,0,3,3
Oman,Kuwait,1988,0,2,2
Bahrain,Qatar,1988,1,0,1
Guatemala,Uruguay,1988,1,0,1
Hungary,Turkey,1988,1,0,1
Ivory Coast,DR Congo,1988,1,1,2
Morocco,Algeria,1988,1,0,1
Saudi Arabia,Iraq,1988,0,2,2
Cameroon,Nigeria,1988,1,1,2
Egypt,Kenya,1988,3,0,3
United Arab Emirates,Oman,1988,1,0,1
Bahrain,Iraq,1988,0,1,1
El Salvador,Honduras,1988,0,0,0
Saudi Arabia,Kuwait,1988,0,0,0
Algeria,DR Congo,1988,1,0,1
Morocco,Ivory Coast,1988,0,0,0
Antigua and Barbuda,Dominica,1988,2,1,3
Cameroon,Kenya,1988,0,0,0
Egypt,Nigeria,1988,0,0,0
Malta,Scotland,1988,1,1,2
Algeria,Nigeria,1988,1,1,2
Bulgaria,Czechoslovakia,1988,2,0,2
England,Netherlands,1988,2,2,4
France,Spain,1988,2,1,3
Greece,Russia,1988,0,4,4
Republic of Ireland,Romania,1988,2,0,2
Morocco,Cameroon,1988,0,1,1
Northern Ireland,Poland,1988,1,1,2
Wales,Yugoslavia,1988,1,2,3
Belgium,Hungary,1988,3,0,3
Morocco,Algeria,1988,1,1,2
Peru,Canada,1988,1,3,4
Cameroon,Nigeria,1988,1,0,1
Mexico,El Salvador,1988,8,0,8
Colombia,Canada,1988,3,0,3
German DR,Romania,1988,3,3,6
Argentina,Russia,1988,2,4,6
Germany,Sweden,1988,1,1,2
Yugoslavia,Italy,1988,1,1,2
Germany,Argentina,1988,1,0,1
Sweden,Russia,1988,2,0,2
Jamaica,Canada,1988,0,4,4
Greece,Austria,1988,2,2,4
Jamaica,Canada,1988,0,0,0
Malaysia,Pakistan,1988,4,0,4
Kuwait,Japan,1988,1,0,1
El Salvador,Guatemala,1988,0,0,0
Jordan,Pakistan,1988,1,0,1
Malaysia,Japan,1988,0,1,1
Kuwait,Jordan,1988,0,0,0
Bulgaria,German DR,1988,1,1,2
Malaysia,Jordan,1988,0,0,0
Kuwait,Pakistan,1988,3,0,3
Japan,Jordan,1988,1,1,2
Guyana,Trinidad and Tobago,1988,0,4,4
Japan,Pakistan,1988,4,1,5
Malaysia,Kuwait,1988,0,5,5
Guadeloupe,Suriname,1988,1,1,2
El Salvador,Guatemala,1988,1,0,1
Mexico,Honduras,1988,4,1,5
Austria,Denmark,1988,1,0,1
Czechoslovakia,Russia,1988,1,1,2
Germany,Switzerland,1988,1,0,1
Hungary,England,1988,0,0,0
Republic of Ireland,Yugoslavia,1988,2,0,2
Luxembourg,Italy,1988,0,3,3
Northern Ireland,France,1988,0,0,0
Spain,Scotland,1988,0,0,0
Sweden,Wales,1988,4,1,5
Gambia,Senegal,1988,0,4,4
Guinea-Bissau,Sierra Leone,1988,0,0,0
Cape Verde,Mali,1988,1,3,4
Guinea,Mauritania,1988,1,1,2
Cuba,Guatemala,1988,0,1,1
Gambia,Sierra Leone,1988,1,3,4
Guinea-Bissau,Senegal,1988,1,1,2
Cape Verde,Mauritania,1988,3,2,5
Guinea,Mali,1988,1,0,1
Guinea-Bissau,Gambia,1988,3,1,4
Senegal,Sierra Leone,1988,2,2,4
Cape Verde,Guinea,1988,1,1,2
Mali,Mauritania,1988,2,2,4
Hungary,Iceland,1988,3,0,3
Guinea,Sierra Leone,1988,3,0,3
Mali,Senegal,1988,1,1,2
Senegal,Sierra Leone,1988,2,1,3
China PR,North Korea,1988,0,0,0
Guinea,Mali,1988,0,0,0
Trinidad and Tobago,Guyana,1988,1,0,1
Hungary,Denmark,1988,2,2,4
Guadeloupe,Togo,1988,2,1,3
Jamaica,Puerto Rico,1988,1,0,1
Réunion,Togo,1988,1,0,1
Guatemala,Cuba,1988,1,1,2
Macau,Hong Kong,1988,0,2,2
Hungary,Austria,1988,0,4,4
Scotland,Colombia,1988,0,0,0
Canada,Greece,1988,0,1,1
Finland,Colombia,1988,1,3,4
Canada,Greece,1988,0,3,3
England,Scotland,1988,1,0,1
Northern Ireland,Malta,1988,3,0,3
Republic of Ireland,Poland,1988,3,1,4
Chile,Greece,1988,0,1,1
England,Colombia,1988,1,1,2
Netherlands,Bulgaria,1988,1,2,3
Burkina Faso,Ghana,1988,3,0,3
Canada,Chile,1988,1,0,1
Nepal,Hong Kong,1988,0,0,0
Syria,North Korea,1988,2,1,3
Iran,Hong Kong,1988,2,0,2
Canada,Greece,1988,0,0,0
Nepal,North Korea,1988,0,1,1
Switzerland,England,1988,0,1,1
Puerto Rico,Jamaica,1988,1,2,3
Syria,Iran,1988,1,1,2
North Korea,Hong Kong,1988,1,0,1
Denmark,Czechoslovakia,1988,0,1,1
Malta,Wales,1988,2,3,5
Nepal,Syria,1988,0,3,3
Netherlands,Romania,1988,2,0,2
Norway,Republic of Ireland,1988,0,0,0
Russia,Poland,1988,2,1,3
Spain,Sweden,1988,1,3,4
United States,Chile,1988,1,1,2
Iran,North Korea,1988,0,0,0
Japan,China PR,1988,0,3,3
Libya,Burkina Faso,1988,3,0,3
Syria,Hong Kong,1988,2,0,2
United States,Chile,1988,1,3,4
Germany,Yugoslavia,1988,1,1,2
Italy,Wales,1988,0,1,1
Nepal,Iran,1988,0,3,3
Zambia,Zimbabwe,1988,3,2,5
Denmark,Belgium,1988,3,1,4
Switzerland,Spain,1988,1,1,2
United States,Chile,1988,0,3,3
United States,Ecuador,1988,0,1,1
Seychelles,Tanzania,1988,1,1,2
Germany,Italy,1988,1,1,2
Mozambique,Malawi,1988,1,2,3
United States,Ecuador,1988,0,2,2
Denmark,Spain,1988,2,3,5
England,Republic of Ireland,1988,0,1,1
Netherlands,Russia,1988,0,1,1
United States,Ecuador,1988,0,0,0
Germany,Denmark,1988,2,0,2
Italy,Spain,1988,1,0,1
Mozambique,Malawi,1988,1,1,2
United States,Costa Rica,1988,1,0,1
England,Netherlands,1988,1,3,4
Honduras,Ecuador,1988,1,1,2
Republic of Ireland,Russia,1988,1,1,2
Bahrain,South Korea,1988,2,0,2
Canada,Costa Rica,1988,0,1,1
Germany,Spain,1988,2,0,2
Honduras,Ecuador,1988,0,1,1
Indonesia,Yemen DPR,1988,1,0,1
Italy,Denmark,1988,2,0,2
England,Russia,1988,1,3,4
Republic of Ireland,Netherlands,1988,0,1,1
Antigua and Barbuda,Curaçao,1988,0,1,1
Indonesia,Bahrain,1988,0,0,0
South Korea,Zambia,1988,4,0,4
South Korea,Yemen DPR,1988,1,1,2
Germany,Netherlands,1988,1,2,3
Saudi Arabia,New Zealand,1988,0,2,2
Bahrain,Yemen DPR,1988,2,0,2
Indonesia,South Korea,1988,0,4,4
Russia,Italy,1988,2,0,2
Saudi Arabia,New Zealand,1988,2,3,5
Russia,Netherlands,1988,0,2,2
Hong Kong,Saudi Arabia,1988,0,3,3
Curaçao,Costa Rica,1988,1,1,2
Hong Kong,Saudi Arabia,1988,0,1,1
Burkina Faso,Libya,1988,2,0,2
Curaçao,Costa Rica,1988,1,0,1
Guadeloupe,Trinidad and Tobago,1988,0,3,3
Martinique,Antigua and Barbuda,1988,2,2,4
Argentina,Saudi Arabia,1988,2,2,4
Malawi,Zambia,1988,1,0,1
Antigua and Barbuda,Trinidad and Tobago,1988,1,1,2
Australia,Brazil,1988,0,1,1
Martinique,Guadeloupe,1988,2,1,3
Jordan,Bahrain,1988,0,0,0
Malawi,Zambia,1988,0,1,1
Antigua and Barbuda,Guadeloupe,1988,0,0,0
Australia,Saudi Arabia,1988,3,0,3
Iraq,Tunisia,1988,1,1,2
Martinique,Trinidad and Tobago,1988,0,3,3
Argentina,Brazil,1988,0,0,0
Malawi,Zambia,1988,1,1,2
Iraq,Lebanon,1988,0,0,0
Bahrain,Syria,1988,1,2,3
Brazil,Saudi Arabia,1988,4,1,5
Egypt,Tunisia,1988,1,0,1
Australia,Argentina,1988,4,1,5
Canada,Poland,1988,1,2,3
Egypt,Lebanon,1988,3,0,3
Argentina,Saudi Arabia,1988,2,0,2
Jordan,Syria,1988,2,0,2
Uganda,Malawi,1988,1,0,1
Australia,Brazil,1988,0,2,2
Costa Rica,Panama,1988,1,1,2
Egypt,Iraq,1988,0,0,0
Lebanon,Tunisia,1988,1,1,2
Egypt,Syria,1988,0,0,0
Jordan,Iraq,1988,0,3,3
Iraq,Syria,1988,1,1,2
Jordan,Egypt,1988,0,2,2
Burkina Faso,Niger,1988,1,0,1
Jamaica,United States,1988,0,0,0
Benin,Ghana,1988,1,1,2
Burkina Faso,Ghana,1988,3,1,4
Mali,Niger,1988,1,0,1
Norway,Brazil,1988,1,1,2
Benin,Mali,1988,0,1,1
Curaçao,Antigua and Barbuda,1988,3,1,4
Ghana,Niger,1988,0,3,3
Malawi,Uganda,1988,3,1,4
Burkina Faso,Benin,1988,1,0,1
Ghana,Mali,1988,1,0,1
Panama,Costa Rica,1988,0,2,2
Angola,Gabon,1988,4,1,5
Benin,Niger,1988,0,5,5
Burkina Faso,Mali,1988,2,1,3
Austria,Brazil,1988,0,2,2
Zambia,Malawi,1988,4,1,5
Burkina Faso,Niger,1988,1,0,1
Finland,Bulgaria,1988,1,1,2
Zambia,Malawi,1988,7,1,8
El Salvador,Guatemala,1988,1,2,3
Indonesia,Thailand,1988,1,0,1
Tunisia,Guinea,1988,5,0,5
Albania,Cuba,1988,0,0,0
Angola,Sudan,1988,0,0,0
Colombia,Uruguay,1988,2,1,3
Ghana,Liberia,1988,0,0,0
Iceland,Bulgaria,1988,2,3,5
Norway,Bulgaria,1988,1,1,2
United States,Jamaica,1988,5,1,6
Finland,Russia,1988,0,0,0
Guinea,Tunisia,1988,3,0,3
Liberia,Ghana,1988,2,0,2
France,Czechoslovakia,1988,1,1,2
Iceland,Faroe Islands,1988,1,0,1
Poland,Bulgaria,1988,3,2,5
Switzerland,Yugoslavia,1988,0,2,2
Austria,Hungary,1988,0,0,0
Finland,Germany,1988,0,4,4
German DR,Greece,1988,1,0,1
Iceland,Russia,1988,1,1,2
Sweden,Denmark,1988,1,2,3
Ecuador,Paraguay,1988,1,5,6
Honduras,Paraguay,1988,0,0,0
Chile,Ecuador,1988,3,1,4
England,Denmark,1988,1,0,1
Netherlands,Wales,1988,1,0,1
Northern Ireland,Republic of Ireland,1988,0,0,0
Norway,Scotland,1988,1,2,3
Spain,Yugoslavia,1988,1,2,3
Honduras,Paraguay,1988,0,2,2
Czechoslovakia,Austria,1988,4,2,6
Romania,Albania,1988,3,0,3
German DR,Poland,1988,1,2,3
Germany,Russia,1988,1,0,1
Iceland,Hungary,1988,0,3,3
Luxembourg,Switzerland,1988,1,4,5
Peru,Paraguay,1988,0,1,1
Turkey,Greece,1988,3,1,4
El Salvador,Honduras,1988,0,0,0
Curaçao,Venezuela,1988,0,0,0
Malawi,Mozambique,1988,1,1,2
Ecuador,Uruguay,1988,1,2,3
Paraguay,Chile,1988,2,0,2
Denmark,Iceland,1988,1,0,1
France,Norway,1988,1,0,1
Malawi,Mozambique,1988,1,0,1
Chile,Ecuador,1988,0,0,0
Paraguay,Uruguay,1988,3,1,4
Curaçao,El Salvador,1988,0,1,1
Tanzania,Eswatini,1988,1,1,2
Indonesia,Qatar,1988,0,1,1
Liberia,Mali,1988,0,1,1
Angola,Equatorial Guinea,1988,0,1,1
Mauritius,Seychelles,1988,3,0,3
Trinidad and Tobago,Canada,1988,1,2,3
Indonesia,Qatar,1988,1,4,5
Gabon,Burkina Faso,1988,3,0,3
Guatemala,Canada,1988,1,0,1
Singapore,Qatar,1988,0,1,1
Belgium,Brazil,1988,1,2,3
Cyprus,Malta,1988,0,1,1
New Zealand,Australia,1988,1,2,3
Spain,Argentina,1988,1,1,2
Sweden,Portugal,1988,0,0,0
Turkey,Iceland,1988,1,1,2
Uruguay,Paraguay,1988,2,0,2
Canada,Guatemala,1988,3,2,5
Seychelles,Mauritius,1988,1,0,1
Australia,New Zealand,1988,2,0,2
El Salvador,Curaçao,1988,5,0,5
Equatorial Guinea,Angola,1988,0,0,0
Mali,Liberia,1988,3,0,3
Eswatini,Tanzania,1988,1,1,2
Israel,Malta,1988,2,0,2
Luxembourg,Czechoslovakia,1988,0,2,2
Belgium,Switzerland,1988,1,0,1
Bulgaria,Romania,1988,1,3,4
England,Sweden,1988,0,0,0
German DR,Iceland,1988,2,0,2
Germany,Netherlands,1988,0,0,0
Greece,Denmark,1988,1,1,2
Hungary,Northern Ireland,1988,1,0,1
Republic of Ireland,Tunisia,1988,4,0,4
Italy,Norway,1988,2,1,3
Poland,Albania,1988,1,0,1
Russia,Austria,1988,2,0,2
Scotland,Yugoslavia,1988,1,1,2
Wales,Finland,1988,2,2,4
Solomon Islands,Fiji,1988,1,1,2
Cyprus,France,1988,1,1,2
Burkina Faso,Gabon,1988,1,0,1
New Caledonia,Vanuatu,1988,6,1,7
Fiji,Vanuatu,1988,8,0,8
Solomon Islands,New Caledonia,1988,1,0,1
Chile,Peru,1988,2,0,2
Fiji,New Caledonia,1988,2,0,2
Solomon Islands,Vanuatu,1988,5,0,5
Japan,South Korea,1988,0,1,1
New Caledonia,Vanuatu,1988,0,1,1
Solomon Islands,Fiji,1988,1,3,4
Algeria,Angola,1988,1,1,2
Trinidad and Tobago,Honduras,1988,0,0,0
Chile,Uruguay,1988,1,1,2
Austria,Turkey,1988,3,2,5
Cyprus,Norway,1988,0,3,3
Denmark,Bulgaria,1988,1,1,2
Romania,Greece,1988,3,0,3
Kuwait,Finland,1988,0,0,0
Czechoslovakia,Norway,1988,3,2,5
Albania,Sweden,1988,1,2,3
Ethiopia,Zambia,1988,0,0,0
Kuwait,Finland,1988,0,0,0
Malawi,Tanzania,1988,0,0,0
Kenya,Zanzibar,1988,2,0,2
Tunisia,Angola,1988,5,0,5
Uganda,Zimbabwe,1988,0,0,0
El Salvador,Guatemala,1988,0,0,0
Indonesia,Qatar,1988,0,1,1
Uruguay,Chile,1988,3,1,4
Kenya,Tanzania,1988,2,0,2
Malawi,Zanzibar,1988,1,0,1
Ethiopia,Uganda,1988,2,1,3
Sudan,Angola,1988,1,2,3
Zambia,Zimbabwe,1988,1,1,2
Malawi,Kenya,1988,3,0,3
Tanzania,Zanzibar,1988,0,1,1
Algeria,Mali,1988,7,0,7
DR Congo,Congo,1988,1,0,1
Ethiopia,Zimbabwe,1988,1,2,3
Honduras,Trinidad and Tobago,1988,1,1,2
Uganda,Zambia,1988,0,3,3
Fiji,New Zealand,1988,1,1,2
Saudi Arabia,Egypt,1988,0,0,0
Greece,Hungary,1988,3,0,3
Czechoslovakia,Belgium,1988,0,0,0
Italy,Netherlands,1988,1,0,1
Kuwait,Egypt,1988,2,2,4
Portugal,Luxembourg,1988,1,0,1
Saudi Arabia,England,1988,1,1,2
Spain,Republic of Ireland,1988,2,0,2
Cape Verde,Senegal,1988,0,1,1
Fiji,New Zealand,1988,2,0,2
Kenya,Zambia,1988,0,1,1
United Arab Emirates,Jordan,1988,2,1,3
Angola,Senegal,1988,1,2,3
Cape Verde,Angola,1988,2,3,5
Fiji,New Zealand,1988,1,0,1
Kenya,Zimbabwe,1988,0,0,0
Malawi,Zambia,1988,3,1,4
Yugoslavia,France,1988,3,2,5
United Arab Emirates,Jordan,1988,3,2,5
Syria,Russia,1988,0,2,2
Kuwait,Russia,1988,0,1,1
Malta,Cyprus,1988,1,1,2
Peru,Chile,1988,1,1,2
Romania,Israel,1988,3,0,3
United Arab Emirates,Algeria,1988,1,1,2
Guinea,Sierra Leone,1988,1,0,1
Fiji,Australia,1988,1,0,1
Liberia,Sierra Leone,1988,0,0,0
Kuwait,Russia,1988,0,2,2
Liberia,Guinea,1988,0,1,1
Saudi Arabia,Tunisia,1988,1,0,1
Cameroon,Gabon,1988,0,0,0
Congo,Chad,1988,2,1,3
Turkey,German DR,1988,3,1,4
Cameroon,Equatorial Guinea,1988,2,1,3
Central African Republic,Chad,1988,2,1,3
Qatar,Iran,1988,0,2,2
Syria,Saudi Arabia,1988,0,2,2
Australia,Fiji,1988,5,1,6
Kuwait,Bahrain,1988,0,0,0
United Arab Emirates,South Korea,1988,0,1,1
Central African Republic,Congo,1988,0,1,1
China PR,Syria,1988,3,0,3
Equatorial Guinea,Gabon,1988,0,3,3
Japan,Iran,1988,0,0,0
Qatar,United Arab Emirates,1988,2,1,3
Saudi Arabia,Kuwait,1988,0,0,0
Bahrain,China PR,1988,0,1,1
Cameroon,Congo,1988,2,0,2
Central African Republic,Gabon,1988,0,0,0
South Korea,Japan,1988,2,0,2
Morocco,Egypt,1988,0,0,0
Cameroon,Gabon,1988,0,1,1
Central African Republic,Congo,1988,0,3,3
Iran,United Arab Emirates,1988,1,0,1
Malaysia,Indonesia,1988,0,0,0
Syria,Kuwait,1988,1,0,1
Oman,Singapore,1988,1,3,4
Qatar,South Korea,1988,2,3,5
Saudi Arabia,Bahrain,1988,1,1,2
Ivory Coast,Tunisia,1988,1,0,1
Kuwait,China PR,1988,2,2,4
Malaysia,Thailand,1988,0,0,0
United Arab Emirates,Japan,1988,1,0,1
Bahrain,Syria,1988,0,1,1
South Korea,Iran,1988,3,0,3
Malta,Hungary,1988,2,2,4
Yugoslavia,Cyprus,1988,4,0,4
China PR,Saudi Arabia,1988,0,1,1
Indonesia,Thailand,1988,0,0,0
Qatar,Japan,1988,3,0,3
Egypt,Switzerland,1988,1,3,4
South Korea,China PR,1988,2,1,3
Uruguay,Peru,1988,3,0,3
Saudi Arabia,Iran,1988,1,0,1
Morocco,Gabon,1988,5,2,7
New Zealand,Taiwan,1988,4,1,5
China PR,Iran,1988,0,0,0
Ivory Coast,Tunisia,1988,1,1,2
South Korea,Saudi Arabia,1988,0,0,0
Liberia,Tunisia,1988,1,1,2
Zambia,Egypt,1988,1,2,3
Spain,Northern Ireland,1988,4,0,4
Italy,Scotland,1988,2,0,2
Morocco,Guinea,1988,1,0,1
DR Congo,Angola,1988,0,0,0
Israel,Netherlands,1989,0,2,2
Algeria,Zimbabwe,1989,3,0,3
Egypt,Liberia,1989,2,0,2
Oman,Iraq,1989,1,1,2
Pakistan,Kuwait,1989,0,1,1
Qatar,Jordan,1989,1,0,1
Kenya,Malawi,1989,1,1,2
Nigeria,Gabon,1989,1,0,1
Cameroon,Angola,1989,1,1,2
DR Congo,Tunisia,1989,3,1,4
Ivory Coast,Libya,1989,1,0,1
Morocco,Zambia,1989,1,0,1
Egypt,Finland,1989,2,1,3
Malta,Israel,1989,1,2,3
Egypt,Finland,1989,2,1,3
Jordan,Iraq,1989,0,1,1
Kuwait,United Arab Emirates,1989,3,2,5
Oman,Qatar,1989,0,0,0
Albania,Greece,1989,1,1,2
Iran,Japan,1989,2,2,4
Jordan,Oman,1989,2,0,2
Qatar,Iraq,1989,1,0,1
United Arab Emirates,Pakistan,1989,5,0,5
Malawi,Egypt,1989,1,1,2
Angola,Nigeria,1989,2,2,4
Gabon,Cameroon,1989,1,3,4
Liberia,Kenya,1989,0,0,0
Malta,Spain,1989,0,2,2
Tunisia,Morocco,1989,2,1,3
Zambia,DR Congo,1989,4,2,6
Zimbabwe,Ivory Coast,1989,0,0,0
Greece,Portugal,1989,1,2,3
India,North Korea,1989,1,2,3
Iraq,Oman,1989,3,1,4
Jordan,Qatar,1989,1,1,2
Kuwait,Pakistan,1989,2,0,2
Thailand,Malaysia,1989,1,0,1
Ecuador,Chile,1989,1,0,1
Senegal,DR Congo,1989,1,1,2
Thailand,Indonesia,1989,3,0,3
Senegal,DR Congo,1989,2,1,3
Chile,Peru,1989,0,0,0
Colombia,Peru,1989,1,0,1
Indonesia,Malaysia,1989,1,3,4
Iraq,Jordan,1989,4,0,4
Qatar,Oman,1989,3,0,3
United Arab Emirates,Kuwait,1989,1,0,1
China PR,North Korea,1989,3,1,4
Colombia,Chile,1989,1,0,1
Republic of Ireland,France,1989,0,0,0
Algeria,Finland,1989,2,0,2
Cyprus,Scotland,1989,2,3,5
Greece,England,1989,1,2,3
Israel,Wales,1989,3,3,6
Malta,Denmark,1989,0,2,2
Northern Ireland,Spain,1989,0,2,2
Thailand,China PR,1989,2,0,2
Denmark,Finland,1989,0,0,0
Iraq,Qatar,1989,2,2,4
Malta,Algeria,1989,0,1,1
Oman,Jordan,1989,0,2,2
Pakistan,United Arab Emirates,1989,1,4,5
Algeria,Denmark,1989,0,0,0
Guatemala,Poland,1989,0,1,1
Hong Kong,China PR,1989,0,0,0
Malta,Finland,1989,0,0,0
Egypt,German DR,1989,0,4,4
Mexico,Poland,1989,3,1,4
Portugal,Belgium,1989,1,1,2
Thailand,Bangladesh,1989,1,0,1
Bulgaria,Russia,1989,1,2,3
Costa Rica,El Salvador,1989,1,1,2
Guatemala,Mexico,1989,1,2,3
Greece,Norway,1989,4,2,6
Italy,Denmark,1989,1,0,1
China PR,Bangladesh,1989,2,0,2
Costa Rica,Guatemala,1989,2,3,5
El Salvador,Mexico,1989,0,2,2
Thailand,Iran,1989,0,3,3
Bangladesh,Iran,1989,1,2,3
Thailand,China PR,1989,0,3,3
Guatemala,El Salvador,1989,3,0,3
Bangladesh,China PR,1989,0,2,2
Israel,New Zealand,1989,1,0,1
Albania,England,1989,0,2,2
Bangladesh,Thailand,1989,3,1,4
Greece,German DR,1989,3,2,5
Hungary,Republic of Ireland,1989,0,0,0
Scotland,France,1989,2,0,2
Colombia,Argentina,1989,1,0,1
Yemen,Syria,1989,0,1,1
Australia,New Zealand,1989,4,1,5
Jamaica,Paraguay,1989,0,3,3
Brazil,Ecuador,1989,1,0,1
Martinique,Paraguay,1989,0,2,2
Saudi Arabia,Syria,1989,5,4,9
Tunisia,Egypt,1989,0,0,0
Guadeloupe,Paraguay,1989,0,2,2
Iran,Bangladesh,1989,1,0,1
Guatemala,Costa Rica,1989,1,0,1
Israel,Australia,1989,1,1,2
Trinidad and Tobago,Paraguay,1989,2,2,4
Yemen,Saudi Arabia,1989,0,1,1
Algeria,Morocco,1989,1,1,2
Bulgaria,Germany,1989,1,2,3
German DR,Finland,1989,1,1,2
Netherlands,Russia,1989,2,0,2
Trinidad and Tobago,Paraguay,1989,1,1,2
Spain,Malta,1989,4,0,4
Austria,Italy,1989,0,1,1
Syria,Yemen,1989,2,0,2
Barbados,Jamaica,1989,1,1,2
Ethiopia,Malawi,1989,1,1,2
Venezuela,Paraguay,1989,1,2,3
Qatar,Malaysia,1989,1,0,1
Barbados,Jamaica,1989,1,1,2
Ethiopia,Malawi,1989,1,0,1
Greece,Turkey,1989,0,1,1
Portugal,Angola,1989,6,0,6
Romania,Italy,1989,1,0,1
Syria,Saudi Arabia,1989,0,0,0
Venezuela,Paraguay,1989,0,0,0
Aruba,Trinidad and Tobago,1989,0,7,7
Ethiopia,Zambia,1989,0,1,1
Curaçao,Trinidad and Tobago,1989,1,1,2
Costa Rica,Guatemala,1989,2,1,3
Curaçao,Aruba,1989,1,0,1
Ethiopia,Zambia,1989,2,2,4
New Zealand,Australia,1989,2,0,2
Algeria,Tunisia,1989,2,0,2
Hungary,Switzerland,1989,3,0,3
Greece,Yugoslavia,1989,1,4,5
Saudi Arabia,Yemen,1989,1,0,1
Sudan,Kenya,1989,1,0,1
Angola,Ivory Coast,1989,0,2,2
Ethiopia,Egypt,1989,1,0,1
Gabon,Ghana,1989,1,0,1
Mali,Morocco,1989,0,0,0
Mauritius,Zimbabwe,1989,1,4,5
New Zealand,Israel,1989,2,2,4
Eswatini,Malawi,1989,0,2,2
Austria,Czechoslovakia,1989,1,2,3
Barbados,Bermuda,1989,1,2,3
Brazil,Paraguay,1989,2,0,2
Denmark,Canada,1989,2,0,2
German DR,Turkey,1989,0,2,2
Hungary,Malta,1989,1,1,2
Poland,Romania,1989,2,1,3
Angola,Mozambique,1989,1,1,2
Ecuador,Argentina,1989,2,2,4
Barbados,Bermuda,1989,2,1,3
Faroe Islands,Canada,1989,1,0,1
Guinea,Nigeria,1989,1,1,2
Australia,Israel,1989,1,1,2
Costa Rica,United States,1989,1,0,1
Faroe Islands,Canada,1989,0,1,1
Mozambique,Zambia,1989,0,1,1
Trinidad and Tobago,Bermuda,1989,1,1,2
Trinidad and Tobago,Bermuda,1989,0,1,1
Chile,Argentina,1989,1,1,2
Egypt,Ethiopia,1989,6,1,7
Italy,Uruguay,1989,1,1,2
Nigeria,Guinea,1989,3,0,3
Antigua and Barbuda,Jamaica,1989,1,0,1
Ghana,Gabon,1989,1,0,1
Ivory Coast,Angola,1989,4,1,5
Kenya,Sudan,1989,1,0,1
Malawi,Eswatini,1989,1,1,2
Morocco,Mali,1989,1,1,2
Saint Kitts and Nevis,French Guiana,1989,1,0,1
Saint Lucia,Dominica,1989,0,0,0
Trinidad and Tobago,Aruba,1989,11,0,11
Zimbabwe,Mauritius,1989,1,0,1
Bulgaria,Denmark,1989,0,2,2
Curaçao,Martinique,1989,3,1,4
England,Albania,1989,5,0,5
Greece,Romania,1989,0,0,0
Republic of Ireland,Spain,1989,1,0,1
Italy,Hungary,1989,4,0,4
Malta,Northern Ireland,1989,0,2,2
Netherlands,Germany,1989,1,1,2
Portugal,Switzerland,1989,3,1,4
Russia,German DR,1989,3,0,3
Scotland,Cyprus,1989,2,1,3
Wales,Sweden,1989,0,2,2
Belgium,Czechoslovakia,1989,2,1,3
France,Yugoslavia,1989,0,0,0
United States,Costa Rica,1989,1,0,1
Zambia,Mozambique,1989,3,0,3
Norway,Poland,1989,0,3,3
Uruguay,Ecuador,1989,3,1,4
El Salvador,Paraguay,1989,1,2,3
Guatemala,Chile,1989,0,1,1
South Korea,Japan,1989,1,0,1
El Salvador,Chile,1989,0,1,1
Grenada,Saint Kitts and Nevis,1989,2,1,3
Guatemala,Paraguay,1989,1,2,3
Jamaica,Guadeloupe,1989,1,3,4
Sint Maarten,British Virgin Islands,1989,1,2,3
Sweden,Poland,1989,2,1,3
Czechoslovakia,Luxembourg,1989,4,0,4
Brazil,Peru,1989,4,1,5
French Guiana,Trinidad and Tobago,1989,1,3,4
Japan,China PR,1989,2,2,4
Turkey,Russia,1989,0,1,1
Dominica,Antigua and Barbuda,1989,0,1,1
Hong Kong,Macau,1989,2,1,3
Japan,China PR,1989,2,0,2
Singapore,Indonesia,1989,1,2,3
United States,Trinidad and Tobago,1989,1,1,2
Paraguay,Peru,1989,1,1,2
Namibia,Angola,1989,0,1,1
Denmark,Greece,1989,7,1,8
Romania,Bulgaria,1989,1,0,1
Peru,Venezuela,1989,2,1,3
German DR,Austria,1989,1,1,2
Aruba,Grenada,1989,0,0,0
Guadeloupe,Dominica,1989,0,0,0
Indonesia,North Korea,1989,0,0,0
Martinique,British Virgin Islands,1989,0,0,0
Norway,Cyprus,1989,3,1,4
Saint Kitts and Nevis,Trinidad and Tobago,1989,0,2,2
Saint Vincent and the Grenadines,Curaçao,1989,3,2,5
Hong Kong,Japan,1989,0,0,0
Ecuador,Uruguay,1989,1,1,2
England,Chile,1989,0,0,0
South Korea,Singapore,1989,3,0,3
Malaysia,Nepal,1989,2,0,2
Guinea-Bissau,Senegal,1989,0,0,0
Morocco,Algeria,1989,1,0,1
Peru,Brazil,1989,1,1,2
Bolivia,Paraguay,1989,3,2,5
South Korea,Nepal,1989,9,0,9
Malaysia,Singapore,1989,1,0,1
Mali,Cape Verde,1989,1,1,2
Mauritania,Sierra Leone,1989,1,2,3
Northern Ireland,Chile,1989,0,1,1
Belgium,Yugoslavia,1989,1,0,1
Cape Verde,Guinea-Bissau,1989,2,3,5
Hong Kong,North Korea,1989,1,2,3
South Korea,Malaysia,1989,3,0,3
Mali,Senegal,1989,2,2,4
Scotland,England,1989,0,2,2
Singapore,Nepal,1989,3,0,3
Indonesia,Japan,1989,0,0,0
Republic of Ireland,Malta,1989,2,0,2
Trinidad and Tobago,Costa Rica,1989,1,1,2
Cape Verde,Senegal,1989,2,1,3
Guinea,Mauritania,1989,3,1,4
Iran,Thailand,1989,3,0,3
Mali,Guinea-Bissau,1989,2,1,3
Scotland,Chile,1989,2,0,2
Finland,Netherlands,1989,0,1,1
Norway,Austria,1989,4,1,5
Russia,Iceland,1989,1,1,2
Sweden,Algeria,1989,2,0,2
Wales,Germany,1989,0,0,0
Ivory Coast,DR Congo,1989,1,1,2
Luxembourg,Belgium,1989,0,5,5
Paraguay,Bolivia,1989,2,0,2
Cape Verde,Guinea,1989,0,1,1
Mali,Sierra Leone,1989,1,0,1
Cape Verde,Sierra Leone,1989,1,0,1
Curaçao,British Virgin Islands,1989,4,0,4
Egypt,Chile,1989,2,0,2
England,Poland,1989,3,0,3
Malawi,Tunisia,1989,1,0,1
Nepal,South Korea,1989,0,4,4
Singapore,Malaysia,1989,2,2,4
Dominica,Jamaica,1989,0,0,0
Gabon,DR Congo,1989,0,0,0
Hong Kong,Indonesia,1989,1,1,2
Republic of Ireland,Hungary,1989,2,0,2
Japan,North Korea,1989,2,1,3
Mali,Guinea,1989,3,0,3
United States,Peru,1989,3,0,3
Malaysia,South Korea,1989,0,3,3
Singapore,Nepal,1989,7,0,7
Grenada,Trinidad and Tobago,1989,1,0,1
Denmark,England,1989,1,1,2
Malaysia,Nepal,1989,3,0,3
Martinique,Sint Maarten,1989,10,0,10
Singapore,South Korea,1989,0,3,3
Switzerland,Czechoslovakia,1989,0,1,1
Bolivia,Uruguay,1989,0,0,0
Brazil,Portugal,1989,4,0,4
Canada,Belgium,1989,0,2,2
French Guiana,Aruba,1989,4,0,4
Kenya,Egypt,1989,0,0,0
Nigeria,Cameroon,1989,2,0,2
Angola,Gabon,1989,2,0,2
DR Congo,Morocco,1989,0,0,0
Costa Rica,Trinidad and Tobago,1989,1,0,1
Ivory Coast,Algeria,1989,0,0,0
Japan,Indonesia,1989,5,0,5
Liberia,Malawi,1989,1,0,1
Zambia,Tunisia,1989,1,0,1
Denmark,Sweden,1989,6,0,6
Iceland,Austria,1989,0,0,0
Norway,Yugoslavia,1989,1,2,3
Uruguay,Bolivia,1989,1,0,1
Brazil,Sweden,1989,1,2,3
Trinidad and Tobago,Peru,1989,2,1,3
Zimbabwe,Zambia,1989,0,0,0
United States,Guatemala,1989,2,1,3
Aruba,Saint Kitts and Nevis,1989,1,4,5
Denmark,Brazil,1989,4,0,4
Jamaica,Saint Lucia,1989,1,1,2
Japan,Hong Kong,1989,0,0,0
Sint Maarten,Curaçao,1989,1,2,3
Uruguay,Chile,1989,2,2,4
Ecuador,Peru,1989,1,2,3
Switzerland,Brazil,1989,1,0,1
Bolivia,Chile,1989,0,1,1
Malawi,Kenya,1989,1,0,1
United States,Colombia,1989,0,1,1
Angola,Cameroon,1989,1,2,3
El Salvador,Costa Rica,1989,2,4,6
Gabon,Nigeria,1989,2,1,3
Indonesia,Hong Kong,1989,3,2,5
North Korea,Japan,1989,2,0,2
Liberia,Egypt,1989,1,0,1
Tunisia,DR Congo,1989,1,0,1
Venezuela,Peru,1989,3,1,4
Zambia,Morocco,1989,2,1,3
Zimbabwe,Algeria,1989,1,2,3
South Korea,Czechoslovakia,1989,0,0,0
Chile,Bolivia,1989,2,1,3
Haiti,Colombia,1989,0,4,4
Grenada,French Guiana,1989,0,0,0
Brazil,Venezuela,1989,3,1,4
Paraguay,Peru,1989,5,2,7
Argentina,Chile,1989,1,0,1
Grenada,Saint Vincent and the Grenadines,1989,2,0,2
North Korea,Hong Kong,1989,4,1,5
Uruguay,Ecuador,1989,0,1,1
Barbados,Guadeloupe,1989,1,0,1
Brazil,Peru,1989,0,0,0
Venezuela,Colombia,1989,2,4,6
Argentina,Ecuador,1989,0,0,0
Curaçao,Saint Vincent and the Grenadines,1989,1,1,2
Uruguay,Bolivia,1989,3,0,3
Barbados,Trinidad and Tobago,1989,0,3,3
Colombia,Paraguay,1989,0,1,1
Peru,Venezuela,1989,1,1,2
Chile,Uruguay,1989,0,3,3
Curaçao,Grenada,1989,1,1,2
Ecuador,Bolivia,1989,0,0,0
Malawi,Gabon,1989,2,0,2
Faroe Islands,Ynys Môn,1989,6,0,6
Greenland,Shetland,1989,4,1,5
Brazil,Colombia,1989,0,0,0
Gabon,Mozambique,1989,1,0,1
Guadeloupe,Trinidad and Tobago,1989,2,0,2
Paraguay,Venezuela,1989,3,0,3
Bolivia,Chile,1989,0,5,5
Uruguay,Argentina,1989,0,1,1
Faroe Islands,Shetland,1989,4,0,4
Åland Islands,Ynys Môn,1989,4,5,9
Brazil,Paraguay,1989,2,0,2
Colombia,Peru,1989,1,1,2
Grenada,Trinidad and Tobago,1989,1,2,3
North Korea,Indonesia,1989,2,1,3
Malawi,Mozambique,1989,0,1,1
Faroe Islands,Greenland,1989,3,0,3
Åland Islands,Shetland,1989,2,0,2
Argentina,Bolivia,1989,0,0,0
Chile,Ecuador,1989,2,1,3
Kenya,DR Congo,1989,0,1,1
Malawi,Mozambique,1989,0,2,2
Åland Islands,Greenland,1989,3,0,3
Ynys Môn,Shetland,1989,3,0,3
Brazil,Argentina,1989,2,0,2
Paraguay,Uruguay,1989,0,3,3
Faroe Islands,Åland Islands,1989,7,1,8
Ynys Môn,Greenland,1989,1,0,1
Argentina,Uruguay,1989,0,2,2
Brazil,Paraguay,1989,3,0,3
China PR,Iran,1989,2,0,2
Brazil,Uruguay,1989,1,0,1
Costa Rica,El Salvador,1989,1,0,1
Egypt,DR Congo,1989,2,0,2
Nigeria,Zimbabwe,1989,3,0,3
Malawi,Kenya,1989,2,3,5
Zambia,Gabon,1989,3,0,3
Mali,Ivory Coast,1989,2,2,4
Paraguay,Argentina,1989,0,0,0
Senegal,Tunisia,1989,3,0,3
Iran,China PR,1989,3,2,5
Brazil,Japan,1989,1,0,1
Chile,Peru,1989,2,1,3
Algeria,Qatar,1989,1,1,2
DR Congo,Egypt,1989,0,0,0
Kenya,Malawi,1989,0,0,0
China PR,Thailand,1989,2,0,2
Gabon,Zambia,1989,2,1,3
Ivory Coast,Mali,1989,3,1,4
Trinidad and Tobago,El Salvador,1989,2,0,2
Tunisia,Senegal,1989,0,1,1
Venezuela,Brazil,1989,0,4,4
Zimbabwe,Nigeria,1989,1,1,2
Tunisia,Malawi,1989,3,0,3
Uruguay,Colombia,1989,0,0,0
Venezuela,Chile,1989,1,3,4
Mexico,South Korea,1989,4,2,6
Egypt,Malawi,1989,1,0,1
Kenya,Liberia,1989,1,0,1
Nigeria,Angola,1989,1,0,1
Cameroon,Gabon,1989,2,1,3
Chile,Brazil,1989,1,1,2
DR Congo,Zambia,1989,1,0,1
El Salvador,Trinidad and Tobago,1989,0,0,0
Ivory Coast,Zimbabwe,1989,5,0,5
Morocco,Tunisia,1989,0,0,0
United States,South Korea,1989,1,2,3
Sweden,France,1989,2,4,6
Bolivia,Peru,1989,2,1,3
Brazil,Venezuela,1989,6,0,6
Colombia,Ecuador,1989,2,0,2
Guatemala,Trinidad and Tobago,1989,0,1,1
Austria,Iceland,1989,2,1,3
Belgium,Denmark,1989,3,0,3
Finland,Yugoslavia,1989,2,2,4
German DR,Bulgaria,1989,1,1,2
Norway,Greece,1989,0,0,0
Poland,Russia,1989,1,1,2
Algeria,Ivory Coast,1989,1,0,1
Egypt,Kenya,1989,2,0,2
Malawi,Liberia,1989,0,0,0
Cameroon,Nigeria,1989,1,0,1
Chile,Venezuela,1989,5,0,5
Gabon,Angola,1989,1,0,1
Morocco,DR Congo,1989,1,1,2
Paraguay,Colombia,1989,2,1,3
Peru,Uruguay,1989,0,2,2
Tunisia,Zambia,1989,1,0,1
Portugal,Romania,1989,0,0,0
Trinidad and Tobago,Panama,1989,2,0,2
Bolivia,Uruguay,1989,2,1,3
Brazil,Chile,1989,1,0,1
Ecuador,Colombia,1989,0,0,0
Trinidad and Tobago,Guatemala,1989,2,1,3
Czechoslovakia,Romania,1989,2,0,2
Norway,France,1989,1,1,2
Poland,Greece,1989,3,0,3
Austria,Russia,1989,0,0,0
Belgium,Portugal,1989,3,0,3
Finland,Wales,1989,1,0,1
Iceland,German DR,1989,0,3,3
Republic of Ireland,Germany,1989,1,1,2
Netherlands,Denmark,1989,2,2,4
Northern Ireland,Hungary,1989,1,2,3
Sweden,England,1989,0,0,0
Yugoslavia,Scotland,1989,3,1,4
Paraguay,Ecuador,1989,2,1,3
Peru,Bolivia,1989,1,2,3
South Korea,Egypt,1989,0,1,1
Colombia,Paraguay,1989,2,1,3
El Salvador,United States,1989,0,1,1
Uruguay,Bolivia,1989,2,0,2
Iceland,Turkey,1989,2,1,3
Italy,Bulgaria,1989,4,0,4
Kuwait,China PR,1989,2,0,2
Spain,Poland,1989,1,0,1
Switzerland,Portugal,1989,1,2,3
Yugoslavia,Greece,1989,3,0,3
Kuwait,Qatar,1989,1,0,1
Ecuador,Paraguay,1989,3,1,4
Uruguay,Peru,1989,2,0,2
Kuwait,Egypt,1989,0,0,0
Germany,Finland,1989,6,1,7
Malta,Austria,1989,1,2,3
Czechoslovakia,Portugal,1989,2,1,3
Algeria,Egypt,1989,0,0,0
Cameroon,Tunisia,1989,2,0,2
German DR,Russia,1989,2,1,3
Guatemala,United States,1989,0,0,0
Sweden,Albania,1989,3,1,4
Bulgaria,Greece,1989,4,0,4
Cyprus,Malta,1989,0,0,0
Denmark,Romania,1989,3,0,3
France,Scotland,1989,3,0,3
Hungary,Spain,1989,2,2,4
Republic of Ireland,Northern Ireland,1989,3,0,3
Luxembourg,Portugal,1989,0,3,3
Poland,England,1989,0,0,0
Switzerland,Belgium,1989,2,2,4
Wales,Netherlands,1989,1,2,3
Yugoslavia,Norway,1989,1,0,1
China PR,Saudi Arabia,1989,2,1,3
United Arab Emirates,North Korea,1989,0,0,0
South Korea,Qatar,1989,0,0,0
Italy,Brazil,1989,0,1,1
Colombia,Israel,1989,1,0,1
Iraq,Kuwait,1989,1,0,1
South Korea,North Korea,1989,1,0,1
Qatar,Saudi Arabia,1989,1,1,2
China PR,United Arab Emirates,1989,1,2,3
China PR,South Korea,1989,0,1,1
North Korea,Qatar,1989,2,0,2
Saudi Arabia,United Arab Emirates,1989,0,0,0
Liberia,Guinea,1989,2,0,2
Trinidad and Tobago,Finland,1989,0,1,1
North Korea,China PR,1989,0,1,1
United Arab Emirates,Qatar,1989,1,1,2
Belgium,Luxembourg,1989,1,1,2
Czechoslovakia,Switzerland,1989,3,0,3
Hungary,Greece,1989,1,1,2
Kuwait,Norway,1989,2,2,4
Malta,German DR,1989,0,4,4
Poland,Sweden,1989,0,2,2
Saudi Arabia,South Korea,1989,0,2,2
Trinidad and Tobago,Finland,1989,2,0,2
Turkey,Austria,1989,3,0,3
Cyprus,Yugoslavia,1989,1,2,3
Fiji,Papua New Guinea,1989,2,1,3
Qatar,China PR,1989,2,1,3
Saudi Arabia,North Korea,1989,2,0,2
Solomon Islands,Vanuatu,1989,2,0,2
United Arab Emirates,South Korea,1989,1,1,2
Fiji,Vanuatu,1989,2,1,3
Israel,Colombia,1989,0,0,0
Kuwait,Lebanon,1989,5,0,5
New Caledonia,Solomon Islands,1989,2,0,2
Fiji,New Caledonia,1989,3,0,3
Guinea,Iraq,1989,1,0,1
Papua New Guinea,Vanuatu,1989,3,0,3
Iran,Yemen DPR,1989,2,0,2
Tunisia,Algeria,1989,0,0,0
Lebanon,Uganda,1989,0,2,2
Guinea,Iran,1989,1,1,2
Iraq,Yemen DPR,1989,6,2,8
New Caledonia,Vanuatu,1989,5,1,6
Papua New Guinea,Solomon Islands,1989,0,0,0
Qatar,Egypt,1989,0,2,2
Fiji,Solomon Islands,1989,0,0,0
Kuwait,Uganda,1989,1,1,2
New Caledonia,Papua New Guinea,1989,2,1,3
Guinea,Yemen DPR,1989,0,1,1
Iran,Iraq,1989,0,0,0
United States,El Salvador,1989,0,0,0
Iran,Uganda,1989,2,2,4
Kuwait,Iraq,1989,1,2,3
Italy,Algeria,1989,1,0,1
Iraq,Uganda,1989,1,1,2
Kuwait,Iran,1989,1,0,1
Brazil,Yugoslavia,1989,0,0,0
United States,Bermuda,1989,2,1,3
Albania,Poland,1989,1,2,3
Austria,German DR,1989,3,0,3
England,Italy,1989,0,0,0
Germany,Wales,1989,2,1,3
Greece,Bulgaria,1989,1,0,1
Malta,Republic of Ireland,1989,0,2,2
Netherlands,Finland,1989,3,0,3
Portugal,Czechoslovakia,1989,0,0,0
Romania,Denmark,1989,3,1,4
Russia,Turkey,1989,2,0,2
Scotland,Norway,1989,1,1,2
Spain,Hungary,1989,4,0,4
Switzerland,Luxembourg,1989,2,1,3
Egypt,Algeria,1989,1,0,1
France,Cyprus,1989,2,0,2
Trinidad and Tobago,United States,1989,0,1,1
Tunisia,Cameroon,1989,0,1,1
Senegal,Central African Republic,1989,3,0,3
Ghana,Guinea,1989,1,1,2
Liberia,Guinea,1989,2,0,2
Liberia,Ghana,1989,1,1,2
Botswana,Zambia,1989,2,1,3
Central African Republic,Chad,1989,1,1,2
Kenya,Uganda,1989,2,1,3
Malawi,Zanzibar,1989,0,0,0
Tanzania,Zimbabwe,1989,0,3,3
Congo,Gabon,1989,0,2,2
Kenya,Tanzania,1989,2,1,3
Chad,Cameroon,1989,0,1,1
Uganda,Zimbabwe,1989,1,1,2
Zambia,Zanzibar,1989,1,0,1
Tanzania,Uganda,1989,1,5,6
Kenya,Zimbabwe,1989,2,1,3
Malawi,Zambia,1989,0,0,0
Chad,Cameroon,1989,0,0,0
Chad,Gabon,1989,0,2,2
England,Yugoslavia,1989,2,1,3
Spain,Switzerland,1989,2,1,3
Uganda,Zambia,1989,3,1,4
Kenya,Malawi,1989,0,1,1
Kenya,Zambia,1989,1,0,1
Malawi,Uganda,1989,3,3,6
Netherlands,Brazil,1989,0,1,1
Italy,Argentina,1989,0,0,0
Senegal,Sierra Leone,1989,1,0,1
Senegal,Algeria,1989,0,0,0
Algeria,Mali,1990,5,0,5
Algeria,Cameroon,1990,3,1,4
Greece,Belgium,1990,2,0,2
Mexico,Argentina,1990,2,0,2
Malawi,Tanzania,1990,2,2,4
Eswatini,Botswana,1990,3,1,4
Botswana,Malawi,1990,2,2,4
Kuwait,France,1990,0,1,1
Eswatini,Tanzania,1990,0,1,1
Botswana,Tanzania,1990,0,0,0
France,German DR,1990,3,0,3
Liberia,Senegal,1990,0,1,1
Nigeria,Ivory Coast,1990,2,0,2
United Arab Emirates,Egypt,1990,1,2,3
Kuwait,German DR,1990,1,2,3
Ivory Coast,Liberia,1990,1,0,1
United Arab Emirates,Egypt,1990,1,0,1
Nigeria,Senegal,1990,1,1,2
Thailand,Kenya,1990,2,1,3
Colombia,Uruguay,1990,0,2,2
Indonesia,Kenya,1990,2,3,5
Iran,Poland,1990,0,2,2
United States,Costa Rica,1990,0,2,2
Algeria,Romania,1990,0,0,0
Costa Rica,Uruguay,1990,0,2,2
Iran,Poland,1990,0,1,1
South Korea,Norway,1990,2,3,5
United States,Colombia,1990,1,1,2
Thailand,Indonesia,1990,1,1,2
United Arab Emirates,Denmark,1990,1,1,2
Malta,Norway,1990,1,1,2
Malta,South Korea,1990,1,2,3
Uganda,Mauritius,1990,4,1,5
Kuwait,Poland,1990,1,1,2
Togo,Cameroon,1990,1,1,2
United Arab Emirates,Finland,1990,1,1,2
Bermuda,United States,1990,0,1,1
Egypt,Denmark,1990,0,0,0
United Arab Emirates,Sweden,1990,2,1,3
Iraq,South Korea,1990,0,0,0
Kuwait,Finland,1990,0,1,1
United Arab Emirates,Sweden,1990,0,2,2
Egypt,South Korea,1990,0,0,0
Colombia,Russia,1990,0,0,0
Belgium,Sweden,1990,0,0,0
Gambia,Guinea-Bissau,1990,0,1,1
Kuwait,Bahrain,1990,1,0,1
Morocco,Ivory Coast,1990,2,1,3
Netherlands,Italy,1990,0,0,0
Spain,Czechoslovakia,1990,1,0,1
Costa Rica,Russia,1990,1,2,3
Oman,United Arab Emirates,1990,1,1,2
Qatar,Bahrain,1990,0,0,0
Kuwait,Oman,1990,1,1,2
United States,Russia,1990,1,3,4
Qatar,United Arab Emirates,1990,0,0,0
Egypt,Austria,1990,0,0,0
France,Germany,1990,2,1,3
Bahrain,Oman,1990,0,0,0
Algeria,Nigeria,1990,5,1,6
Ivory Coast,Egypt,1990,3,1,4
Cameroon,Zambia,1990,0,1,1
Senegal,Kenya,1990,0,0,0
Oman,Qatar,1990,2,4,6
Algeria,Ivory Coast,1990,3,0,3
Bahrain,United Arab Emirates,1990,1,0,1
Nigeria,Egypt,1990,1,0,1
Cameroon,Senegal,1990,0,2,2
Mozambique,Angola,1990,2,1,3
Zambia,Kenya,1990,1,0,1
Kuwait,Qatar,1990,2,0,2
Lesotho,Zimbabwe,1990,1,4,5
Algeria,Egypt,1990,2,0,2
Angola,Zimbabwe,1990,0,2,2
Nigeria,Ivory Coast,1990,1,0,1
Cameroon,Kenya,1990,2,0,2
Kuwait,United Arab Emirates,1990,6,1,7
Zambia,Senegal,1990,0,0,0
Angola,Lesotho,1990,3,1,4
Mozambique,Zimbabwe,1990,3,1,4
United States,Finland,1990,2,1,3
Mozambique,Lesotho,1990,3,0,3
Algeria,Senegal,1990,2,1,3
Nigeria,Zambia,1990,2,0,2
Senegal,Zambia,1990,0,1,1
Algeria,Nigeria,1990,1,0,1
Jamaica,Barbados,1990,0,1,1
Jamaica,Barbados,1990,1,0,1
Hungary,United States,1990,2,0,2
Mexico,Uruguay,1990,2,1,3
Basque Country,Romania,1990,2,2,4
Sint Maarten,Cayman Islands,1990,1,1,2
Saint Kitts and Nevis,Antigua and Barbuda,1990,3,1,4
Saint Martin,British Virgin Islands,1990,3,0,3
Northern Ireland,Norway,1990,2,3,5
Egypt,Romania,1990,1,3,4
England,Brazil,1990,1,0,1
German DR,United States,1990,3,2,5
Greece,Israel,1990,2,1,3
Hungary,France,1990,1,3,4
Republic of Ireland,Wales,1990,1,0,1
Luxembourg,Iceland,1990,1,2,3
Poland,Yugoslavia,1990,0,0,0
Russia,Netherlands,1990,2,1,3
Scotland,Argentina,1990,1,0,1
Spain,Austria,1990,2,3,5
Switzerland,Italy,1990,0,1,1
Zambia,Tanzania,1990,2,0,2
Bermuda,Iceland,1990,0,4,4
Switzerland,Romania,1990,2,1,3
Czechoslovakia,Egypt,1990,0,1,1
United States,Iceland,1990,4,1,5
Algeria,Sweden,1990,1,1,2
Austria,Hungary,1990,3,0,3
Denmark,Turkey,1990,1,0,1
German DR,Egypt,1990,2,0,2
Bermuda,Antigua and Barbuda,1990,2,2,4
Barbados,Saint Lucia,1990,1,0,1
Bermuda,Antigua and Barbuda,1990,3,0,3
Grenada,Curaçao,1990,1,1,2
Mexico,Colombia,1990,2,0,2
Martinique,French Guiana,1990,4,0,4
Saint Vincent and the Grenadines,Dominica,1990,2,1,3
United States,Colombia,1990,0,1,1
England,Czechoslovakia,1990,4,2,6
Germany,Uruguay,1990,3,3,6
Republic of Ireland,Russia,1990,1,0,1
Israel,Romania,1990,1,4,5
Scotland,German DR,1990,0,1,1
Sweden,Wales,1990,4,2,6
Barbados,Antigua and Barbuda,1990,1,0,1
Gabon,Martinique,1990,0,2,2
Jamaica,Saint Kitts and Nevis,1990,3,0,3
Suriname,Guyana,1990,5,0,5
Guadeloupe,Martinique,1990,1,0,1
Austria,Argentina,1990,1,1,2
Colombia,Poland,1990,2,1,3
Brazil,Bulgaria,1990,2,1,3
United States,Malta,1990,1,0,1
Cayman Islands,Jamaica,1990,1,2,3
Costa Rica,Poland,1990,0,2,2
Saint Martin,Guadeloupe,1990,2,1,3
Switzerland,Argentina,1990,1,1,2
Andalusia,Uruguay,1990,1,1,2
United States,Poland,1990,3,1,4
Brazil,German DR,1990,3,3,6
Canada,Mexico,1990,2,1,3
Dominica,French Guiana,1990,1,1,2
Saint Lucia,Bermuda,1990,0,2,2
England,Denmark,1990,1,0,1
Grenada,Suriname,1990,3,1,4
Republic of Ireland,Finland,1990,1,1,2
Israel,Russia,1990,3,2,5
Scotland,Egypt,1990,1,3,4
Barbados,Suriname,1990,5,0,5
Mauritania,Gambia,1990,2,0,2
Northern Ireland,Uruguay,1990,1,0,1
Zimbabwe,Eswatini,1990,4,4,8
Scotland,Poland,1990,1,1,2
Saint Kitts and Nevis,Guadeloupe,1990,2,0,2
Guyana,Curaçao,1990,1,1,2
Jamaica,Saint Martin,1990,1,0,1
Wales,Costa Rica,1990,1,0,1
Poland,United Arab Emirates,1990,4,0,4
Romania,Egypt,1990,1,0,1
England,Uruguay,1990,1,2,3
Israel,Argentina,1990,1,2,3
Belgium,Romania,1990,2,2,4
Bermuda,Barbados,1990,1,1,2
Egypt,Colombia,1990,1,1,2
Gambia,Burkina Faso,1990,0,0,0
Germany,Czechoslovakia,1990,1,0,1
Turkey,Republic of Ireland,1990,0,0,0
Yugoslavia,Spain,1990,0,1,1
Antigua and Barbuda,Saint Lucia,1990,0,2,2
Curaçao,Suriname,1990,1,1,2
Georgia,Lithuania,1990,2,2,4
Guyana,Grenada,1990,0,0,0
Sweden,Finland,1990,6,0,6
Hungary,United Arab Emirates,1990,3,0,3
Malta,Scotland,1990,1,2,3
Bermuda,Barbados,1990,3,0,3
Austria,Netherlands,1990,3,2,5
Burkina Faso,Ghana,1990,1,0,1
French Guiana,Saint Vincent and the Grenadines,1990,2,2,4
Germany,Denmark,1990,1,0,1
Guadeloupe,Jamaica,1990,0,0,0
Iceland,Albania,1990,2,0,2
Italy,Greece,1990,0,0,0
Liechtenstein,United States,1990,1,4,5
Martinique,Dominica,1990,0,0,0
Andalusia,Yugoslavia,1990,0,0,0
Jordan,Iraq,1990,0,2,2
Belgium,Mexico,1990,3,0,3
Hungary,Colombia,1990,3,1,4
Malta,Republic of Ireland,1990,0,3,3
Switzerland,United States,1990,2,1,3
Tunisia,England,1990,1,1,2
Gambia,Mauritania,1990,2,1,3
Yugoslavia,Netherlands,1990,0,2,2
Belgium,Poland,1990,1,1,2
Norway,Denmark,1990,1,2,3
Namibia,Mauritius,1990,1,2,3
Argentina,Cameroon,1990,0,1,1
Italy,Austria,1990,1,0,1
Russia,Romania,1990,0,2,2
United Arab Emirates,Colombia,1990,0,2,2
Botswana,Mauritius,1990,0,1,1
Brazil,Sweden,1990,2,1,3
Germany,Yugoslavia,1990,4,1,5
United States,Czechoslovakia,1990,1,5,6
Costa Rica,Scotland,1990,1,0,1
England,Republic of Ireland,1990,1,1,2
Belgium,South Korea,1990,2,0,2
Netherlands,Egypt,1990,1,1,2
Argentina,Russia,1990,2,0,2
Uruguay,Spain,1990,0,0,0
Cameroon,Romania,1990,2,1,3
Italy,United States,1990,1,0,1
Yugoslavia,Colombia,1990,1,0,1
Austria,Czechoslovakia,1990,0,1,1
Germany,United Arab Emirates,1990,5,1,6
Brazil,Costa Rica,1990,1,0,1
England,Netherlands,1990,0,0,0
Sweden,Scotland,1990,1,2,3
Belgium,Uruguay,1990,3,1,4
Republic of Ireland,Egypt,1990,0,0,0
South Korea,Spain,1990,1,3,4
Argentina,Romania,1990,1,1,2
Cameroon,Russia,1990,0,4,4
Austria,United States,1990,2,1,3
Germany,Colombia,1990,1,1,2
Italy,Czechoslovakia,1990,2,0,2
Yugoslavia,United Arab Emirates,1990,4,1,5
Brazil,Scotland,1990,1,0,1
Sweden,Costa Rica,1990,1,2,3
Belgium,Spain,1990,1,2,3
England,Egypt,1990,1,0,1
Republic of Ireland,Netherlands,1990,1,1,2
South Korea,Uruguay,1990,0,1,1
Cameroon,Colombia,1990,2,1,3
Czechoslovakia,Costa Rica,1990,4,1,5
Brazil,Argentina,1990,0,1,1
Germany,Netherlands,1990,2,1,3
Republic of Ireland,Romania,1990,0,0,0
Italy,Uruguay,1990,2,0,2
England,Belgium,1990,1,0,1
Spain,Yugoslavia,1990,1,2,3
Italy,Republic of Ireland,1990,1,0,1
Yugoslavia,Argentina,1990,0,0,0
Cameroon,England,1990,2,3,5
Germany,Czechoslovakia,1990,1,0,1
Italy,Argentina,1990,1,1,2
Germany,England,1990,1,1,2
Malawi,Tanzania,1990,2,0,2
Italy,England,1990,2,1,3
Germany,Argentina,1990,1,0,1
Barbados,Grenada,1990,1,1,2
Malawi,Tanzania,1990,1,1,2
Barbados,Grenada,1990,4,0,4
Malawi,Tanzania,1990,0,0,0
Barbados,Martinique,1990,2,2,4
China PR,North Korea,1990,2,0,2
Japan,South Korea,1990,0,2,2
Trinidad and Tobago,Jamaica,1990,0,0,0
China PR,Japan,1990,1,0,1
South Korea,North Korea,1990,1,0,1
Togo,Mali,1990,0,0,0
China PR,South Korea,1990,0,1,1
Japan,North Korea,1990,0,1,1
China PR,South Korea,1990,1,1,2
Malawi,DR Congo,1990,1,0,1
Malawi,DR Congo,1990,1,0,1
Faroe Islands,Iceland,1990,2,3,5
Malawi,DR Congo,1990,0,0,0
Tunisia,Morocco,1990,0,0,0
Réunion,Congo,1990,2,1,3
Gabon,Mali,1990,0,0,0
Eswatini,Mozambique,1990,0,0,0
Zambia,DR Congo,1990,0,0,0
Mozambique,Zimbabwe,1990,2,3,5
France,Poland,1990,0,0,0
New Zealand,China PR,1990,2,1,3
Egypt,Ethiopia,1990,2,0,2
Sudan,Mozambique,1990,1,0,1
Indonesia,Singapore,1990,6,0,6
Malawi,Congo,1990,0,1,1
Cameroon,Mali,1990,0,0,0
Guinea,Sierra Leone,1990,1,2,3
DR Congo,Tanzania,1990,2,0,2
Gabon,Uganda,1990,1,0,1
Ivory Coast,Mauritania,1990,2,0,2
Morocco,Niger,1990,2,0,2
Angola,Madagascar,1990,0,1,1
Tunisia,Chad,1990,2,1,3
Zambia,Eswatini,1990,5,0,5
Burkina Faso,Benin,1990,2,0,2
Nigeria,Togo,1990,3,0,3
Austria,Switzerland,1990,1,3,4
Norway,Sweden,1990,1,2,3
New Zealand,China PR,1990,1,0,1
Botswana,Eswatini,1990,3,2,5
Indonesia,Australia,1990,0,3,3
Zambia,Zimbabwe,1990,3,1,4
Botswana,Zimbabwe,1990,0,7,7
Mali,Burkina Faso,1990,2,1,3
Finland,Czechoslovakia,1990,1,1,2
Portugal,Germany,1990,1,1,2
Russia,Romania,1990,1,2,3
Mozambique,Angola,1990,0,2,2
Sierra Leone,Cameroon,1990,1,1,2
Uganda,DR Congo,1990,2,1,3
Tanzania,Gabon,1990,0,0,0
Ghana,Nigeria,1990,1,0,1
Eswatini,Angola,1990,1,1,2
Madagascar,Zambia,1990,0,0,0
Congo,Zimbabwe,1990,2,0,2
Burkina Faso,Togo,1990,2,0,2
Chad,Egypt,1990,0,0,0
Mali,Guinea,1990,1,1,2
Morocco,Mauritania,1990,4,0,4
Mozambique,Kenya,1990,2,1,3
Greece,Albania,1990,1,0,1
Hungary,Turkey,1990,4,1,5
Iceland,France,1990,1,2,3
Sweden,Denmark,1990,0,1,1
South Korea,Australia,1990,1,0,1
Malaysia,Yemen,1990,0,1,1
South Korea,Australia,1990,1,0,1
Denmark,Wales,1990,1,0,1
Belgium,German DR,1990,0,2,2
England,Hungary,1990,1,0,1
Faroe Islands,Austria,1990,1,0,1
Finland,Portugal,1990,0,0,0
Republic of Ireland,Morocco,1990,1,0,1
Northern Ireland,Yugoslavia,1990,0,2,2
Russia,Norway,1990,2,0,2
Scotland,Romania,1990,2,1,3
Spain,Brazil,1990,3,0,3
Switzerland,Bulgaria,1990,2,0,2
Singapore,Malaysia,1990,3,0,3
United States,Trinidad and Tobago,1990,3,0,3
Czechoslovakia,Iceland,1990,1,0,1
Italy,Netherlands,1990,1,0,1
Romania,Poland,1990,2,1,3
Sweden,Bulgaria,1990,2,0,2
Aruba,Curaçao,1990,1,3,4
Benin,Nigeria,1990,0,1,1
Botswana,Cameroon,1990,0,0,0
Niger,Ivory Coast,1990,0,1,1
Togo,Ghana,1990,0,1,1
Denmark,Faroe Islands,1990,4,1,5
Greece,Egypt,1990,6,1,7
Norway,Hungary,1990,0,0,0
Poland,United States,1990,2,3,5
Spain,Iceland,1990,2,1,3
Sweden,Germany,1990,1,3,4
North Korea,South Korea,1990,2,1,3
France,Czechoslovakia,1990,2,1,3
Benin,Togo,1990,1,1,2
Niger,Mauritania,1990,7,1,8
Ghana,Burkina Faso,1990,2,0,2
Croatia,United States,1990,2,1,3
England,Poland,1990,2,0,2
Hungary,Italy,1990,1,1,2
Republic of Ireland,Turkey,1990,5,0,5
Northern Ireland,Denmark,1990,1,1,2
Portugal,Netherlands,1990,1,0,1
Romania,Bulgaria,1990,0,3,3
Scotland,Switzerland,1990,2,1,3
Wales,Belgium,1990,3,1,4
South Korea,North Korea,1990,1,0,1
Greece,Malta,1990,4,0,4
Hungary,Cyprus,1990,4,2,6
Luxembourg,Germany,1990,2,3,5
Norway,Cameroon,1990,6,1,7
Yugoslavia,Austria,1990,4,1,5
Fiji,Solomon Islands,1990,0,0,0
Vanuatu,New Caledonia,1990,1,0,1
Italy,Russia,1990,0,0,0
New Caledonia,Papua New Guinea,1990,2,1,3
Vanuatu,Solomon Islands,1990,1,1,2
New Caledonia,Fiji,1990,0,0,0
Vanuatu,Papua New Guinea,1990,1,0,1
Solomon Islands,Papua New Guinea,1990,1,0,1
Vanuatu,Fiji,1990,1,1,2
Tunisia,Norway,1990,1,3,4
Brazil,Chile,1990,0,0,0
Fiji,Papua New Guinea,1990,1,0,1
New Caledonia,Solomon Islands,1990,3,1,4
Angola,Mozambique,1990,4,2,6
Congo,Mozambique,1990,1,0,1
Angola,Congo,1990,1,0,1
Tunisia,Finland,1990,1,2,3
Austria,Northern Ireland,1990,0,0,0
Bulgaria,Scotland,1990,1,1,2
Cyprus,Norway,1990,0,3,3
Czechoslovakia,Spain,1990,3,2,5
Denmark,Yugoslavia,1990,0,2,2
Republic of Ireland,England,1990,1,1,2
Luxembourg,Wales,1990,0,1,1
San Marino,Switzerland,1990,0,4,4
Turkey,Poland,1990,0,1,1
Albania,France,1990,0,1,1
Ethiopia,Tunisia,1990,0,2,2
Trinidad and Tobago,United States,1990,0,0,0
United States,Russia,1990,0,0,0
Trinidad and Tobago,Russia,1990,0,2,2
Malta,Finland,1990,1,1,2
Tanzania,Uganda,1990,1,1,2
Guatemala,Russia,1990,0,3,3
Romania,San Marino,1990,6,0,6
Congo,Chad,1990,3,0,3
Zanzibar,Tanzania,1990,0,0,0
Cameroon,Gabon,1990,2,1,3
Kenya,Uganda,1990,2,2,4
Malawi,Zimbabwe,1990,0,0,0
Central African Republic,Gabon,1990,0,1,1
Malawi,Tanzania,1990,1,0,1
Chad,Equatorial Guinea,1990,1,0,1
Kenya,Sudan,1990,1,2,3
Mexico,Brazil,1990,0,0,0
Zanzibar,Zimbabwe,1990,0,1,1
Central African Republic,Cameroon,1990,0,3,3
Congo,Equatorial Guinea,1990,6,0,6
Sudan,Uganda,1990,2,2,4
Tanzania,Zimbabwe,1990,2,0,2
Zanzibar,Malawi,1990,2,1,3
Chad,Cameroon,1990,0,1,1
Congo,Gabon,1990,1,0,1
Central African Republic,Equatorial Guinea,1990,3,3,6
Chad,Gabon,1990,2,1,3
Tanzania,Uganda,1990,1,1,2
Zanzibar,Sudan,1990,0,1,1
Algeria,Senegal,1990,1,0,1
Congo,Cameroon,1990,2,1,3
Germany,Switzerland,1990,4,0,4
Greece,Poland,1990,1,2,3
Malta,Netherlands,1990,0,8,8
Portugal,United States,1990,1,0,1
Spain,Albania,1990,9,0,9
Zanzibar,Tanzania,1990,1,2,3
Sudan,Uganda,1990,0,2,2
Croatia,Romania,1990,2,0,2
Cyprus,Italy,1990,0,4,4
Burkina Faso,Mali,1991,2,0,2
Burkina Faso,Niger,1991,2,2,4
Russia,Zambia,1991,4,0,4
Burkina Faso,Nigeria,1991,1,1,2
Ghana,Benin,1991,4,0,4
Morocco,Ivory Coast,1991,3,1,4
Hungary,Russia,1991,1,1,2
Spain,Portugal,1991,1,1,2
India,Hungary,1991,1,2,3
India,Zambia,1991,1,0,1
Cameroon,Algeria,1991,0,0,0
Senegal,Ivory Coast,1991,0,0,0
Senegal,Algeria,1991,2,2,4
Ivory Coast,Cameroon,1991,1,1,2
Greece,Portugal,1991,3,2,5
Hungary,Zambia,1991,4,1,5
India,Russia,1991,1,3,4
Benin,Burkina Faso,1991,1,2,3
Niger,Morocco,1991,1,0,1
Togo,Nigeria,1991,0,0,0
Mexico,Colombia,1991,0,0,0
Australia,Czechoslovakia,1991,0,1,1
United States,Switzerland,1991,0,1,1
Colombia,Switzerland,1991,2,3,5
Northern Ireland,Poland,1991,3,1,4
Malaysia,Indonesia,1991,1,2,3
Australia,Czechoslovakia,1991,0,2,2
England,Cameroon,1991,2,0,2
Guinea-Bissau,Gambia,1991,2,1,3
Scotland,Russia,1991,0,1,1
Wales,Republic of Ireland,1991,0,3,3
Guinea-Bissau,Mauritania,1991,2,0,2
Malta,Portugal,1991,0,1,1
Italy,Belgium,1991,0,0,0
Algeria,Cameroon,1991,0,0,0
Senegal,Ivory Coast,1991,0,0,0
Gambia,Mauritania,1991,0,0,0
Ivory Coast,Cameroon,1991,3,2,5
Senegal,Algeria,1991,1,3,4
Argentina,Hungary,1991,2,0,2
France,Spain,1991,3,1,4
Portugal,Malta,1991,5,0,5
Bermuda,United States,1991,1,0,1
Belgium,Luxembourg,1991,3,0,3
Brazil,Paraguay,1991,1,1,2
Cyprus,Greece,1991,1,1,2
Turkey,Yugoslavia,1991,1,1,2
Suriname,French Guiana,1991,3,0,3
Algeria,Tunisia,1991,2,1,3
Uganda,Sudan,1991,0,1,1
Liechtenstein,Switzerland,1991,0,6,6
United States,Mexico,1991,2,2,4
Argentina,Mexico,1991,0,0,0
Netherlands,Malta,1991,1,0,1
Poland,Finland,1991,1,1,2
Canada,Mexico,1991,0,3,3
United States,Canada,1991,2,0,2
Argentina,Brazil,1991,3,3,6
Belgium,Wales,1991,1,1,2
Czechoslovakia,Poland,1991,4,0,4
England,Republic of Ireland,1991,1,1,2
Germany,Russia,1991,2,1,3
Morocco,Greece,1991,0,0,0
San Marino,Romania,1991,1,3,4
Scotland,Bulgaria,1991,1,1,2
Spain,Hungary,1991,2,4,6
Tunisia,Turkey,1991,0,0,0
Yugoslavia,Northern Ireland,1991,4,1,5
France,Albania,1991,5,0,5
Algeria,Morocco,1991,2,2,4
Cyprus,Hungary,1991,0,2,2
Switzerland,Romania,1991,0,0,0
Mali,Burkina Faso,1991,5,1,6
Sudan,Uganda,1991,1,1,2
Tunisia,Algeria,1991,0,0,0
Denmark,Bulgaria,1991,1,1,2
Mexico,Chile,1991,1,0,1
Mauritania,Morocco,1991,0,2,2
Nigeria,Ghana,1991,0,0,0
Angola,Zambia,1991,1,2,3
DR Congo,Gabon,1991,2,1,3
Guinea,Cameroon,1991,0,0,0
Mali,Sierra Leone,1991,0,0,0
Nicaragua,El Salvador,1991,2,3,5
Sudan,Kenya,1991,1,0,1
Eswatini,Madagascar,1991,0,1,1
Tunisia,Egypt,1991,2,2,4
Uganda,Tanzania,1991,3,2,5
Zimbabwe,Malawi,1991,4,0,4
Austria,Norway,1991,0,0,0
Congo,Benin,1991,1,2,3
Costa Rica,Mexico,1991,0,0,0
Greece,Sweden,1991,2,2,4
Hungary,Russia,1991,0,1,1
Netherlands,Finland,1991,2,0,2
Poland,Turkey,1991,3,0,3
Spain,Romania,1991,0,2,2
Togo,Burkina Faso,1991,1,0,1
Nigeria,Benin,1991,3,0,3
Uganda,Gabon,1991,0,0,0
Tanzania,DR Congo,1991,1,0,1
Chad,Tunisia,1991,0,0,0
Congo,Malawi,1991,2,1,3
Mali,Cameroon,1991,0,2,2
Mozambique,Sudan,1991,1,0,1
Sierra Leone,Guinea,1991,0,1,1
Eswatini,Zambia,1991,2,1,3
Ghana,Togo,1991,2,0,2
Ivory Coast,Niger,1991,1,0,1
Albania,Czechoslovakia,1991,0,2,2
Bulgaria,Switzerland,1991,2,3,5
Germany,Belgium,1991,1,0,1
Republic of Ireland,Poland,1991,0,0,0
Italy,Hungary,1991,3,1,4
Northern Ireland,Faroe Islands,1991,1,1,2
Norway,Cyprus,1991,3,0,3
San Marino,Scotland,1991,0,2,2
Sweden,Austria,1991,6,0,6
Turkey,England,1991,0,1,1
Wales,Iceland,1991,1,0,1
Yugoslavia,Denmark,1991,1,2,3
Madagascar,Angola,1991,0,0,0
Jamaica,Haiti,1991,2,1,3
Senegal,Ivory Coast,1991,0,0,0
United States,Uruguay,1991,1,0,1
Jamaica,Haiti,1991,2,0,2
Malta,Iceland,1991,1,4,5
Mexico,Uruguay,1991,0,2,2
Aruba,Suriname,1991,0,1,1
Martinique,DR Congo,1991,0,0,0
Cayman Islands,British Virgin Islands,1991,2,1,3
Guyana,Aruba,1991,4,1,5
Puerto Rico,Haiti,1991,2,3,5
Saint Lucia,Montserrat,1991,3,0,3
Dominican Republic,Haiti,1991,1,1,2
Guyana,Suriname,1991,1,1,2
New Zealand,Australia,1991,0,1,1
Panama,Honduras,1991,2,0,2
Saint Kitts and Nevis,Cayman Islands,1991,1,1,2
Anguilla,Montserrat,1991,1,1,2
Hong Kong,Malaysia,1991,2,0,2
Puerto Rico,Dominican Republic,1991,1,3,4
Saint Kitts and Nevis,British Virgin Islands,1991,0,0,0
Australia,New Zealand,1991,2,1,3
Martinique,French Guiana,1991,1,2,3
Finland,Malta,1991,2,0,2
Saint Lucia,Anguilla,1991,6,0,6
Yugoslavia,Faroe Islands,1991,7,0,7
Guadeloupe,French Guiana,1991,1,0,1
Honduras,Panama,1991,3,0,3
Martinique,Guadeloupe,1991,3,1,4
United States,Argentina,1991,0,1,1
England,Russia,1991,3,1,4
Guyana,Haiti,1991,1,1,2
Austria,Faroe Islands,1991,3,0,3
Republic of Ireland,Chile,1991,1,1,2
San Marino,Bulgaria,1991,0,3,3
Argentina,Russia,1991,1,1,2
Dominican Republic,Trinidad and Tobago,1991,0,7,7
Norway,Romania,1991,1,0,1
Saint Lucia,Martinique,1991,0,0,0
Jamaica,Guyana,1991,6,0,6
Dominican Republic,Saint Lucia,1991,0,0,0
England,Argentina,1991,2,2,4
Martinique,Trinidad and Tobago,1991,0,1,1
Albania,Iceland,1991,1,0,1
Costa Rica,Honduras,1991,2,0,2
Guatemala,El Salvador,1991,0,0,0
Jamaica,Cayman Islands,1991,3,2,5
Dominican Republic,Martinique,1991,1,4,5
Saint Lucia,Trinidad and Tobago,1991,2,1,3
Brazil,Bulgaria,1991,3,0,3
Cayman Islands,Guyana,1991,1,2,3
Costa Rica,El Salvador,1991,7,1,8
Guatemala,Honduras,1991,0,0,0
Poland,Wales,1991,0,0,0
Russia,Cyprus,1991,4,0,4
Chile,Uruguay,1991,2,1,3
Guyana,Trinidad and Tobago,1991,1,3,4
Jamaica,Saint Lucia,1991,2,0,2
Australia,England,1991,0,1,1
United States,Republic of Ireland,1991,1,1,2
Costa Rica,Guatemala,1991,1,0,1
Guyana,Saint Lucia,1991,1,4,5
Honduras,El Salvador,1991,2,1,3
Jamaica,Trinidad and Tobago,1991,2,0,2
Japan,Thailand,1991,1,0,1
New Zealand,England,1991,0,1,1
Denmark,Austria,1991,2,1,3
Finland,Netherlands,1991,1,1,2
Iceland,Czechoslovakia,1991,0,1,1
Norway,Italy,1991,2,1,3
Sweden,Colombia,1991,2,2,4
Switzerland,San Marino,1991,7,0,7
Wales,Germany,1991,1,0,1
Peru,Ecuador,1991,0,1,1
Indonesia,Malta,1991,0,3,3
South Korea,Egypt,1991,0,0,0
New Zealand,England,1991,0,2,2
Egypt,Malta,1991,5,2,7
Ivory Coast,Senegal,1991,2,0,2
South Korea,Indonesia,1991,3,0,3
Egypt,Indonesia,1991,6,0,6
South Korea,Malta,1991,1,1,2
Denmark,Italy,1991,0,2,2
Malaysia,England,1991,2,4,6
Peru,Uruguay,1991,1,0,1
Sweden,Russia,1991,2,3,5
Bolivia,Paraguay,1991,0,1,1
South Korea,Australia,1991,0,0,0
Sweden,Denmark,1991,4,0,4
Italy,Russia,1991,1,1,2
South Korea,Egypt,1991,2,0,2
Paraguay,Bolivia,1991,0,0,0
Ecuador,Chile,1991,2,1,3
Slovenia,Croatia,1991,0,1,1
Mozambique,Botswana,1991,2,0,2
Uruguay,Peru,1991,0,0,0
Mozambique,Eswatini,1991,2,1,3
Philippines,Brunei,1991,2,1,3
Faroe Islands,Shetland,1991,3,0,3
Jersey,Greenland,1991,4,3,7
Ynys Môn,Guernsey,1991,1,0,1
Åland Islands,Isle of Wight,1991,1,0,1
Costa Rica,Colombia,1991,0,1,1
Ecuador,Peru,1991,2,2,4
Mozambique,Botswana,1991,1,1,2
Faroe Islands,Greenland,1991,3,2,5
Jersey,Shetland,1991,2,0,2
Åland Islands,Guernsey,1991,2,0,2
Ynys Môn,Isle of Wight,1991,5,1,6
Uruguay,Chile,1991,2,1,3
Faroe Islands,Jersey,1991,5,3,8
Shetland,Greenland,1991,5,2,7
Åland Islands,Ynys Môn,1991,0,1,1
Isle of Wight,Guernsey,1991,1,1,2
Brazil,Argentina,1991,1,1,2
Canada,Honduras,1991,2,4,6
Gambia,Ghana,1991,2,3,5
Mexico,Jamaica,1991,4,1,5
Isle of Wight,Greenland,1991,3,1,4
Shetland,Guernsey,1991,2,1,3
Åland Islands,Jersey,1991,0,2,2
Costa Rica,Guatemala,1991,2,0,2
United States,Trinidad and Tobago,1991,2,1,3
Faroe Islands,Ynys Môn,1991,2,0,2
Canada,Mexico,1991,1,3,4
Chile,Ecuador,1991,3,1,4
Jamaica,Honduras,1991,0,5,5
Trinidad and Tobago,Costa Rica,1991,2,1,3
United States,Guatemala,1991,3,0,3
Moldova,Georgia,1991,2,4,6
Jamaica,Canada,1991,2,3,5
Mexico,Honduras,1991,1,1,2
Trinidad and Tobago,Guatemala,1991,0,1,1
United States,Costa Rica,1991,3,2,5
Honduras,Costa Rica,1991,2,0,2
United States,Mexico,1991,2,0,2
Chile,Venezuela,1991,2,0,2
Malawi,Kenya,1991,0,2,2
Paraguay,Peru,1991,1,0,1
Bolivia,Uruguay,1991,1,1,2
Colombia,Ecuador,1991,1,0,1
Gabon,Ghana,1991,0,1,1
Mexico,Costa Rica,1991,2,0,2
United States,Honduras,1991,0,0,0
Argentina,Venezuela,1991,3,0,3
Chile,Peru,1991,4,2,6
Malawi,Kenya,1991,1,1,2
Bolivia,Brazil,1991,1,2,3
Congo,DR Congo,1991,0,0,0
Ecuador,Uruguay,1991,1,1,2
Chile,Argentina,1991,0,1,1
Malawi,Kenya,1991,1,1,2
Paraguay,Venezuela,1991,5,0,5
Bolivia,Colombia,1991,0,0,0
Brazil,Uruguay,1991,1,1,2
Argentina,Paraguay,1991,4,1,5
Egypt,Chad,1991,5,1,6
Peru,Venezuela,1991,5,1,6
Bolivia,Ecuador,1991,0,4,4
Brazil,Colombia,1991,0,2,2
Burkina Faso,Ghana,1991,2,1,3
Argentina,Peru,1991,3,2,5
Cameroon,Sierra Leone,1991,1,0,1
Chile,Paraguay,1991,4,0,4
DR Congo,Uganda,1991,1,0,1
Gabon,Tanzania,1991,1,0,1
Guinea,Mali,1991,2,1,3
Kenya,Mozambique,1991,1,0,1
Togo,Benin,1991,2,0,2
Zambia,Madagascar,1991,2,1,3
Zimbabwe,Congo,1991,2,2,4
Angola,Eswatini,1991,1,1,2
Brazil,Ecuador,1991,3,1,4
Colombia,Uruguay,1991,0,1,1
Faroe Islands,Turkey,1991,1,1,2
Argentina,Brazil,1991,3,2,5
Chile,Colombia,1991,1,1,2
Iceland,Turkey,1991,5,1,6
Brazil,Colombia,1991,2,0,2
Chile,Argentina,1991,0,0,0
Argentina,Colombia,1991,2,1,3
Chile,Brazil,1991,0,2,2
Ivory Coast,Guinea,1991,0,0,0
Egypt,Tunisia,1991,2,2,4
Mauritania,Niger,1991,0,1,1
Japan,South Korea,1991,0,1,1
Malawi,Zimbabwe,1991,2,2,4
Nigeria,Burkina Faso,1991,7,1,8
Benin,Ghana,1991,0,0,0
Zambia,Angola,1991,1,0,1
Cameroon,Guinea,1991,1,0,1
Gabon,DR Congo,1991,0,0,0
Kenya,Sudan,1991,2,1,3
Ivory Coast,Morocco,1991,2,0,2
Sierra Leone,Mali,1991,2,0,2
Tanzania,Uganda,1991,1,1,2
Czechoslovakia,Yugoslavia,1991,0,0,0
Norway,Sweden,1991,1,2,3
Benin,Ivory Coast,1991,0,3,3
Poland,France,1991,1,5,6
Malawi,Mozambique,1991,1,0,1
Malawi,Mozambique,1991,2,0,2
Bulgaria,Turkey,1991,0,0,0
Czechoslovakia,Switzerland,1991,1,1,2
Poland,Sweden,1991,2,0,2
Norway,Russia,1991,0,1,1
Romania,United States,1991,0,2,2
Ivory Coast,Benin,1991,1,0,1
Czechoslovakia,France,1991,1,2,3
Greece,Albania,1991,0,2,2
Iceland,Denmark,1991,0,0,0
Portugal,Austria,1991,1,1,2
Spain,Uruguay,1991,2,1,3
Sweden,Yugoslavia,1991,4,3,7
Turkey,United States,1991,1,1,2
Mali,Guinea,1991,0,0,0
Guam,Tahiti,1991,0,15,15
Papua New Guinea,Solomon Islands,1991,0,0,0
Fiji,New Caledonia,1991,3,1,4
Vanuatu,Wallis Islands and Futuna,1991,4,0,4
England,Germany,1991,0,1,1
Faroe Islands,Northern Ireland,1991,0,5,5
Hungary,Republic of Ireland,1991,1,2,3
Luxembourg,Belgium,1991,0,2,2
Netherlands,Poland,1991,1,1,2
New Caledonia,Tahiti,1991,2,2,4
Portugal,Finland,1991,1,0,1
Solomon Islands,Wallis Islands and Futuna,1991,5,0,5
Switzerland,Scotland,1991,2,2,4
Wales,Brazil,1991,1,0,1
Bermuda,Jamaica,1991,1,1,2
Fiji,Guam,1991,14,1,15
Papua New Guinea,Vanuatu,1991,0,1,1
Fiji,Tahiti,1991,3,0,3
Solomon Islands,Vanuatu,1991,3,0,3
United States,Jamaica,1991,1,0,1
Guam,New Caledonia,1991,0,18,18
Papua New Guinea,Wallis Islands and Futuna,1991,5,0,5
Fiji,Vanuatu,1991,3,1,4
New Caledonia,Solomon Islands,1991,1,4,5
Wallis Islands and Futuna,Tahiti,1991,0,5,5
Wallis Islands and Futuna,Guam,1991,5,0,5
Fiji,Solomon Islands,1991,1,1,2
New Caledonia,Vanuatu,1991,3,1,4
Botswana,Eswatini,1991,2,1,3
Egypt,Nigeria,1991,1,2,3
Uganda,Zimbabwe,1991,1,2,3
Cameroon,Mali,1991,1,0,1
Mauritius,Tunisia,1991,0,3,3
Egypt,Zimbabwe,1991,2,3,5
Nigeria,Uganda,1991,8,1,9
Cameroon,Tunisia,1991,0,1,1
Mali,Mauritius,1991,5,0,5
Bulgaria,Italy,1991,2,1,3
Egypt,Uganda,1991,1,0,1
Faroe Islands,Denmark,1991,0,4,4
Iceland,Spain,1991,2,0,2
Nigeria,Zimbabwe,1991,1,0,1
Norway,Czechoslovakia,1991,2,3,5
Russia,Hungary,1991,2,2,4
Cameroon,Mauritius,1991,1,0,1
Mali,Tunisia,1991,0,0,0
Cameroon,Nigeria,1991,1,0,1
Egypt,Mali,1991,0,0,0
Mauritius,Uganda,1991,3,0,3
Tunisia,Zimbabwe,1991,3,1,4
Botswana,Ghana,1991,0,0,0
Cameroon,Tunisia,1991,1,0,1
Nigeria,Zimbabwe,1991,3,0,3
Singapore,Indonesia,1991,2,0,2
Austria,Denmark,1991,0,3,3
Finland,Greece,1991,1,1,2
Hungary,Belgium,1991,0,2,2
Switzerland,Sweden,1991,3,1,4
Luxembourg,Portugal,1991,1,1,2
Russia,Italy,1991,0,0,0
Spain,France,1991,1,2,3
Algeria,Iran,1991,1,0,1
Bulgaria,San Marino,1991,4,0,4
Cyprus,Iceland,1991,1,1,2
Czechoslovakia,Albania,1991,2,1,3
England,Turkey,1991,1,0,1
Faroe Islands,Yugoslavia,1991,0,2,2
Germany,Wales,1991,4,1,5
Netherlands,Portugal,1991,1,0,1
Northern Ireland,Austria,1991,2,1,3
Poland,Republic of Ireland,1991,3,3,6
Romania,Scotland,1991,1,0,1
United States,North Korea,1991,1,2,3
Brazil,Yugoslavia,1991,3,1,4
Greece,Finland,1991,2,0,2
Hungary,Norway,1991,0,0,0
Ghana,Senegal,1991,2,3,5
Ivory Coast,Nigeria,1991,2,0,2
Ghana,Nigeria,1991,1,0,1
Ivory Coast,Senegal,1991,1,0,1
Tanzania,Kenya,1991,1,1,2
Austria,Yugoslavia,1991,0,2,2
Cyprus,Russia,1991,0,3,3
Denmark,Northern Ireland,1991,2,1,3
Italy,Norway,1991,1,1,2
Poland,England,1991,1,1,2
Romania,Switzerland,1991,1,0,1
Scotland,San Marino,1991,4,0,4
Spain,Czechoslovakia,1991,2,1,3
Turkey,Republic of Ireland,1991,1,3,4
Wales,Luxembourg,1991,1,0,1
Lithuania,Estonia,1991,4,1,5
Estonia,Latvia,1991,0,2,2
Tanzania,Kenya,1991,1,2,3
Lithuania,Latvia,1991,1,1,2
Belgium,Germany,1991,0,1,1
Bulgaria,Romania,1991,1,1,2
France,Iceland,1991,3,1,4
Mexico,Uruguay,1991,1,1,2
Portugal,Greece,1991,1,0,1
Cape Verde,Guinea-Bissau,1991,2,1,3
Gambia,Mali,1991,1,0,1
Ivory Coast,Niger,1991,5,2,7
Kenya,Zambia,1991,0,1,1
Guinea,Sierra Leone,1991,0,1,1
Senegal,Guinea-Bissau,1991,4,0,4
Sudan,Tanzania,1991,1,1,2
United States,Costa Rica,1991,1,1,2
Malawi,Zanzibar,1991,1,0,1
Gambia,Guinea,1991,0,0,0
Mali,Sierra Leone,1991,1,1,2
Costa Rica,Mexico,1991,1,1,2
Malta,Libya,1991,2,0,2
Senegal,Cape Verde,1991,0,0,0
Tunisia,Ivory Coast,1991,5,3,8
Uganda,Sudan,1991,2,0,2
Zambia,Zanzibar,1991,3,2,5
Gambia,Sierra Leone,1991,0,0,0
Guinea,Mali,1991,0,2,2
Kenya,Malawi,1991,1,0,1
Cape Verde,Sierra Leone,1991,0,0,0
Kenya,Zanzibar,1991,3,2,5
Senegal,Gambia,1991,2,0,2
Uganda,Tanzania,1991,5,0,5
Malawi,Zambia,1991,0,0,0
Senegal,Cape Verde,1991,1,0,1
Egypt,Poland,1991,4,0,4
Greece,Netherlands,1991,0,2,2
Mexico,Hungary,1991,3,0,3
Morocco,Mali,1991,3,0,3
Uganda,Kenya,1991,1,3,4
Egypt,Poland,1991,0,0,0
Sudan,Zambia,1991,2,3,5
Kenya,Zambia,1991,0,2,2
Uganda,Sudan,1991,3,1,4
El Salvador,Hungary,1991,1,1,2
Kuwait,Poland,1991,0,2,2
Algeria,Senegal,1991,3,1,4
Brazil,Czechoslovakia,1991,2,1,3
Germany,Luxembourg,1991,4,0,4
Egypt,Romania,1991,3,1,4
Italy,Cyprus,1991,2,0,2
Malta,Greece,1991,1,1,2
Egypt,Romania,1991,1,1,2
Tunisia,Cameroon,1991,2,2,4
Morocco,Algeria,1991,1,1,2
Malawi,Zambia,1991,0,2,2
Egypt,Czechoslovakia,1992,2,0,2
DR Congo,Ivory Coast,1992,2,0,2
Guyana,Barbados,1992,0,2,2
Egypt,Norway,1992,0,0,0
Cameroon,Morocco,1992,1,0,1
Senegal,Nigeria,1992,1,2,3
Algeria,Ivory Coast,1992,0,3,3
Egypt,Zambia,1992,0,1,1
Morocco,DR Congo,1992,1,1,2
Nigeria,Kenya,1992,2,1,3
Ivory Coast,Congo,1992,0,0,0
Portugal,Spain,1992,0,0,0
Zambia,Ghana,1992,0,1,1
Cameroon,DR Congo,1992,1,1,2
Senegal,Kenya,1992,3,0,3
Algeria,Congo,1992,1,1,2
Egypt,Ghana,1992,0,1,1
Nigeria,DR Congo,1992,1,0,1
Senegal,Cameroon,1992,0,1,1
Ghana,Congo,1992,2,1,3
Ivory Coast,Zambia,1992,1,0,1
Cameroon,Ivory Coast,1992,0,0,0
Nigeria,Ghana,1992,1,2,3
Cameroon,Nigeria,1992,1,2,3
United States,Russia,1992,0,1,1
Australia,Sweden,1992,0,0,0
Ghana,Ivory Coast,1992,0,0,0
Albania,Greece,1992,1,0,1
Australia,Sweden,1992,1,0,1
El Salvador,Russia,1992,0,3,3
Australia,Sweden,1992,1,0,1
United States,Russia,1992,2,1,3
Bermuda,Norway,1992,1,3,4
Malta,Iceland,1992,1,0,1
Costa Rica,United States,1992,0,0,0
Greece,Romania,1992,1,0,1
Israel,Russia,1992,1,2,3
Portugal,Netherlands,1992,2,0,2
Turkey,Finland,1992,1,1,2
El Salvador,United States,1992,2,0,2
England,France,1992,2,0,2
Republic of Ireland,Wales,1992,0,1,1
Italy,San Marino,1992,4,0,4
Scotland,Northern Ireland,1992,1,0,1
Spain,Russia,1992,1,1,2
Tunisia,Nigeria,1992,1,1,2
Brazil,United States,1992,3,0,3
Tunisia,Belgium,1992,2,1,3
United Arab Emirates,Iceland,1992,0,1,1
Israel,Cyprus,1992,2,1,3
Costa Rica,El Salvador,1992,2,0,2
Saint Vincent and the Grenadines,Curaçao,1992,2,2,4
Dominica,Guadeloupe,1992,0,0,0
Barbados,Curaçao,1992,1,0,1
Grenada,Curaçao,1992,0,1,1
Mexico,Russia,1992,4,0,4
Mexico,Russia,1992,1,1,2
Spain,United States,1992,2,0,2
El Salvador,Honduras,1992,1,1,2
Morocco,United States,1992,3,1,4
Dominican Republic,Puerto Rico,1992,1,2,3
Saint Lucia,Saint Vincent and the Grenadines,1992,1,0,1
Cyprus,Greece,1992,1,3,4
Czechoslovakia,England,1992,2,2,4
France,Belgium,1992,3,3,6
Hungary,Austria,1992,2,1,3
Republic of Ireland,Switzerland,1992,2,1,3
Italy,Germany,1992,1,0,1
Luxembourg,Turkey,1992,2,3,5
Netherlands,Yugoslavia,1992,2,0,2
Scotland,Finland,1992,1,1,2
Puerto Rico,Dominican Republic,1992,1,1,2
Saint Vincent and the Grenadines,Saint Lucia,1992,3,1,4
Cayman Islands,Martinique,1992,0,7,7
Canada,China PR,1992,5,2,7
Sint Maarten,Cayman Islands,1992,4,2,6
United States,China PR,1992,5,0,5
Sint Maarten,Martinique,1992,1,1,2
Togo,Ghana,1992,1,0,1
Israel,Iceland,1992,2,2,4
Romania,Latvia,1992,2,0,2
Turkey,Denmark,1992,2,1,3
Jamaica,Bermuda,1992,0,0,0
Austria,Lithuania,1992,4,0,4
Antigua and Barbuda,Montserrat,1992,5,0,5
Brazil,Finland,1992,3,1,4
Saint Kitts and Nevis,British Virgin Islands,1992,4,0,4
Antigua and Barbuda,British Virgin Islands,1992,2,0,2
Saint Kitts and Nevis,Montserrat,1992,10,0,10
Barbados,Trinidad and Tobago,1992,1,2,3
Curaçao,Antigua and Barbuda,1992,1,1,2
Singapore,Malaysia,1992,1,1,2
China PR,Indonesia,1992,2,0,2
Belgium,Cyprus,1992,1,0,1
Czechoslovakia,Germany,1992,1,1,2
Singapore,Indonesia,1992,1,2,3
Spain,Albania,1992,3,0,3
Tunisia,Sweden,1992,0,1,1
China PR,Malaysia,1992,4,0,4
Indonesia,Malaysia,1992,1,1,2
Antigua and Barbuda,Curaçao,1992,3,0,3
Bermuda,Haiti,1992,1,0,1
Guyana,Suriname,1992,1,2,3
Singapore,China PR,1992,0,1,1
Northern Ireland,Lithuania,1992,2,2,4
Switzerland,Bulgaria,1992,0,2,2
Austria,Wales,1992,1,1,2
Denmark,Norway,1992,1,0,1
El Salvador,Costa Rica,1992,1,1,2
Republic of Ireland,United States,1992,4,1,5
Russia,England,1992,2,2,4
Ukraine,Hungary,1992,1,3,4
Uruguay,Brazil,1992,1,0,1
Anguilla,Cuba,1992,0,3,3
French Guiana,Guyana,1992,1,1,2
Romania,Faroe Islands,1992,7,0,7
Sweden,Poland,1992,5,0,5
Aruba,French Guiana,1992,0,2,2
Congo,Haiti,1992,4,1,5
Congo,Guadeloupe,1992,1,1,2
Cuba,Anguilla,1992,5,0,5
Suriname,French Guiana,1992,3,2,5
Iran,Pakistan,1992,7,0,7
Hungary,England,1992,0,1,1
Greece,Iceland,1992,1,0,1
Norway,Faroe Islands,1992,2,0,2
Finland,Bulgaria,1992,0,3,3
Kuwait,Syria,1992,0,0,0
United Arab Emirates,Qatar,1992,1,0,1
India,Iran,1992,0,3,3
England,Brazil,1992,1,1,2
Qatar,Kuwait,1992,0,0,0
United Arab Emirates,Syria,1992,2,0,2
United States,Scotland,1992,0,1,1
Austria,Poland,1992,2,4,6
Bahrain,Algeria,1992,0,0,0
Canada,Scotland,1992,1,3,4
Moldova,Lithuania,1992,1,1,2
Romania,Wales,1992,5,1,6
United Arab Emirates,Syria,1992,0,0,0
Jamaica,Puerto Rico,1992,2,1,3
Guatemala,Ecuador,1992,1,1,2
Haiti,Bermuda,1992,2,1,3
Suriname,Guyana,1992,1,1,2
Ethiopia,Sudan,1992,5,1,6
Republic of Ireland,Albania,1992,2,0,2
Malta,Latvia,1992,1,0,1
Costa Rica,Ecuador,1992,2,1,3
Netherlands,Austria,1992,3,2,5
Poland,Czechoslovakia,1992,1,0,1
Sweden,Hungary,1992,2,1,3
Switzerland,France,1992,2,1,3
Qatar,Syria,1992,4,2,6
Germany,Turkey,1992,1,0,1
Japan,Argentina,1992,0,1,1
Netherlands,Wales,1992,4,0,4
Puerto Rico,Jamaica,1992,0,1,1
United States,Republic of Ireland,1992,3,1,4
Italy,Portugal,1992,0,0,0
Qatar,Oman,1992,4,0,4
Trinidad and Tobago,Barbados,1992,3,0,3
Kazakhstan,Turkmenistan,1992,1,0,1
Germany,Northern Ireland,1992,1,1,2
Albania,Lithuania,1992,1,0,1
Argentina,Wales,1992,1,0,1
Denmark,Russia,1992,1,1,2
Estonia,Slovenia,1992,1,1,2
Faroe Islands,Belgium,1992,0,3,3
Finland,England,1992,1,2,3
Hungary,Iceland,1992,1,2,3
North Korea,Taiwan,1992,6,0,6
Macau,Hong Kong,1992,2,2,4
Norway,Scotland,1992,0,0,0
United States,Portugal,1992,1,0,1
Republic of Ireland,Italy,1992,0,2,2
France,Netherlands,1992,1,1,2
Hong Kong,Taiwan,1992,0,0,0
North Korea,Macau,1992,2,0,2
United States,Italy,1992,1,1,2
Guatemala,Nicaragua,1992,7,1,8
Republic of Ireland,Portugal,1992,2,0,2
Japan,Wales,1992,0,1,1
North Korea,Hong Kong,1992,0,0,0
Macau,Taiwan,1992,2,0,2
New Zealand,Fiji,1992,3,0,3
Sweden,France,1992,1,1,2
Denmark,England,1992,0,0,0
Netherlands,Scotland,1992,1,0,1
Russia,Germany,1992,1,1,2
Canada,Hong Kong,1992,3,1,4
United States,Australia,1992,0,1,1
Antigua and Barbuda,Bermuda,1992,0,3,3
France,England,1992,0,0,0
Gabon,Togo,1992,1,0,1
Guinea-Bissau,Cape Verde,1992,3,1,4
Lesotho,Botswana,1992,0,0,0
Sweden,Denmark,1992,1,0,1
Netherlands,Russia,1992,0,0,0
Scotland,Germany,1992,0,2,2
Faroe Islands,Cyprus,1992,0,2,2
France,Denmark,1992,1,2,3
Sweden,England,1992,2,1,3
Tajikistan,Uzbekistan,1992,2,2,4
Argentina,Australia,1992,2,0,2
Netherlands,Germany,1992,3,1,4
Scotland,Russia,1992,3,0,3
Antigua and Barbuda,Suriname,1992,1,1,2
South Korea,Bangladesh,1992,6,0,6
Guadeloupe,Jamaica,1992,0,1,1
Mozambique,Eswatini,1992,4,1,5
Antigua and Barbuda,Martinique,1992,1,4,5
Gabon,Burundi,1992,0,1,1
Sweden,Germany,1992,2,3,5
Thailand,South Korea,1992,2,1,3
Uruguay,Australia,1992,2,0,2
Cuba,Jamaica,1992,0,0,0
Netherlands,Denmark,1992,2,2,4
Thailand,Bangladesh,1992,1,0,1
Jamaica,Martinique,1992,1,0,1
Trinidad and Tobago,Cuba,1992,1,0,1
Denmark,Germany,1992,2,0,2
Sudan,Eritrea,1992,1,1,2
Cuba,Martinique,1992,1,1,2
Trinidad and Tobago,Jamaica,1992,3,1,4
United States,Ukraine,1992,0,0,0
Vanuatu,New Zealand,1992,1,4,5
Botswana,Lesotho,1992,0,4,4
Cape Verde,Guinea-Bissau,1992,1,0,1
Chad,Eritrea,1992,0,1,1
China PR,Slovakia,1992,2,3,5
Honduras,Panama,1992,4,0,4
Uzbekistan,Turkmenistan,1992,2,1,3
Honduras,Panama,1992,4,0,4
Sudan,Chad,1992,1,0,1
New Zealand,Vanuatu,1992,8,0,8
Kazakhstan,Libya,1992,1,0,1
Bermuda,Antigua and Barbuda,1992,2,1,3
Uruguay,Ecuador,1992,3,1,4
Australia,Croatia,1992,1,0,1
Guatemala,Poland,1992,2,2,4
Guinea-Bissau,Cape Verde,1992,1,0,1
Trinidad and Tobago,Jamaica,1992,1,2,3
Malawi,Zimbabwe,1992,0,0,0
South Africa,Cameroon,1992,1,0,1
Australia,Croatia,1992,3,1,4
Malawi,Zimbabwe,1992,0,0,0
South Africa,Cameroon,1992,1,2,3
Latvia,Estonia,1992,2,1,3
Estonia,Lithuania,1992,1,1,2
South Africa,Cameroon,1992,2,2,4
Turkmenistan,Tajikistan,1992,3,3,6
Australia,Croatia,1992,0,0,0
Latvia,Lithuania,1992,2,3,5
New Caledonia,Tahiti,1992,0,1,1
Kazakhstan,Uzbekistan,1992,1,0,1
Solomon Islands,Tahiti,1992,1,1,2
Guatemala,Honduras,1992,0,0,0
Nicaragua,El Salvador,1992,0,5,5
Vanuatu,Tahiti,1992,1,2,3
Cameroon,Egypt,1992,0,1,1
New Caledonia,Tahiti,1992,1,2,3
El Salvador,Nicaragua,1992,5,1,6
Fiji,Solomon Islands,1992,2,1,3
Vanuatu,New Caledonia,1992,0,1,1
El Salvador,Mexico,1992,1,2,3
Honduras,Guatemala,1992,2,0,2
Ivory Coast,Egypt,1992,2,0,2
Vanuatu,Solomon Islands,1992,1,3,4
Fiji,New Caledonia,1992,2,2,4
Ivory Coast,Egypt,1992,2,2,4
New Caledonia,Solomon Islands,1992,1,0,1
Vanuatu,Fiji,1992,0,2,2
Brazil,Mexico,1992,5,0,5
United States,Colombia,1992,0,1,1
Lesotho,Namibia,1992,2,0,2
Lesotho,Namibia,1992,2,2,4
Mexico,Colombia,1992,0,0,0
Uruguay,Costa Rica,1992,2,1,3
United States,Brazil,1992,0,1,1
Faroe Islands,Israel,1992,1,1,2
Ecuador,Costa Rica,1992,1,1,2
Indonesia,Malaysia,1992,1,1,2
Lesotho,Mauritius,1992,1,0,1
Iceland,Israel,1992,0,2,2
Lesotho,Mauritius,1992,2,2,4
Libya,Niger,1992,0,0,0
Australia,Malaysia,1992,0,1,1
El Salvador,Honduras,1992,0,3,3
Latvia,Lithuania,1992,1,2,3
Libya,Mali,1992,0,1,1
Algeria,Guinea-Bissau,1992,3,1,4
Indonesia,Australia,1992,0,3,3
Mali,Libya,1992,2,1,3
Uganda,Ethiopia,1992,3,1,4
Malawi,Egypt,1992,1,0,1
Zambia,Mauritius,1992,3,1,4
Benin,Niger,1992,1,2,3
Sudan,Nigeria,1992,0,0,0
Burundi,Congo,1992,1,0,1
DR Congo,Mozambique,1992,2,0,2
Estonia,Switzerland,1992,0,6,6
Gabon,Cameroon,1992,0,0,0
Lesotho,Kenya,1992,2,2,4
Panama,Costa Rica,1992,1,0,1
Zimbabwe,South Africa,1992,4,1,5
Ethiopia,Iraq,1992,0,13,13
Jordan,Sudan,1992,3,0,3
Moldova,Pakistan,1992,5,0,5
Bulgaria,Mexico,1992,1,1,2
Czechoslovakia,Austria,1992,2,2,4
Congo,Iraq,1992,0,3,3
Jordan,Pakistan,1992,2,0,2
Moldova,Sudan,1992,2,1,3
China PR,North Korea,1992,2,2,4
Congo,Ethiopia,1992,3,0,3
Japan,South Korea,1992,0,0,0
Jordan,Moldova,1992,1,0,1
Pakistan,Sudan,1992,0,4,4
Costa Rica,Panama,1992,5,1,6
Uzbekistan,Kyrgyzstan,1992,3,0,3
China PR,Japan,1992,0,2,2
South Korea,North Korea,1992,1,1,2
China PR,South Korea,1992,0,2,2
Finland,Poland,1992,0,0,0
France,Brazil,1992,0,2,2
Hungary,Ukraine,1992,2,1,3
Iraq,Moldova,1992,1,0,1
Japan,North Korea,1992,4,1,5
Jordan,Congo,1992,2,1,3
Latvia,Denmark,1992,0,0,0
Norway,Sweden,1992,2,2,4
Romania,Mexico,1992,2,0,2
Turkey,Bulgaria,1992,3,2,5
Congo,Moldova,1992,1,3,4
Jordan,Iraq,1992,2,0,2
China PR,North Korea,1992,0,0,0
Japan,South Korea,1992,2,2,4
Kenya,DR Congo,1992,1,3,4
Malawi,Mali,1992,1,1,2
Nigeria,Uganda,1992,2,0,2
Sierra Leone,Algeria,1992,1,0,1
Cameroon,Benin,1992,2,0,2
Ethiopia,Sudan,1992,3,0,3
Guinea,Burundi,1992,2,2,4
Mauritius,Zimbabwe,1992,0,1,1
Mozambique,Lesotho,1992,3,0,3
Niger,Gabon,1992,1,3,4
Senegal,Guinea-Bissau,1992,3,0,3
South Africa,Zambia,1992,0,1,1
Austria,Portugal,1992,1,1,2
Czechoslovakia,Belgium,1992,1,2,3
Greece,Cyprus,1992,2,3,5
Lithuania,Georgia,1992,1,0,1
Canada,United States,1992,0,2,2
Solomon Islands,Australia,1992,1,2,3
Egypt,Jordan,1992,1,1,2
Syria,Saudi Arabia,1992,1,1,2
Bulgaria,France,1992,2,0,2
Denmark,Germany,1992,1,2,3
Finland,Sweden,1992,0,1,1
Republic of Ireland,Latvia,1992,4,0,4
Luxembourg,Hungary,1992,0,3,3
Netherlands,Italy,1992,2,3,5
Northern Ireland,Albania,1992,3,0,3
Norway,San Marino,1992,10,0,10
Poland,Israel,1992,1,1,2
Spain,England,1992,1,0,1
Switzerland,Scotland,1992,3,1,4
Wales,Faroe Islands,1992,6,0,6
Kuwait,Jordan,1992,4,1,5
Syria,Palestine,1992,0,0,0
Tahiti,Australia,1992,0,3,3
Egypt,Kuwait,1992,1,0,1
Fiji,Vanuatu,1992,3,0,3
Saudi Arabia,Palestine,1992,2,1,3
El Salvador,Honduras,1992,3,1,4
Turkmenistan,Kazakhstan,1992,1,1,2
Syria,Egypt,1992,0,0,0
Saudi Arabia,Kuwait,1992,2,0,2
Syria,Kuwait,1992,1,2,3
Egypt,Saudi Arabia,1992,3,2,5
Georgia,Azerbaijan,1992,6,3,9
Honduras,El Salvador,1992,1,1,2
Australia,Tahiti,1992,2,0,2
Honduras,Jamaica,1992,5,1,6
Brazil,Costa Rica,1992,4,2,6
Czechoslovakia,Faroe Islands,1992,4,0,4
Hungary,Israel,1992,0,0,0
Latvia,Spain,1992,0,0,0
Lithuania,Denmark,1992,0,0,0
Norway,Netherlands,1992,2,1,3
Poland,Turkey,1992,1,0,1
Uruguay,Argentina,1992,0,0,0
Honduras,Jamaica,1992,7,0,7
Australia,Solomon Islands,1992,6,1,7
Kyrgyzstan,Kazakhstan,1992,1,1,2
Vanuatu,Fiji,1992,0,3,3
Saint Vincent and the Grenadines,Jamaica,1992,0,1,1
Botswana,Kenya,1992,1,3,4
Iran,Cameroon,1992,1,1,2
Botswana,Kenya,1992,0,1,1
Kyrgyzstan,Uzbekistan,1992,2,6,8
Gabon,Chad,1992,1,0,1
Guinea-Bissau,Sierra Leone,1992,0,3,3
Iran,Cameroon,1992,0,0,0
Jamaica,Saint Vincent and the Grenadines,1992,3,3,6
Mali,Morocco,1992,2,1,3
Saudi Arabia,Cameroon,1992,2,1,3
Cyprus,Malta,1992,3,0,3
El Salvador,Mexico,1992,0,2,2
Iceland,Greece,1992,0,1,1
San Marino,Norway,1992,0,2,2
Sweden,Bulgaria,1992,2,0,2
Algeria,Burundi,1992,3,1,4
Tahiti,Solomon Islands,1992,4,2,6
United States,Canada,1992,0,0,0
Zimbabwe,Togo,1992,1,0,1
Nigeria,South Africa,1992,4,0,4
DR Congo,Liberia,1992,4,2,6
Egypt,Angola,1992,1,0,1
Gabon,Mozambique,1992,3,1,4
Ivory Coast,Botswana,1992,6,0,6
Madagascar,Namibia,1992,3,0,3
Morocco,Ethiopia,1992,5,0,5
Qatar,Hungary,1992,1,4,5
Tunisia,Benin,1992,5,1,6
Zambia,Tanzania,1992,2,0,2
Qatar,Hungary,1992,1,1,2
Armenia,Moldova,1992,0,0,0
Belgium,Romania,1992,1,0,1
Cyprus,Wales,1992,0,1,1
Denmark,Republic of Ireland,1992,0,0,0
England,Norway,1992,1,1,2
France,Austria,1992,2,0,2
Germany,Mexico,1992,1,1,2
Italy,Switzerland,1992,2,2,4
Lithuania,Slovakia,1992,0,1,1
Netherlands,Poland,1992,2,2,4
Northern Ireland,Spain,1992,0,0,0
Russia,Iceland,1992,1,0,1
Scotland,Portugal,1992,0,0,0
Turkmenistan,Kyrgyzstan,1992,4,0,4
Uzbekistan,Kazakhstan,1992,1,1,2
Saudi Arabia,United States,1992,3,0,3
Argentina,Ivory Coast,1992,4,0,4
Bermuda,El Salvador,1992,1,0,1
Cameroon,Eswatini,1992,5,0,5
Jamaica,Canada,1992,1,1,2
Kuwait,Iran,1992,1,1,2
Niger,Mali,1992,0,2,2
United States,Ivory Coast,1992,5,2,7
Saudi Arabia,Argentina,1992,1,3,4
South Korea,United Arab Emirates,1992,0,0,0
Croatia,Mexico,1992,3,0,3
Kuwait,Oman,1992,4,0,4
South Africa,Congo,1992,1,0,1
Benin,Morocco,1992,0,1,1
Bermuda,Jamaica,1992,1,1,2
Burundi,Ghana,1992,1,0,1
El Salvador,Canada,1992,1,1,2
Ethiopia,Tunisia,1992,0,0,0
Kazakhstan,Kyrgyzstan,1992,2,0,2
Malta,Estonia,1992,0,0,0
Mozambique,Senegal,1992,0,1,1
Namibia,Zambia,1992,0,4,4
Niger,Ivory Coast,1992,0,0,0
Eswatini,DR Congo,1992,1,0,1
Tanzania,Madagascar,1992,0,0,0
Togo,Egypt,1992,1,4,5
Turkmenistan,Uzbekistan,1992,1,0,1
Austria,Israel,1992,5,2,7
Belarus,Ukraine,1992,1,1,2
Lithuania,Latvia,1992,1,1,2
Russia,Luxembourg,1992,2,0,2
Turkey,San Marino,1992,4,1,5
Qatar,Thailand,1992,1,1,2
Saudi Arabia,China PR,1992,1,1,2
Japan,United Arab Emirates,1992,0,0,0
North Korea,Iran,1992,0,2,2
China PR,Thailand,1992,0,0,0
Saudi Arabia,Qatar,1992,1,1,2
Canada,Jamaica,1992,1,0,1
El Salvador,Bermuda,1992,4,1,5
Japan,North Korea,1992,1,1,2
United Arab Emirates,Iran,1992,0,0,0
China PR,Qatar,1992,2,1,3
Egypt,Kuwait,1992,1,1,2
Saudi Arabia,Thailand,1992,4,0,4
Japan,Iran,1992,1,0,1
United Arab Emirates,North Korea,1992,2,1,3
Japan,China PR,1992,3,2,5
Saudi Arabia,United Arab Emirates,1992,2,0,2
Tunisia,Finland,1992,1,1,2
Zimbabwe,Malawi,1992,0,1,1
Canada,El Salvador,1992,2,3,5
China PR,United Arab Emirates,1992,1,1,2
Costa Rica,Honduras,1992,2,3,5
Jamaica,Bermuda,1992,3,2,5
Japan,Saudi Arabia,1992,1,0,1
Morocco,Egypt,1992,0,0,0
Sierra Leone,Senegal,1992,2,0,2
Zimbabwe,Malawi,1992,4,1,5
Albania,Latvia,1992,1,1,2
Bulgaria,Portugal,1992,1,2,3
Greece,Hungary,1992,0,0,0
Israel,Sweden,1992,1,3,4
France,Finland,1992,2,1,3
Romania,Czechoslovakia,1992,1,1,2
Canada,Bermuda,1992,4,2,6
Ethiopia,Zanzibar,1992,3,0,3
Kenya,Uganda,1992,1,1,2
Mexico,Honduras,1992,2,0,2
Niger,Mali,1992,0,1,1
Tanzania,Malawi,1992,1,1,2
Ethiopia,Zambia,1992,2,3,5
United Arab Emirates,Senegal,1992,1,1,2
Belgium,Wales,1992,2,0,2
Cyprus,Slovenia,1992,1,1,2
England,Turkey,1992,4,0,4
Germany,Austria,1992,0,0,0
Kenya,Seychelles,1992,2,1,3
Northern Ireland,Denmark,1992,0,1,1
Poland,Latvia,1992,1,0,1
Scotland,Italy,1992,0,0,0
Spain,Republic of Ireland,1992,0,0,0
Switzerland,Malta,1992,3,0,3
Tanzania,Zanzibar,1992,0,1,1
Malawi,Zambia,1992,1,0,1
United Arab Emirates,Senegal,1992,2,2,4
Egypt,Kuwait,1992,1,1,2
Tanzania,Ethiopia,1992,2,1,3
Seychelles,Uganda,1992,2,5,7
Zambia,Zanzibar,1992,8,0,8
Ethiopia,Malawi,1992,1,2,3
Jamaica,El Salvador,1992,0,2,2
Mexico,Costa Rica,1992,4,0,4
Tanzania,Zambia,1992,1,2,3
Algeria,United Arab Emirates,1992,0,0,0
Malawi,Zanzibar,1992,3,1,4
Brazil,Uruguay,1992,1,2,3
Uganda,Zambia,1992,0,0,0
Argentina,Poland,1992,2,0,2
Qatar,Oman,1992,2,0,2
Malawi,Zambia,1992,0,4,4
Saudi Arabia,Bahrain,1992,1,2,3
United Arab Emirates,Kuwait,1992,0,2,2
Costa Rica,Mexico,1992,2,0,2
Cyprus,Romania,1992,1,4,5
Uruguay,Poland,1992,0,1,1
Kuwait,Oman,1992,2,1,3
Saudi Arabia,United Arab Emirates,1992,0,1,1
Qatar,Bahrain,1992,1,0,1
China PR,Norway,1992,2,1,3
Guatemala,Jamaica,1992,2,1,3
Israel,Bulgaria,1992,0,2,2
Qatar,Kuwait,1992,4,0,4
Bahrain,United Arab Emirates,1992,0,2,2
Oman,Saudi Arabia,1992,0,2,2
Honduras,Costa Rica,1992,2,1,3
Bermuda,Canada,1992,0,0,0
El Salvador,Jamaica,1992,2,1,3
Kuwait,Saudi Arabia,1992,1,2,3
Qatar,United Arab Emirates,1992,1,0,1
Bahrain,Oman,1992,3,0,3
Singapore,Malaysia,1992,3,0,3
Oman,United Arab Emirates,1992,0,1,1
Kuwait,Bahrain,1992,0,1,1
Qatar,Saudi Arabia,1992,0,1,1
Honduras,Mexico,1992,1,1,2
Niger,Ghana,1992,0,1,1
Brazil,Germany,1992,3,1,4
Guinea,Sierra Leone,1992,0,0,0
Spain,Latvia,1992,5,0,5
Turkey,Netherlands,1992,1,3,4
Malta,Italy,1992,1,2,3
Tanzania,Namibia,1992,2,0,2
Botswana,Niger,1992,0,1,1
Congo,Nigeria,1992,0,1,1
Ethiopia,Benin,1992,3,1,4
Gabon,Senegal,1992,3,2,5
Ghana,Algeria,1992,2,0,2
Guinea,Kenya,1992,4,0,4
Madagascar,Zambia,1992,2,0,2
Tunisia,Morocco,1992,1,1,2
Uruguay,Germany,1992,1,4,5
Zimbabwe,Egypt,1992,2,1,3
Cyprus,Georgia,1992,1,0,1
Burkina Faso,Mali,1992,3,1,4
Ghana,Mali,1993,1,1,2
Gabon,Burkina Faso,1993,1,1,2
Kuwait,Lebanon,1993,2,0,2
Burkina Faso,Mali,1993,1,0,1
Gabon,Ghana,1993,2,3,5
Uganda,Tanzania,1993,3,1,4
Sierra Leone,Togo,1993,0,0,0
Angola,Zimbabwe,1993,1,1,2
Botswana,South Africa,1993,0,2,2
DR Congo,Cameroon,1993,1,2,3
Senegal,Algeria,1993,1,2,3
Tunisia,Bulgaria,1993,3,0,3
Uganda,Tanzania,1993,2,0,2
South Africa,Nigeria,1993,0,0,0
Tanzania,Zambia,1993,1,3,4
Benin,Tunisia,1993,0,5,5
Botswana,Ivory Coast,1993,0,0,0
Burundi,Algeria,1993,0,0,0
Ethiopia,Morocco,1993,0,1,1
Mozambique,Gabon,1993,1,1,2
Namibia,Madagascar,1993,0,1,1
Eswatini,Cameroon,1993,0,0,0
Togo,Zimbabwe,1993,1,2,3
Angola,Egypt,1993,0,0,0
North Korea,Bolivia,1993,2,1,3
Guinea-Bissau,Guinea,1993,2,1,3
India,Finland,1993,0,0,0
Italy,Mexico,1993,2,0,2
Cameroon,Finland,1993,0,0,0
Japan,Switzerland,1993,1,1,2
Ghana,Niger,1993,4,0,4
Guinea-Bissau,Algeria,1993,1,4,5
Venezuela,Peru,1993,0,0,0
India,Cameroon,1993,1,1,2
Malta,Portugal,1993,0,1,1
Togo,Senegal,1993,1,1,2
Bolivia,Russia,1993,1,2,3
India,Finland,1993,0,2,2
Ecuador,Belarus,1993,1,1,2
Peru,Honduras,1993,1,1,2
Spain,Mexico,1993,1,1,2
Cameroon,Finland,1993,2,0,2
Bolivia,Honduras,1993,3,1,4
India,Cameroon,1993,2,2,4
Peru,Belarus,1993,1,1,2
Senegal,Mozambique,1993,6,1,7
United States,Denmark,1993,2,2,4
Zambia,Namibia,1993,4,0,4
Congo,South Africa,1993,0,1,1
Ecuador,Romania,1993,3,0,3
Egypt,Togo,1993,3,0,3
Ghana,Burundi,1993,1,0,1
Ivory Coast,Niger,1993,1,0,1
North Korea,Finland,1993,3,2,5
Morocco,Benin,1993,5,0,5
Tunisia,Ethiopia,1993,3,0,3
Zimbabwe,Angola,1993,2,1,3
Cyprus,Poland,1993,0,0,0
Israel,Poland,1993,0,0,0
Peru,Romania,1993,0,2,2
Malaysia,Singapore,1993,2,1,3
Ghana,Indonesia,1993,2,0,2
United States,Romania,1993,1,1,2
Malaysia,Thailand,1993,1,1,2
Singapore,Thailand,1993,1,1,2
Mexico,Romania,1993,0,2,2
Portugal,Norway,1993,1,1,2
Thailand,China PR,1993,1,0,1
Cyprus,Belgium,1993,0,3,3
United States,Russia,1993,0,1,1
Costa Rica,Nicaragua,1993,6,0,6
Thailand,China PR,1993,0,4,4
Albania,Northern Ireland,1993,1,2,3
El Salvador,Russia,1993,1,2,3
England,San Marino,1993,6,0,6
Greece,Luxembourg,1993,2,0,2
Republic of Ireland,Wales,1993,2,1,3
Israel,France,1993,0,4,4
Scotland,Malta,1993,3,0,3
Argentina,Brazil,1993,1,1,2
United Arab Emirates,Bulgaria,1993,1,0,1
Costa Rica,Nicaragua,1993,2,0,2
Finland,Estonia,1993,0,0,0
Latvia,Lithuania,1993,1,2,3
United Arab Emirates,Bulgaria,1993,1,3,4
Estonia,Latvia,1993,0,2,2
Finland,Lithuania,1993,3,0,3
United States,Russia,1993,0,0,0
Argentina,Denmark,1993,1,1,2
Kuwait,China PR,1993,1,0,1
Netherlands,Turkey,1993,3,1,4
Portugal,Italy,1993,1,3,4
Spain,Lithuania,1993,5,0,5
Venezuela,Colombia,1993,0,0,0
Algeria,Ghana,1993,2,1,3
Kenya,Guinea,1993,2,0,2
Nigeria,Congo,1993,2,0,2
Senegal,Gabon,1993,1,0,1
Benin,Ethiopia,1993,1,0,1
Morocco,Tunisia,1993,0,0,0
Niger,Botswana,1993,2,1,3
Togo,Angola,1993,0,1,1
Zambia,Madagascar,1993,3,1,4
Cameroon,DR Congo,1993,0,0,0
Jordan,Syria,1993,1,1,2
Martinique,French Guiana,1993,2,1,3
Paraguay,Bolivia,1993,1,0,1
El Salvador,Costa Rica,1993,0,1,1
Honduras,Panama,1993,2,0,2
El Salvador,Panama,1993,1,1,2
Honduras,Costa Rica,1993,2,0,2
Japan,Hungary,1993,0,1,1
Canada,South Korea,1993,0,2,2
Costa Rica,Panama,1993,2,0,2
Honduras,El Salvador,1993,3,0,3
Austria,Greece,1993,2,1,3
Hungary,United States,1993,0,0,0
San Marino,Turkey,1993,0,0,0
Canada,South Korea,1993,2,0,2
Guyana,Cayman Islands,1993,3,2,5
Puerto Rico,Barbados,1993,1,0,1
Cayman Islands,Barbados,1993,1,6,7
El Salvador,Bolivia,1993,2,2,4
Guyana,Puerto Rico,1993,0,2,2
Qatar,Jordan,1993,1,2,3
Guyana,Barbados,1993,0,3,3
Honduras,Bolivia,1993,0,0,0
Japan,United States,1993,3,1,4
Puerto Rico,Cayman Islands,1993,4,0,4
Honduras,Bolivia,1993,0,0,0
Kuwait,Syria,1993,2,1,3
Brazil,Poland,1993,2,2,4
Tunisia,Switzerland,1993,0,1,1
El Salvador,United States,1993,2,2,4
Costa Rica,Canada,1993,0,1,1
Cyprus,Czech Republic,1993,1,1,2
French Guiana,Guadeloupe,1993,2,1,3
Israel,Russia,1993,2,2,4
Italy,Malta,1993,6,1,7
Netherlands,San Marino,1993,6,0,6
Scotland,Germany,1993,0,1,1
Honduras,United States,1993,4,1,5
Lebanon,Jordan,1993,1,0,1
Austria,France,1993,0,1,1
Malawi,Zambia,1993,1,0,1
Qatar,Norway,1993,1,6,7
Slovakia,Lithuania,1993,2,2,4
Chile,Bolivia,1993,2,1,3
Colombia,Costa Rica,1993,4,1,5
Denmark,Spain,1993,1,0,1
Hungary,Greece,1993,0,1,1
Republic of Ireland,Northern Ireland,1993,3,0,3
Poland,Lithuania,1993,1,1,2
Switzerland,Portugal,1993,1,1,2
Turkey,England,1993,0,2,2
Wales,Belgium,1993,2,0,2
Malaysia,United Arab Emirates,1993,0,1,1
Saint Kitts and Nevis,British Virgin Islands,1993,5,1,6
Niger,Benin,1993,2,2,4
Anguilla,Antigua and Barbuda,1993,0,4,4
Dominican Republic,British Virgin Islands,1993,3,1,4
El Salvador,Mexico,1993,2,1,3
Honduras,Canada,1993,2,2,4
Kuwait,Egypt,1993,1,3,4
Antigua and Barbuda,Sint Maarten,1993,0,2,2
Anguilla,Sint Maarten,1993,0,1,1
Saint Kitts and Nevis,Dominican Republic,1993,2,2,4
Slovenia,Estonia,1993,2,0,2
Japan,Thailand,1993,1,0,1
Sri Lanka,United Arab Emirates,1993,0,4,4
Algeria,Sierra Leone,1993,0,0,0
Egypt,Mali,1993,2,1,3
North Korea,Vietnam,1993,3,0,3
Oman,Malaysia,1993,1,0,1
Qatar,Indonesia,1993,3,1,4
South Africa,Mauritius,1993,0,0,0
Zambia,Zimbabwe,1993,0,0,0
Ghana,Liberia,1993,0,0,0
Canada,El Salvador,1993,2,0,2
Ethiopia,Nigeria,1993,1,0,1
Gabon,Benin,1993,2,0,2
Guinea,Congo,1993,1,0,1
Guinea-Bissau,Senegal,1993,0,3,3
Japan,Bangladesh,1993,8,0,8
North Korea,Singapore,1993,2,1,3
Lesotho,DR Congo,1993,1,1,2
Mexico,Honduras,1993,3,0,3
Morocco,Malawi,1993,0,1,1
Mozambique,Kenya,1993,0,0,0
Niger,Cameroon,1993,0,0,0
Sudan,Uganda,1993,1,1,2
Qatar,Vietnam,1993,4,0,4
Thailand,Sri Lanka,1993,1,0,1
North Korea,Indonesia,1993,4,0,4
Poland,Finland,1993,2,1,3
Sri Lanka,Bangladesh,1993,0,1,1
United Arab Emirates,Thailand,1993,1,0,1
Vietnam,Singapore,1993,2,3,5
Austria,Bulgaria,1993,3,1,4
Denmark,Latvia,1993,2,0,2
Germany,Ghana,1993,6,1,7
Guadeloupe,Martinique,1993,1,4,5
Italy,Estonia,1993,2,0,2
Lithuania,Albania,1993,3,1,4
Luxembourg,Russia,1993,0,4,4
Romania,Cyprus,1993,2,1,3
Egypt,Zimbabwe,1993,0,0,0
Hungary,Sweden,1993,0,2,2
Japan,Sri Lanka,1993,5,0,5
United Arab Emirates,Bangladesh,1993,1,0,1
Algeria,Ivory Coast,1993,1,1,2
Australia,Kuwait,1993,1,0,1
Qatar,Singapore,1993,4,1,5
Vietnam,Indonesia,1993,1,0,1
Malta,Switzerland,1993,0,2,2
United States,Iceland,1993,1,1,2
Cameroon,Guinea,1993,3,1,4
Canada,Honduras,1993,3,1,4
Indonesia,Singapore,1993,0,2,2
Japan,United Arab Emirates,1993,2,0,2
Mexico,El Salvador,1993,3,1,4
Morocco,Senegal,1993,1,0,1
Qatar,North Korea,1993,1,2,3
Saudi Arabia,New Zealand,1993,3,1,4
Thailand,Bangladesh,1993,4,1,5
Australia,Kuwait,1993,1,3,4
Singapore,Saudi Arabia,1993,0,3,3
Hong Kong,Kuwait,1993,2,2,4
Nigeria,Sudan,1993,4,0,4
Egypt,Malawi,1993,2,0,2
Indonesia,Qatar,1993,1,4,5
Kenya,Lesotho,1993,3,0,3
Saudi Arabia,New Zealand,1993,1,0,1
Sierra Leone,Guinea-Bissau,1993,2,0,2
South Africa,Zimbabwe,1993,1,1,2
Vietnam,North Korea,1993,0,1,1
Cameroon,Gabon,1993,0,0,0
Congo,Burundi,1993,0,0,0
Cyprus,Faroe Islands,1993,3,1,4
Ethiopia,Uganda,1993,2,2,4
Grenada,Dominica,1993,1,1,2
Honduras,El Salvador,1993,2,0,2
Hong Kong,Kuwait,1993,0,1,1
South Korea,Iraq,1993,1,1,2
Mauritius,Zambia,1993,0,3,3
Mexico,Canada,1993,4,0,4
Morocco,Mali,1993,1,0,1
Mozambique,DR Congo,1993,0,0,0
Niger,Benin,1993,4,1,5
Saint Vincent and the Grenadines,Saint Lucia,1993,0,1,1
Singapore,North Korea,1993,1,3,4
Vietnam,Qatar,1993,0,4,4
Dominica,Saint Lucia,1993,2,4,6
Ukraine,Israel,1993,1,1,2
Bulgaria,Finland,1993,2,0,2
Czech Republic,Wales,1993,1,1,2
England,Netherlands,1993,2,2,4
France,Sweden,1993,2,1,3
Indonesia,North Korea,1993,1,2,3
Republic of Ireland,Denmark,1993,1,1,2
South Korea,Iraq,1993,2,2,4
Norway,Turkey,1993,3,1,4
Poland,San Marino,1993,1,0,1
Portugal,Scotland,1993,5,0,5
Russia,Hungary,1993,3,0,3
Singapore,Vietnam,1993,1,0,1
Spain,Northern Ireland,1993,3,1,4
Thailand,Japan,1993,0,1,1
United Arab Emirates,Sri Lanka,1993,3,0,3
Dominica,Saint Vincent and the Grenadines,1993,0,2,2
Grenada,Saint Lucia,1993,0,1,1
Bangladesh,Japan,1993,1,4,5
Indonesia,Vietnam,1993,2,1,3
Singapore,Qatar,1993,1,0,1
United Arab Emirates,Thailand,1993,2,1,3
Macau,Saudi Arabia,1993,0,6,6
Malaysia,Kuwait,1993,1,1,2
Switzerland,Italy,1993,1,0,1
El Salvador,Canada,1993,1,2,3
Guinea,Zimbabwe,1993,3,0,3
Honduras,Mexico,1993,1,4,5
Ivory Coast,Nigeria,1993,2,1,3
North Korea,Qatar,1993,2,2,4
Singapore,Indonesia,1993,2,1,3
Guernsey,Jersey,1993,1,2,3
Macau,Kuwait,1993,1,10,11
Malaysia,Saudi Arabia,1993,1,1,2
Sri Lanka,Thailand,1993,0,3,3
United Arab Emirates,Bangladesh,1993,7,0,7
Bangladesh,Thailand,1993,1,4,5
Kuwait,Saudi Arabia,1993,0,0,0
Malaysia,Macau,1993,9,0,9
Sri Lanka,Japan,1993,0,6,6
Bangladesh,Sri Lanka,1993,3,0,3
Hong Kong,Bahrain,1993,2,1,3
Lebanon,India,1993,2,2,4
United Arab Emirates,Japan,1993,1,1,2
United States,Colombia,1993,1,2,3
Bahrain,South Korea,1993,0,0,0
Canada,Mexico,1993,1,2,3
El Salvador,Honduras,1993,2,1,3
Lebanon,Hong Kong,1993,2,2,4
India,Hong Kong,1993,1,2,3
Lebanon,South Korea,1993,0,1,1
Bulgaria,Israel,1993,2,2,4
Estonia,Malta,1993,0,1,1
Finland,Austria,1993,3,1,4
India,South Korea,1993,0,3,3
Lebanon,Bahrain,1993,0,0,0
Kuwait,Malaysia,1993,2,0,2
Saudi Arabia,Macau,1993,8,0,8
Bahrain,India,1993,2,1,3
Hong Kong,South Korea,1993,0,3,3
Latvia,Albania,1993,0,0,0
Kuwait,Macau,1993,8,0,8
Saudi Arabia,Malaysia,1993,3,0,3
Lithuania,Ukraine,1993,1,2,3
Macau,Malaysia,1993,0,5,5
Saudi Arabia,Kuwait,1993,2,0,2
Estonia,Scotland,1993,0,3,3
San Marino,Poland,1993,0,3,3
Sweden,Austria,1993,1,0,1
Guadeloupe,Réunion,1993,0,3,3
Luxembourg,Iceland,1993,1,1,2
Zambia,Malawi,1993,1,1,2
Colombia,Venezuela,1993,1,1,2
Jamaica,Saint Kitts and Nevis,1993,4,1,5
Martinique,Saint Lucia,1993,2,0,2
Puerto Rico,Sint Maarten,1993,3,0,3
Belgium,Faroe Islands,1993,3,0,3
Burkina Faso,Guadeloupe,1993,2,0,2
Jordan,Yemen,1993,1,1,2
New Zealand,Fiji,1993,2,0,2
Pakistan,China PR,1993,0,5,5
Zambia,Malawi,1993,0,1,1
Jamaica,Sint Maarten,1993,2,0,2
Russia,Greece,1993,1,1,2
Saint Kitts and Nevis,Puerto Rico,1993,1,0,1
Trinidad and Tobago,Saint Lucia,1993,1,1,2
United States,Bolivia,1993,0,0,0
Jordan,Iraq,1993,1,1,2
New Zealand,Fiji,1993,5,0,5
Yemen,Pakistan,1993,5,1,6
Zambia,Malawi,1993,4,2,6
Azerbaijan,Georgia,1993,1,0,1
Jamaica,Puerto Rico,1993,1,0,1
Lithuania,Northern Ireland,1993,0,1,1
Martinique,Trinidad and Tobago,1993,3,2,5
Saint Kitts and Nevis,Sint Maarten,1993,2,2,4
Saint Vincent and the Grenadines,Saint Lucia,1993,4,1,5
Albania,Republic of Ireland,1993,1,2,3
Ethiopia,Sudan,1993,1,1,2
Jordan,China PR,1993,0,3,3
United States,Peru,1993,0,0,0
Yemen,Iraq,1993,1,6,7
Bolivia,Paraguay,1993,2,1,3
Jamaica,Trinidad and Tobago,1993,3,0,3
Martinique,Saint Kitts and Nevis,1993,1,1,2
Pakistan,Iraq,1993,0,8,8
Yemen,China PR,1993,1,0,1
Republic of Ireland,Hungary,1993,2,4,6
Poland,England,1993,1,1,2
Chile,Colombia,1993,1,1,2
Ecuador,Peru,1993,1,0,1
Iraq,China PR,1993,1,0,1
Jamaica,Martinique,1993,0,0,0
Jordan,Pakistan,1993,3,1,4
New Zealand,Australia,1993,0,1,1
Trinidad and Tobago,Saint Kitts and Nevis,1993,3,2,5
Czech Republic,Romania,1993,5,2,7
Denmark,Albania,1993,4,0,4
Iceland,Russia,1993,1,1,2
Latvia,Northern Ireland,1993,1,2,3
Lithuania,Spain,1993,0,2,2
Norway,England,1993,2,0,2
Scotland,Estonia,1993,3,1,4
Sweden,Israel,1993,5,0,5
Turkmenistan,Tajikistan,1993,6,0,6
Bahrain,Lebanon,1993,0,0,0
South Korea,Hong Kong,1993,4,1,5
Australia,New Zealand,1993,3,0,3
Azerbaijan,Tajikistan,1993,2,0,2
Colombia,Chile,1993,1,0,1
Faroe Islands,Wales,1993,0,3,3
Iran,Pakistan,1993,5,0,5
Peru,Bolivia,1993,1,0,1
United States,Brazil,1993,0,2,2
Azerbaijan,Kyrgyzstan,1993,3,2,5
India,Bahrain,1993,0,3,3
South Korea,Lebanon,1993,2,0,2
Pakistan,Turkmenistan,1993,0,4,4
Iran,Turkmenistan,1993,2,1,3
Kyrgyzstan,Tajikistan,1993,1,1,2
Ecuador,Chile,1993,1,2,3
Hong Kong,Lebanon,1993,1,2,3
South Korea,India,1993,7,0,7
Latvia,Republic of Ireland,1993,0,2,2
Netherlands,Norway,1993,0,0,0
United States,England,1993,2,0,2
Brazil,Germany,1993,3,3,6
Mexico,Paraguay,1993,3,1,4
Bahrain,Hong Kong,1993,3,0,3
India,Lebanon,1993,1,2,3
South Korea,Romania,1993,2,2,4
Martinique,Trinidad and Tobago,1993,1,1,2
Peru,Venezuela,1993,3,1,4
China PR,Pakistan,1993,3,0,3
Yemen,Jordan,1993,1,1,2
Bolivia,Chile,1993,1,3,4
Brazil,England,1993,1,1,2
Hong Kong,India,1993,1,3,4
Iran,Tajikistan,1993,1,0,1
South Korea,Bahrain,1993,3,0,3
United States,Germany,1993,3,4,7
Iran,Turkmenistan,1993,2,1,3
Iraq,Jordan,1993,4,0,4
South Korea,Czech Republic,1993,1,2,3
Pakistan,Yemen,1993,0,3,3
Ecuador,Venezuela,1993,6,1,7
China PR,Jordan,1993,4,1,5
Colombia,Mexico,1993,2,1,3
Faroe Islands,Czech Republic,1993,0,3,3
Finland,Israel,1993,0,0,0
Iceland,Hungary,1993,2,0,2
Iraq,Yemen,1993,3,0,3
Lithuania,Republic of Ireland,1993,0,1,1
Uruguay,United States,1993,1,0,1
Argentina,Bolivia,1993,1,0,1
Brazil,Peru,1993,0,0,0
China PR,Yemen,1993,1,0,1
Iraq,Pakistan,1993,4,0,4
Paraguay,Chile,1993,1,0,1
Ecuador,United States,1993,2,0,2
England,Germany,1993,1,2,3
South Korea,Egypt,1993,1,2,3
Portugal,Malta,1993,4,0,4
Uruguay,Venezuela,1993,2,2,4
Argentina,Mexico,1993,1,1,2
China PR,Iraq,1993,2,1,3
Colombia,Bolivia,1993,1,1,2
Mali,Senegal,1993,0,2,2
Pakistan,Jordan,1993,0,5,5
Brazil,Chile,1993,2,3,5
Paraguay,Peru,1993,1,1,2
Ecuador,Uruguay,1993,2,1,3
United States,Venezuela,1993,3,3,6
Argentina,Colombia,1993,1,1,2
Costa Rica,Panama,1993,3,1,4
Iran,Oman,1993,0,0,0
Mexico,Bolivia,1993,0,0,0
Brazil,Paraguay,1993,3,0,3
Chile,Peru,1993,0,1,1
Croatia,Ukraine,1993,3,1,4
Iran,Taiwan,1993,6,0,6
Oman,Syria,1993,0,0,0
Colombia,Uruguay,1993,1,1,2
Ecuador,Paraguay,1993,3,0,3
Egypt,Romania,1993,3,2,5
South Korea,Czech Republic,1993,1,0,1
Brazil,Argentina,1993,1,1,2
Iran,Syria,1993,1,1,2
Oman,Taiwan,1993,2,1,3
Peru,Mexico,1993,2,4,6
South Korea,Egypt,1993,0,1,1
Costa Rica,Mexico,1993,0,2,2
Ecuador,Mexico,1993,0,2,2
Colombia,Argentina,1993,0,0,0
Estonia,Latvia,1993,0,2,2
Oman,Iran,1993,0,1,1
Syria,Taiwan,1993,8,1,9
Ecuador,Colombia,1993,0,1,1
Latvia,Lithuania,1993,0,0,0
Nigeria,Algeria,1993,4,1,5
Argentina,Mexico,1993,2,1,3
Estonia,Lithuania,1993,2,1,3
Gabon,Mali,1993,0,2,2
Jamaica,Costa Rica,1993,1,1,2
Syria,Oman,1993,2,1,3
Zambia,Morocco,1993,2,1,3
Zimbabwe,Cameroon,1993,1,0,1
Gibraltar,Jersey,1993,1,2,3
Ynys Môn,Greenland,1993,0,1,1
Isle of Wight,Isle of Man,1993,1,0,1
Åland Islands,Shetland,1993,3,1,4
Jersey,Greenland,1993,4,2,6
Ynys Môn,Gibraltar,1993,1,0,1
Isle of Man,Åland Islands,1993,2,0,2
Isle of Wight,Shetland,1993,2,0,2
Malawi,Eswatini,1993,3,1,4
Syria,Iran,1993,1,1,2
Greenland,Gibraltar,1993,5,0,5
Jersey,Ynys Môn,1993,2,2,4
Shetland,Isle of Man,1993,1,5,6
Isle of Wight,Åland Islands,1993,0,2,2
Ivory Coast,Niger,1993,3,2,5
Malawi,Eswatini,1993,1,1,2
Shetland,Gibraltar,1993,1,0,1
Isle of Wight,Ynys Môn,1993,1,1,2
Greenland,Åland Islands,1993,1,2,3
Jersey,Isle of Man,1993,5,1,6
Sudan,Ethiopia,1993,1,0,1
Honduras,Panama,1993,5,1,6
Malawi,Eswatini,1993,0,1,1
United States,Jamaica,1993,1,0,1
Benin,Cameroon,1993,0,3,3
Burundi,Guinea,1993,2,2,4
Canada,Costa Rica,1993,1,1,2
DR Congo,Kenya,1993,0,1,1
Egypt,Morocco,1993,1,1,2
Gabon,Niger,1993,3,0,3
Lesotho,Mozambique,1993,1,1,2
Mali,Malawi,1993,2,1,3
Mexico,Martinique,1993,9,0,9
Senegal,Sierra Leone,1993,1,1,2
Zambia,South Africa,1993,3,0,3
Zimbabwe,Mauritius,1993,2,0,2
Peru,Uruguay,1993,1,2,3
Brazil,Paraguay,1993,2,0,2
Honduras,Jamaica,1993,1,3,4
United States,Panama,1993,2,1,3
Canada,Martinique,1993,2,2,4
Mexico,Costa Rica,1993,1,1,2
Jamaica,Panama,1993,1,1,2
Senegal,Morocco,1993,1,3,4
Uganda,Nigeria,1993,0,0,0
Uruguay,Peru,1993,3,0,3
United States,Honduras,1993,1,0,1
Costa Rica,Martinique,1993,3,1,4
Ecuador,Brazil,1993,0,0,0
Guinea,Cameroon,1993,0,1,1
Ivory Coast,Algeria,1993,1,0,1
Mexico,Canada,1993,8,0,8
Venezuela,Bolivia,1993,1,7,8
United States,Costa Rica,1993,1,0,1
Mexico,Jamaica,1993,6,1,7
Nigeria,Ethiopia,1993,6,0,6
Uganda,Sudan,1993,1,0,1
Kenya,Mozambique,1993,4,1,5
Algeria,Senegal,1993,4,0,4
Benin,Gabon,1993,1,2,3
Bolivia,Brazil,1993,2,0,2
Cameroon,Niger,1993,2,0,2
DR Congo,Lesotho,1993,7,0,7
Jamaica,Costa Rica,1993,1,1,2
Liberia,Ghana,1993,0,2,2
Malawi,Morocco,1993,0,2,2
Mali,Egypt,1993,2,1,3
Mauritius,South Africa,1993,1,3,4
Mexico,United States,1993,4,0,4
Venezuela,Uruguay,1993,0,1,1
Zimbabwe,Zambia,1993,1,1,2
France,Russia,1993,3,1,4
Malawi,Eswatini,1993,3,0,3
Canada,Australia,1993,2,1,3
Colombia,Paraguay,1993,0,0,0
Peru,Argentina,1993,0,1,1
Uruguay,Ecuador,1993,0,0,0
Venezuela,Brazil,1993,1,5,6
Senegal,Zambia,1993,0,0,0
Bolivia,Uruguay,1993,3,1,4
Brazil,Mexico,1993,1,1,2
Ecuador,Venezuela,1993,5,0,5
Guinea,Sierra Leone,1993,1,0,1
Paraguay,Argentina,1993,1,3,4
Peru,Colombia,1993,0,1,1
Zimbabwe,Eswatini,1993,2,0,2
Guinea,Sierra Leone,1993,4,0,4
Faroe Islands,Norway,1993,0,7,7
Sweden,Switzerland,1993,1,2,3
Australia,Canada,1993,2,1,3
Bolivia,Ecuador,1993,1,0,1
Colombia,Argentina,1993,2,1,3
Congo,Guinea,1993,0,0,0
Uruguay,Brazil,1993,1,1,2
Argentina,Peru,1993,2,1,3
Bolivia,Venezuela,1993,7,0,7
Brazil,Ecuador,1993,2,0,2
Paraguay,Colombia,1993,1,1,2
Sweden,France,1993,1,1,2
Austria,Finland,1993,3,0,3
Denmark,Lithuania,1993,4,0,4
Argentina,Paraguay,1993,0,0,0
Brazil,Bolivia,1993,6,0,6
Colombia,Peru,1993,4,0,4
Uruguay,Venezuela,1993,4,0,4
Iceland,United States,1993,0,1,1
Argentina,Colombia,1993,0,5,5
Brazil,Venezuela,1993,4,0,4
Ecuador,Uruguay,1993,0,1,1
Estonia,Portugal,1993,0,2,2
Peru,Paraguay,1993,2,2,4
Eswatini,Zimbabwe,1993,0,1,1
Albania,Denmark,1993,0,1,1
Bulgaria,Sweden,1993,1,1,2
England,Poland,1993,3,0,3
Faroe Islands,Romania,1993,0,4,4
Finland,France,1993,0,2,2
Hungary,Russia,1993,1,3,4
Iceland,Luxembourg,1993,1,0,1
Republic of Ireland,Lithuania,1993,2,0,2
Northern Ireland,Latvia,1993,2,0,2
Norway,United States,1993,1,0,1
Scotland,Switzerland,1993,1,1,2
Spain,Chile,1993,2,0,2
Wales,Czech Republic,1993,2,2,4
Uruguay,Bolivia,1993,2,1,3
Venezuela,Ecuador,1993,2,1,3
Morocco,Mali,1993,3,0,3
Saudi Arabia,Thailand,1993,4,0,4
Brazil,Uruguay,1993,2,0,2
Ecuador,Bolivia,1993,1,1,2
Zimbabwe,Senegal,1993,2,0,2
Saudi Arabia,Thailand,1993,3,0,3
Albania,Spain,1993,1,5,6
Estonia,Italy,1993,0,3,3
Mexico,Cameroon,1993,1,0,1
Norway,Poland,1993,1,0,1
Romania,Israel,1993,1,0,1
San Marino,Netherlands,1993,0,7,7
Tunisia,Germany,1993,1,1,2
Saudi Arabia,Costa Rica,1993,1,2,3
South Korea,Australia,1993,1,1,2
Nigeria,Ivory Coast,1993,4,1,5
South Korea,Australia,1993,1,0,1
Zambia,Senegal,1993,4,0,4
Zimbabwe,Guinea,1993,1,0,1
Saudi Arabia,Costa Rica,1993,3,2,5
Mexico,Poland,1993,0,0,0
Morocco,Gabon,1993,1,0,1
Japan,Ivory Coast,1993,1,0,1
Cyprus,Israel,1993,2,2,4
Belgium,Gabon,1993,2,1,3
Mexico,South Africa,1993,4,0,4
Saudi Arabia,Russia,1993,4,2,6
Algeria,Nigeria,1993,1,1,2
Cameroon,Zimbabwe,1993,3,1,4
Morocco,Zambia,1993,1,0,1
Luxembourg,Greece,1993,1,3,4
Bulgaria,Austria,1993,4,1,5
Denmark,Northern Ireland,1993,1,0,1
France,Israel,1993,2,3,5
Germany,Uruguay,1993,5,0,5
Republic of Ireland,Spain,1993,1,3,4
Italy,Scotland,1993,3,1,4
Netherlands,England,1993,2,0,2
Poland,Norway,1993,0,3,3
Portugal,Switzerland,1993,1,0,1
Romania,Belgium,1993,2,1,3
Slovenia,North Macedonia,1993,1,4,5
Sweden,Finland,1993,3,2,5
United States,Mexico,1993,1,1,2
Wales,Cyprus,1993,2,0,2
North Korea,Iraq,1993,3,2,5
Saudi Arabia,Japan,1993,0,0,0
Iran,South Korea,1993,0,3,3
United States,Ukraine,1993,1,2,3
Tunisia,Iceland,1993,3,1,4
Japan,Iran,1993,1,2,3
North Korea,Saudi Arabia,1993,1,2,3
Iraq,South Korea,1993,2,2,4
Mexico,Ukraine,1993,2,1,3
North Korea,Japan,1993,0,3,3
Iran,Iraq,1993,1,2,3
South Korea,Saudi Arabia,1993,1,1,2
United States,Ukraine,1993,0,1,1
Burundi,Guinea,1993,0,0,0
Iraq,Saudi Arabia,1993,1,1,2
Iran,North Korea,1993,2,1,3
Japan,South Korea,1993,1,0,1
Liechtenstein,Estonia,1993,0,2,2
United Arab Emirates,Jordan,1993,2,1,3
Czech Republic,Cyprus,1993,3,0,3
Hungary,Luxembourg,1993,1,0,1
Israel,Austria,1993,1,1,2
Turkey,Poland,1993,2,1,3
Iraq,Japan,1993,2,2,4
South Korea,North Korea,1993,3,0,3
Saudi Arabia,Iran,1993,4,3,7
United Arab Emirates,Jordan,1993,0,2,2
Australia,Argentina,1993,1,1,2
Mexico,China PR,1993,3,0,3
Egypt,Malta,1993,3,0,3
Tunisia,Gabon,1993,4,0,4
Gabon,Malta,1993,1,2,3
Tunisia,Egypt,1993,2,1,3
United States,Jamaica,1993,1,0,1
Austria,Sweden,1993,1,1,2
Israel,Finland,1993,1,3,4
Portugal,Estonia,1993,3,0,3
Turkey,Norway,1993,2,1,3
Antigua and Barbuda,Saint Kitts and Nevis,1993,3,0,3
United States,Cayman Islands,1993,8,1,9
Slovakia,Slovenia,1993,2,0,2
Argentina,Australia,1993,1,0,1
Belgium,Czech Republic,1993,0,0,0
France,Bulgaria,1993,1,2,3
Germany,Brazil,1993,2,1,3
Greece,Russia,1993,1,0,1
Italy,Portugal,1993,1,0,1
Malta,Scotland,1993,0,2,2
Northern Ireland,Republic of Ireland,1993,1,1,2
Poland,Netherlands,1993,1,3,4
San Marino,England,1993,1,7,8
Spain,Denmark,1993,1,0,1
Switzerland,Estonia,1993,4,0,4
Wales,Romania,1993,1,2,3
Gambia,Mauritania,1993,2,4,6
Gambia,Ghana,1993,3,0,3
Sierra Leone,Guinea,1993,1,1,2
Guinea-Bissau,Mauritania,1993,1,0,1
Senegal,Mali,1993,0,1,1
Guinea,Gambia,1993,1,2,3
Sierra Leone,Ghana,1993,2,3,5
Mali,Guinea-Bissau,1993,3,0,3
Senegal,Mauritania,1993,4,0,4
Ghana,Guinea,1993,1,0,1
Sierra Leone,Gambia,1993,1,1,2
Tahiti,Fiji,1993,3,0,3
Kenya,Uganda,1993,2,1,3
Mali,Mauritania,1993,0,0,0
Senegal,Guinea-Bissau,1993,0,0,0
Gambia,Senegal,1993,0,2,2
Sierra Leone,Mali,1993,2,0,2
Gambia,Mali,1993,2,0,2
Sierra Leone,Senegal,1993,2,0,2
United States,El Salvador,1993,7,0,7
Tanzania,Uganda,1993,1,0,1
Bangladesh,Myanmar,1993,3,1,4
Kenya,Tanzania,1993,2,1,3
Argentina,Germany,1993,2,1,3
Mexico,Brazil,1993,0,1,1
United States,Germany,1993,0,3,3
Mali,Ivory Coast,1993,0,1,1
Mexico,Germany,1993,0,0,0
Basque Country,Bolivia,1993,3,1,4
Ghana,Egypt,1993,0,0,0
Ghana,Tunisia,1993,1,1,2
Barbados,Grenada,1994,0,0,0
Ghana,Egypt,1994,2,1,3
Mali,Burkina Faso,1994,1,1,2
Mauritania,Mali,1994,1,3,4
Thailand,Nigeria,1994,1,1,2
United States,Norway,1994,2,1,3
Guinea,Ivory Coast,1994,3,0,3
Costa Rica,Norway,1994,0,0,0
Mexico,Bulgaria,1994,1,1,2
Spain,Portugal,1994,2,2,4
Suriname,French Guiana,1994,1,0,1
Tunisia,Netherlands,1994,2,2,4
Guyana,French Guiana,1994,1,1,2
United States,Switzerland,1994,1,1,2
Barbados,Puerto Rico,1994,0,1,1
Mali,Senegal,1994,1,0,1
Saudi Arabia,China PR,1994,1,0,1
Suriname,Guyana,1994,2,0,2
Grenada,Puerto Rico,1994,1,0,1
Qatar,Finland,1994,1,0,1
Mexico,Switzerland,1994,1,5,6
Saudi Arabia,China PR,1994,1,1,2
Barbados,Grenada,1994,3,2,5
Qatar,Finland,1994,0,0,0
Venezuela,Colombia,1994,1,2,3
Burkina Faso,Guinea,1994,1,1,2
Ivory Coast,Niger,1994,5,3,8
United States,Russia,1994,1,1,2
Burkina Faso,Ivory Coast,1994,0,1,1
Guinea,Niger,1994,1,3,4
Oman,Finland,1994,0,2,2
Senegal,Mali,1994,0,0,0
Oman,Finland,1994,1,1,2
Egypt,Morocco,1994,1,1,2
Mexico,Russia,1994,1,4,5
United Arab Emirates,Slovakia,1994,0,1,1
Egypt,Slovakia,1994,1,0,1
Oman,Kenya,1994,1,0,1
United Arab Emirates,Morocco,1994,1,1,2
Morocco,Slovakia,1994,2,1,3
Oman,Kenya,1994,2,0,2
Saudi Arabia,Colombia,1994,1,1,2
United Arab Emirates,Egypt,1994,0,1,1
Gambia,Senegal,1994,0,0,0
Georgia,Slovenia,1994,0,1,1
Malta,Tunisia,1994,1,1,2
Spain,Poland,1994,1,1,2
Malta,Georgia,1994,0,1,1
Slovenia,Tunisia,1994,2,2,4
Georgia,Tunisia,1994,2,0,2
Malawi,Zambia,1994,0,3,3
Malta,Slovenia,1994,0,1,1
Malawi,Zambia,1994,0,2,2
Romania,United States,1994,2,1,3
Italy,France,1994,0,1,1
South Korea,Romania,1994,1,2,3
Malta,Belgium,1994,1,0,1
Colombia,Sweden,1994,0,0,0
United States,Bolivia,1994,1,1,2
Bolivia,Colombia,1994,0,2,2
United States,Sweden,1994,1,3,4
Dominica,Antigua and Barbuda,1994,3,2,5
Israel,Georgia,1994,2,0,2
Mali,Ghana,1994,0,0,0
Morocco,Finland,1994,0,0,0
Saint Kitts and Nevis,Montserrat,1994,9,1,10
Turkey,Czech Republic,1994,1,4,5
Mexico,Sweden,1994,2,1,3
Antigua and Barbuda,Montserrat,1994,8,0,8
Saint Kitts and Nevis,Dominica,1994,2,3,5
Colombia,South Korea,1994,2,2,4
Zimbabwe,Zambia,1994,2,2,4
Gabon,Senegal,1994,0,0,0
Cayman Islands,British Virgin Islands,1994,5,0,5
Jamaica,Sint Maarten,1994,3,2,5
Mexico,Colombia,1994,0,0,0
Cayman Islands,Sint Maarten,1994,5,0,5
Guadeloupe,Anguilla,1994,9,0,9
Jamaica,British Virgin Islands,1994,12,0,12
United States,South Korea,1994,1,0,1
Cayman Islands,Jamaica,1994,3,2,5
Sint Maarten,British Virgin Islands,1994,3,0,3
Saint Vincent and the Grenadines,Anguilla,1994,2,0,2
Cyprus,Estonia,1994,2,0,2
England,Denmark,1994,1,0,1
Hungary,Switzerland,1994,1,2,3
Nigeria,Ghana,1994,0,0,0
Wales,Norway,1994,1,3,4
Dominican Republic,Haiti,1994,0,1,1
Congo,DR Congo,1994,2,1,3
United States,South Korea,1994,1,1,2
Zambia,Zimbabwe,1994,2,1,3
Gabon,DR Congo,1994,2,1,3
Israel,Ukraine,1994,1,0,1
Egypt,Cameroon,1994,0,0,0
Tunisia,Niger,1994,4,2,6
Angola,Gabon,1994,2,1,3
France,Chile,1994,3,1,4
Austria,Hungary,1994,1,1,2
Brazil,Argentina,1994,2,0,2
Germany,Italy,1994,2,1,3
Greece,Poland,1994,0,0,0
Republic of Ireland,Russia,1994,0,0,0
Luxembourg,Morocco,1994,1,2,3
North Macedonia,Slovenia,1994,2,0,2
Northern Ireland,Romania,1994,2,0,2
Scotland,Netherlands,1994,0,1,1
Spain,Croatia,1994,0,2,2
Nigeria,Gabon,1994,3,0,3
Saudi Arabia,Chile,1994,0,2,2
Tunisia,Mali,1994,0,2,2
United States,Bolivia,1994,2,2,4
Ghana,Guinea,1994,1,0,1
Ivory Coast,Sierra Leone,1994,4,0,4
Egypt,Gabon,1994,4,0,4
Mali,DR Congo,1994,0,1,1
Senegal,Guinea,1994,2,1,3
Zambia,Sierra Leone,1994,0,0,0
Malta,Slovakia,1994,1,2,3
Nigeria,Egypt,1994,0,0,0
Tunisia,DR Congo,1994,1,1,2
Ghana,Senegal,1994,1,0,1
Zambia,Ivory Coast,1994,1,0,1
DR Congo,Nigeria,1994,0,2,2
Egypt,Mali,1994,0,1,1
Ghana,Ivory Coast,1994,1,2,3
Zambia,Senegal,1994,1,0,1
Hungary,Slovenia,1994,0,1,1
Nigeria,Ivory Coast,1994,2,2,4
Zambia,Mali,1994,4,0,4
Cayman Islands,Haiti,1994,2,3,5
Colombia,Bolivia,1994,0,1,1
Martinique,Suriname,1994,2,0,2
Martinique,Haiti,1994,3,0,3
Suriname,Cayman Islands,1994,2,0,2
Ivory Coast,Mali,1994,3,1,4
Nigeria,Zambia,1994,2,1,3
Kazakhstan,Tajikistan,1994,1,0,1
Martinique,Cayman Islands,1994,1,1,2
Suriname,Haiti,1994,1,1,2
Uzbekistan,Turkmenistan,1994,4,0,4
Kyrgyzstan,Turkmenistan,1994,1,5,6
Poland,Saudi Arabia,1994,1,0,1
Uzbekistan,Kazakhstan,1994,1,0,1
Martinique,Guadeloupe,1994,4,2,6
Trinidad and Tobago,Suriname,1994,3,2,5
Kazakhstan,Turkmenistan,1994,0,0,0
Kyrgyzstan,Tajikistan,1994,0,1,1
Oman,Bulgaria,1994,1,1,2
United States,Moldova,1994,1,1,2
Colombia,Nigeria,1994,1,0,1
Guadeloupe,Suriname,1994,2,0,2
Kazakhstan,Kyrgyzstan,1994,0,0,0
Trinidad and Tobago,Martinique,1994,7,2,9
Uzbekistan,Tajikistan,1994,1,1,2
Tunisia,Saudi Arabia,1994,2,0,2
Malta,Azerbaijan,1994,5,0,5
Tajikistan,Turkmenistan,1994,0,2,2
Uzbekistan,Kyrgyzstan,1994,3,0,3
Argentina,Morocco,1994,3,1,4
Austria,Scotland,1994,1,2,3
Denmark,Hungary,1994,3,1,4
Iceland,Saudi Arabia,1994,0,2,2
Lithuania,Israel,1994,1,1,2
Netherlands,Republic of Ireland,1994,0,1,1
Northern Ireland,Liechtenstein,1994,4,1,5
Norway,Portugal,1994,0,0,0
Romania,Bolivia,1994,3,0,3
Slovakia,Croatia,1994,4,1,5
Switzerland,Czech Republic,1994,3,0,3
Turkey,Russia,1994,0,1,1
United States,Moldova,1994,3,0,3
Wales,Sweden,1994,0,2,2
Eswatini,Mozambique,1994,0,1,1
South Africa,Zimbabwe,1994,1,0,1
United States,Iceland,1994,1,2,3
Greece,Saudi Arabia,1994,5,1,6
Slovenia,Cyprus,1994,3,0,3
United Arab Emirates,Germany,1994,0,2,2
Kuwait,Bulgaria,1994,2,2,4
United States,Chile,1994,0,2,2
South Korea,Cameroon,1994,2,2,4
Jersey,Guernsey,1994,3,1,4
Colombia,Peru,1994,1,0,1
El Salvador,Honduras,1994,3,1,4
South Korea,Cameroon,1994,2,1,3
Bolivia,Saudi Arabia,1994,1,0,1
Brazil,Iceland,1994,3,0,3
Poland,Hungary,1994,3,2,5
Colombia,El Salvador,1994,3,0,3
Honduras,Peru,1994,2,1,3
Sweden,Nigeria,1994,3,1,4
United States,Estonia,1994,4,0,4
Greece,Cameroon,1994,0,3,3
Bolivia,Cameroon,1994,1,1,2
Greece,Bolivia,1994,0,0,0
North Macedonia,Albania,1994,5,1,6
Nigeria,Suriname,1994,2,1,3
United States,Armenia,1994,1,0,1
England,Greece,1994,5,0,5
Poland,Austria,1994,3,4,7
Chile,Argentina,1994,3,3,6
Hungary,Croatia,1994,2,2,4
Iceland,Bolivia,1994,1,0,1
England,Norway,1994,0,0,0
Japan,Australia,1994,1,1,2
Estonia,Wales,1994,1,2,3
Fiji,Tahiti,1994,2,2,4
Republic of Ireland,Bolivia,1994,1,0,1
Chile,Peru,1994,2,1,3
Czech Republic,Lithuania,1994,5,3,8
Ecuador,Argentina,1994,1,0,1
Fiji,Tahiti,1994,2,0,2
Ukraine,Belarus,1994,3,1,4
United States,Saudi Arabia,1994,0,0,0
Australia,France,1994,0,1,1
Denmark,Sweden,1994,1,0,1
Italy,Finland,1994,2,0,2
Netherlands,Scotland,1994,3,1,4
Switzerland,Liechtenstein,1994,2,0,2
United States,Greece,1994,1,1,2
Germany,Republic of Ireland,1994,0,2,2
Japan,France,1994,1,4,5
Russia,Slovakia,1994,2,1,3
Israel,Argentina,1994,0,3,3
Canada,Morocco,1994,1,1,2
North Macedonia,Estonia,1994,2,0,2
Netherlands,Hungary,1994,7,1,8
Norway,Denmark,1994,2,1,3
Romania,Slovenia,1994,0,0,0
Austria,Germany,1994,1,5,6
Finland,Spain,1994,1,2,3
Latvia,Malta,1994,2,0,2
Bulgaria,Ukraine,1994,1,1,2
Colombia,Northern Ireland,1994,2,0,2
Italy,Switzerland,1994,1,0,1
Croatia,Argentina,1994,0,0,0
Trinidad and Tobago,Saudi Arabia,1994,2,3,5
United States,Mexico,1994,1,0,1
Canada,Brazil,1994,1,1,2
Colombia,Greece,1994,2,0,2
Ecuador,South Korea,1994,2,1,3
Republic of Ireland,Czech Republic,1994,1,3,4
Ivory Coast,Liberia,1994,4,1,5
Sweden,Norway,1994,2,0,2
Australia,South Africa,1994,1,0,1
Belgium,Hungary,1994,3,1,4
Bolivia,Peru,1994,0,0,0
Canada,Germany,1994,0,2,2
Honduras,Brazil,1994,2,8,10
Canada,Spain,1994,0,2,2
Bolivia,Switzerland,1994,0,0,0
Costa Rica,Italy,1994,0,1,1
Honduras,South Korea,1994,0,3,3
Mexico,Northern Ireland,1994,3,0,3
Nigeria,Georgia,1994,5,1,6
Australia,South Africa,1994,1,0,1
Canada,Netherlands,1994,0,3,3
El Salvador,Brazil,1994,0,4,4
Romania,Sweden,1994,1,1,2
Germany,Bolivia,1994,1,0,1
Spain,South Korea,1994,2,2,4
Colombia,Romania,1994,1,3,4
Italy,Republic of Ireland,1994,0,1,1
United States,Switzerland,1994,1,1,2
Belgium,Morocco,1994,1,0,1
Cameroon,Sweden,1994,2,2,4
Norway,Mexico,1994,1,0,1
Brazil,Russia,1994,2,0,2
Netherlands,Saudi Arabia,1994,2,1,3
Argentina,Greece,1994,4,0,4
Germany,Spain,1994,1,1,2
Nigeria,Bulgaria,1994,3,0,3
Romania,Switzerland,1994,1,4,5
United States,Colombia,1994,2,1,3
Italy,Norway,1994,1,0,1
South Korea,Bolivia,1994,0,0,0
Brazil,Cameroon,1994,3,0,3
Mexico,Republic of Ireland,1994,2,1,3
Sweden,Russia,1994,3,1,4
Argentina,Nigeria,1994,2,1,3
Belgium,Netherlands,1994,1,0,1
Saudi Arabia,Morocco,1994,2,1,3
Bulgaria,Greece,1994,4,0,4
Latvia,Georgia,1994,1,3,4
Switzerland,Colombia,1994,0,2,2
United States,Romania,1994,0,1,1
Bolivia,Spain,1994,1,3,4
Germany,South Korea,1994,3,2,5
Brazil,Sweden,1994,1,1,2
Republic of Ireland,Norway,1994,0,0,0
Italy,Mexico,1994,1,1,2
Russia,Cameroon,1994,6,1,7
Belgium,Saudi Arabia,1994,0,1,1
Morocco,Netherlands,1994,1,2,3
Argentina,Bulgaria,1994,0,2,2
Greece,Nigeria,1994,0,2,2
Botswana,Namibia,1994,0,1,1
Germany,Belgium,1994,3,2,5
Spain,Switzerland,1994,3,0,3
Papua New Guinea,New Caledonia,1994,1,0,1
Romania,Argentina,1994,3,2,5
Saudi Arabia,Sweden,1994,1,3,4
Fiji,New Caledonia,1994,3,1,4
Netherlands,Republic of Ireland,1994,2,0,2
United States,Brazil,1994,0,1,1
Mexico,Bulgaria,1994,1,1,2
Nigeria,Italy,1994,1,2,3
Solomon Islands,Papua New Guinea,1994,2,0,2
Vanuatu,New Caledonia,1994,2,3,5
Papua New Guinea,Fiji,1994,0,1,1
Solomon Islands,Vanuatu,1994,4,0,4
Solomon Islands,Fiji,1994,1,0,1
Vanuatu,Papua New Guinea,1994,1,1,2
Japan,Ghana,1994,3,2,5
Solomon Islands,New Caledonia,1994,3,1,4
Vanuatu,Fiji,1994,2,4,6
Italy,Spain,1994,2,1,3
Netherlands,Brazil,1994,2,3,5
Bulgaria,Germany,1994,2,1,3
Romania,Sweden,1994,2,2,4
Bulgaria,Italy,1994,1,2,3
Sweden,Brazil,1994,0,1,1
Japan,Ghana,1994,2,1,3
Armenia,Malta,1994,1,0,1
Sweden,Bulgaria,1994,4,0,4
Brazil,Italy,1994,0,0,0
Georgia,Malta,1994,1,1,2
Lithuania,Estonia,1994,3,0,3
Estonia,Latvia,1994,0,2,2
Lithuania,Latvia,1994,1,0,1
Ivory Coast,Mali,1994,2,1,3
Myanmar,Thailand,1994,2,2,4
Iceland,Estonia,1994,4,0,4
Niger,Togo,1994,3,2,5
Slovakia,Malta,1994,1,1,2
Austria,Russia,1994,0,3,3
Denmark,Finland,1994,2,1,3
France,Czech Republic,1994,2,2,4
Israel,Croatia,1994,0,4,4
Peru,Ecuador,1994,2,0,2
Poland,Belarus,1994,1,1,2
Sweden,Lithuania,1994,4,2,6
Congo,DR Congo,1994,2,0,2
Egypt,Mali,1994,2,1,3
Egypt,Mali,1994,0,1,1
Burkina Faso,Niger,1994,0,0,0
Egypt,Ghana,1994,2,0,2
DR Congo,Congo,1994,2,0,2
Ghana,Zambia,1994,1,0,1
Namibia,Botswana,1994,2,3,5
DR Congo,Congo,1994,1,1,2
Ukraine,United Arab Emirates,1994,1,1,2
Egypt,Zambia,1994,0,4,4
Iceland,United Arab Emirates,1994,1,0,1
North Macedonia,Turkey,1994,0,2,2
Solomon Islands,Fiji,1994,1,0,1
Tanzania,Uganda,1994,4,0,4
Angola,Namibia,1994,2,0,2
Botswana,Guinea,1994,0,1,1
Burkina Faso,Morocco,1994,2,1,3
Congo,Gambia,1994,1,1,2
DR Congo,Malawi,1994,1,1,2
Estonia,Croatia,1994,0,2,2
Ethiopia,Algeria,1994,0,0,0
Guinea-Bissau,Tunisia,1994,1,3,4
Israel,Poland,1994,2,1,3
Liberia,Togo,1994,1,0,1
Madagascar,South Africa,1994,0,1,1
Mali,Mozambique,1994,2,1,3
Sudan,Egypt,1994,0,0,0
Czech Republic,Malta,1994,6,1,7
Liberia,Togo,1994,1,1,2
Switzerland,United Arab Emirates,1994,1,0,1
Belgium,Armenia,1994,2,0,2
Cyprus,Spain,1994,1,2,3
England,United States,1994,2,0,2
Faroe Islands,Greece,1994,1,5,6
Finland,Scotland,1994,0,2,2
Georgia,Moldova,1994,0,1,1
Hungary,Turkey,1994,2,2,4
Iceland,Sweden,1994,0,1,1
Latvia,Republic of Ireland,1994,0,3,3
Liechtenstein,Austria,1994,0,4,4
Luxembourg,Netherlands,1994,0,4,4
North Macedonia,Denmark,1994,1,1,2
Northern Ireland,Portugal,1994,1,2,3
Norway,Belarus,1994,1,0,1
Romania,Azerbaijan,1994,3,0,3
Russia,Germany,1994,0,1,1
Slovakia,France,1994,0,0,0
Slovenia,Italy,1994,1,1,2
Ukraine,Lithuania,1994,0,2,2
Wales,Albania,1994,2,0,2
Qatar,Oman,1994,0,2,2
South Korea,Ukraine,1994,1,0,1
Bangladesh,India,1994,2,4,6
South Korea,Ukraine,1994,2,0,2
India,Yemen,1994,0,1,1
Oman,Sudan,1994,1,1,2
India,Oman,1994,1,4,5
Qatar,Yemen,1994,2,0,2
India,Yemen,1994,0,2,2
South Korea,United Arab Emirates,1994,0,0,0
Chile,Bolivia,1994,1,2,3
Ecuador,Peru,1994,0,0,0
Malaysia,Kuwait,1994,0,2,2
Australia,Kuwait,1994,0,0,0
Zambia,Ghana,1994,3,0,3
Japan,Australia,1994,0,0,0
Armenia,Cyprus,1994,0,0,0
Estonia,Italy,1994,0,2,2
France,Romania,1994,0,0,0
Croatia,Lithuania,1994,2,0,2
Latvia,Portugal,1994,1,3,4
Senegal,Niger,1994,3,1,4
Zambia,Malawi,1994,2,1,3
Austria,Northern Ireland,1994,1,2,3
Belarus,Luxembourg,1994,2,0,2
Bulgaria,Georgia,1994,2,0,2
Denmark,Belgium,1994,3,1,4
England,Romania,1994,1,1,2
Greece,Finland,1994,4,0,4
Hungary,Germany,1994,0,0,0
Republic of Ireland,Liechtenstein,1994,4,0,4
Israel,Slovakia,1994,2,2,4
North Macedonia,Spain,1994,0,2,2
Malta,Czech Republic,1994,0,0,0
Moldova,Wales,1994,3,2,5
Norway,Netherlands,1994,1,1,2
Poland,Azerbaijan,1994,1,0,1
Russia,San Marino,1994,4,0,4
Scotland,Faroe Islands,1994,5,1,6
Switzerland,Sweden,1994,4,2,6
Turkey,Iceland,1994,5,0,5
Ukraine,Slovenia,1994,0,0,0
Algeria,Sudan,1994,1,1,2
Egypt,Tanzania,1994,5,1,6
Mauritania,Guinea-Bissau,1994,1,1,2
Malawi,Zimbabwe,1994,3,1,4
Namibia,Mali,1994,2,1,3
Uganda,Ethiopia,1994,4,1,5
Cameroon,DR Congo,1994,1,0,1
Guinea,Angola,1994,3,1,4
Mozambique,Botswana,1994,3,1,4
Niger,Ghana,1994,1,5,6
Togo,Senegal,1994,2,0,2
Peru,Uruguay,1994,0,1,1
Saudi Arabia,United States,1994,2,1,3
Oman,Senegal,1994,0,1,1
Oman,Senegal,1994,2,1,3
Estonia,Finland,1994,0,7,7
Saudi Arabia,Trinidad and Tobago,1994,1,0,1
United Arab Emirates,Senegal,1994,3,2,5
Kuwait,Iceland,1994,0,1,1
United Arab Emirates,Qatar,1994,2,0,2
Bahrain,Kuwait,1994,2,1,3
Oman,Saudi Arabia,1994,1,2,3
Latvia,Estonia,1994,0,0,0
United Arab Emirates,Saudi Arabia,1994,1,1,2
Oman,Bahrain,1994,1,1,2
Kuwait,Qatar,1994,1,0,1
Morocco,Cameroon,1994,1,1,2
Tunisia,Ivory Coast,1994,2,0,2
Qatar,Oman,1994,4,2,6
United Arab Emirates,Kuwait,1994,2,0,2
Saudi Arabia,Bahrain,1994,3,1,4
Egypt,Ethiopia,1994,5,0,5
Mauritania,Liberia,1994,1,1,2
Gambia,Ghana,1994,1,2,3
Qatar,Saudi Arabia,1994,1,2,3
Romania,Slovakia,1994,3,2,5
Tanzania,Sudan,1994,2,0,2
Uganda,Algeria,1994,1,1,2
United Arab Emirates,Bahrain,1994,0,0,0
Gabon,Mauritius,1994,3,0,3
Guinea-Bissau,Senegal,1994,1,4,5
Lesotho,Cameroon,1994,2,0,2
Mali,Angola,1994,0,0,0
Morocco,Ivory Coast,1994,1,0,1
Mozambique,Guinea,1994,2,1,3
Niger,Sierra Leone,1994,4,2,6
Oman,Kuwait,1994,0,0,0
Portugal,Austria,1994,1,0,1
Ukraine,Estonia,1994,3,0,3
Zambia,South Africa,1994,1,1,2
Zimbabwe,DR Congo,1994,2,1,3
Bahrain,Qatar,1994,1,1,2
Grenada,Trinidad and Tobago,1994,1,2,3
Liechtenstein,Latvia,1994,0,1,1
Albania,Germany,1994,1,2,3
Azerbaijan,Israel,1994,0,2,2
Belarus,Norway,1994,0,4,4
Belgium,North Macedonia,1994,1,1,2
Bulgaria,Moldova,1994,4,1,5
Chile,Argentina,1994,0,3,3
Cyprus,Armenia,1994,2,0,2
England,Nigeria,1994,1,0,1
Finland,Faroe Islands,1994,5,0,5
Georgia,Wales,1994,5,0,5
Greece,San Marino,1994,2,0,2
Italy,Croatia,1994,1,2,3
Kuwait,Saudi Arabia,1994,0,2,2
Netherlands,Czech Republic,1994,0,0,0
Northern Ireland,Republic of Ireland,1994,0,4,4
Poland,France,1994,0,0,0
Scotland,Russia,1994,1,1,2
Slovenia,Lithuania,1994,1,2,3
Spain,Denmark,1994,3,0,3
Sweden,Hungary,1994,2,0,2
Switzerland,Iceland,1994,1,0,1
United Arab Emirates,Oman,1994,2,0,2
Trinidad and Tobago,United States,1994,1,0,1
Gabon,Zambia,1994,2,1,3
Jamaica,United States,1994,0,3,3
Samoa,American Samoa,1994,3,1,4
Tahiti,Tonga,1994,1,0,1
Samoa,Tonga,1994,2,2,4
Tahiti,American Samoa,1994,2,1,3
Cameroon,Ivory Coast,1994,1,2,3
Kenya,Somalia,1994,3,1,4
Kenya,Djibouti,1994,4,1,5
Samoa,Tahiti,1994,0,7,7
Tonga,American Samoa,1994,2,1,3
Israel,Cyprus,1994,4,3,7
Tanzania,Somalia,1994,4,0,4
Cameroon,Ghana,1994,0,1,1
South Africa,Ivory Coast,1994,0,0,0
Spain,Finland,1994,2,0,2
Kenya,Tanzania,1994,0,1,1
Somalia,Djibouti,1994,2,1,3
Uganda,Seychelles,1994,2,0,2
Tanzania,Djibouti,1994,3,0,3
Uganda,Eritrea,1994,0,0,0
Ghana,Ivory Coast,1994,1,1,2
South Africa,Cameroon,1994,1,1,2
Togo,Burkina Faso,1994,2,0,2
Kenya,Uganda,1994,0,1,1
Tanzania,Eritrea,1994,1,0,1
Kenya,Eritrea,1994,1,0,1
Saudi Arabia,Poland,1994,0,2,2
Tanzania,Uganda,1994,2,2,4
Namibia,Ivory Coast,1994,2,1,3
Saudi Arabia,Poland,1994,1,2,3
United States,Honduras,1994,1,1,2
Albania,Georgia,1994,0,1,1
Finland,San Marino,1994,4,1,5
Israel,Romania,1994,1,1,2
Malta,Norway,1994,0,1,1
Mexico,Hungary,1994,5,1,6
Moldova,Germany,1994,0,3,3
Netherlands,Luxembourg,1994,5,0,5
Turkey,Switzerland,1994,1,2,3
Wales,Bulgaria,1994,0,3,3
Tunisia,Algeria,1994,1,0,1
Belgium,Spain,1994,1,4,5
North Macedonia,Cyprus,1994,3,0,3
Saudi Arabia,Costa Rica,1994,1,3,4
Cameroon,Togo,1994,1,1,2
Germany,Albania,1994,2,1,3
Greece,Scotland,1994,1,0,1
Portugal,Liechtenstein,1994,8,0,8
Italy,Turkey,1994,3,1,4
Brazil,Serbia,1994,2,0,2
Basque Country,Russia,1994,1,0,1
Mali,Mauritania,1994,0,0,0
Argentina,Serbia,1994,1,0,1
Liberia,Guinea,1994,0,0,0
Mali,Mauritania,1994,0,0,0
Saudi Arabia,Zambia,1994,1,0,1
Guinea,Sierra Leone,1995,3,1,4
Mali,Mauritania,1995,0,1,1
Tunisia,Egypt,1995,2,0,2
Vietnam,Estonia,1995,1,0,1
Japan,Nigeria,1995,0,3,3
Saudi Arabia,Mexico,1995,0,2,2
Senegal,Tunisia,1995,0,0,0
Sierra Leone,Gambia,1995,2,0,2
Angola,Mozambique,1995,1,0,1
Cameroon,Malawi,1995,0,0,0
Congo,Niger,1995,3,1,4
DR Congo,Lesotho,1995,3,0,3
Ethiopia,Tanzania,1995,1,0,1
Guinea,Namibia,1995,3,0,3
Japan,Argentina,1995,1,5,6
Saudi Arabia,Denmark,1995,0,2,2
Togo,Mauritania,1995,0,0,0
Mauritius,Zambia,1995,0,3,3
Denmark,Mexico,1995,1,1,2
Nigeria,Argentina,1995,0,0,0
Denmark,Argentina,1995,2,0,2
Mexico,Nigeria,1995,1,1,2
Ivory Coast,Togo,1995,0,0,0
Netherlands,France,1995,0,1,1
Spain,Uruguay,1995,2,2,4
Tanzania,Algeria,1995,2,1,3
Uganda,Egypt,1995,0,0,0
Botswana,Angola,1995,1,2,3
Ethiopia,Sudan,1995,2,0,2
Ghana,Congo,1995,3,1,4
Ivory Coast,Burkina Faso,1995,2,2,4
Lesotho,Malawi,1995,0,2,2
Liberia,Senegal,1995,1,1,2
Mozambique,Namibia,1995,4,2,6
Niger,Gambia,1995,1,1,2
Zimbabwe,Cameroon,1995,4,1,5
Cyprus,Greece,1995,2,3,5
Canada,Portugal,1995,1,1,2
Tunisia,Mauritania,1995,1,0,1
South Korea,Colombia,1995,1,0,1
Mexico,Uruguay,1995,1,0,1
South Korea,Serbia,1995,0,1,1
Estonia,Norway,1995,0,7,7
Cyprus,Norway,1995,0,2,2
Greece,Romania,1995,1,0,1
Tunisia,Liberia,1995,0,0,0
Australia,Colombia,1995,0,1,1
Argentina,Bulgaria,1995,4,1,5
Israel,Luxembourg,1995,4,2,6
Australia,Japan,1995,2,1,3
Cyprus,Estonia,1995,3,1,4
Republic of Ireland,England,1995,1,0,1
Trinidad and Tobago,Finland,1995,2,1,3
Turkey,Romania,1995,1,1,2
Trinidad and Tobago,Finland,1995,2,2,4
China PR,South Korea,1995,0,0,0
Hong Kong,Japan,1995,0,3,3
Hong Kong,China PR,1995,0,0,0
Japan,South Korea,1995,1,1,2
New Zealand,Singapore,1995,3,0,3
Brazil,Slovakia,1995,5,0,5
Malta,Luxembourg,1995,0,1,1
Netherlands,Portugal,1995,0,1,1
Spain,Germany,1995,0,0,0
Thailand,Japan,1995,3,2,5
China PR,Japan,1995,1,2,3
Hong Kong,South Korea,1995,2,3,5
Hong Kong,China PR,1995,1,1,2
Japan,South Korea,1995,2,2,4
Morocco,Senegal,1995,2,0,2
Cyprus,Sweden,1995,3,3,6
Czech Republic,Finland,1995,4,1,5
Greece,Switzerland,1995,1,1,2
Hungary,Latvia,1995,3,1,4
Iraq,Uzbekistan,1995,3,1,4
Slovakia,Russia,1995,2,1,3
Turkey,Israel,1995,2,1,3
India,Thailand,1995,0,5,5
Barbados,Saint Kitts and Nevis,1995,0,1,1
India,Iraq,1995,1,1,2
Jamaica,Cuba,1995,0,0,0
India,Uzbekistan,1995,1,0,1
Iraq,Thailand,1995,3,1,4
Poland,Lithuania,1995,4,1,5
Thailand,Uzbekistan,1995,0,1,1
Sint Maarten,Saint Kitts and Nevis,1995,0,2,2
Grenada,Saint Lucia,1995,2,0,2
Colombia,Uruguay,1995,2,1,3
Morocco,Mali,1995,3,0,3
Tahiti,Fiji,1995,3,3,6
Croatia,Ukraine,1995,4,0,4
Italy,Estonia,1995,4,1,5
Nepal,Bangladesh,1995,0,2,2
Pakistan,Bangladesh,1995,1,0,1
United States,Uruguay,1995,2,2,4
Barbados,Guyana,1995,3,0,3
Lebanon,Egypt,1995,1,1,2
Montserrat,Anguilla,1995,3,2,5
Saint Kitts and Nevis,Sint Maarten,1995,0,1,1
Albania,Moldova,1995,3,0,3
Austria,Latvia,1995,5,0,5
Brazil,Honduras,1995,1,1,2
Bulgaria,Wales,1995,3,1,4
Cyprus,Denmark,1995,1,1,2
Czech Republic,Belarus,1995,4,2,6
England,Uruguay,1995,0,0,0
Georgia,Germany,1995,0,2,2
Hungary,Switzerland,1995,2,2,4
Republic of Ireland,Northern Ireland,1995,1,1,2
Israel,France,1995,0,0,0
Lithuania,Croatia,1995,0,0,0
Luxembourg,Norway,1995,0,2,2
Mexico,Chile,1995,1,2,3
Nepal,Pakistan,1995,2,0,2
Netherlands,Malta,1995,4,0,4
Romania,Poland,1995,2,1,3
Russia,Scotland,1995,0,0,0
San Marino,Finland,1995,0,2,2
Slovakia,Azerbaijan,1995,4,1,5
Slovenia,Estonia,1995,3,0,3
Spain,Belgium,1995,1,1,2
Sri Lanka,India,1995,2,2,4
Turkey,Sweden,1995,2,1,3
Ukraine,Italy,1995,0,2,2
Tahiti,Fiji,1995,3,0,3
India,Bangladesh,1995,0,0,0
Serbia,Uruguay,1995,1,0,1
Sri Lanka,Nepal,1995,2,1,3
Syria,Egypt,1995,1,2,3
Anguilla,Montserrat,1995,0,1,1
Gabon,Benin,1995,7,0,7
Guyana,Barbados,1995,0,4,4
Sri Lanka,India,1995,1,0,1
Bolivia,Venezuela,1995,0,0,0
Uruguay,Peru,1995,1,0,1
Mauritania,Senegal,1995,0,1,1
Sierra Leone,Ghana,1995,1,0,1
Uganda,Tanzania,1995,2,0,2
Zambia,Gabon,1995,1,0,1
Gambia,Congo,1995,1,1,2
Guinea,Botswana,1995,5,0,5
Lesotho,Zimbabwe,1995,0,2,2
Malawi,DR Congo,1995,0,1,1
Morocco,Burkina Faso,1995,0,0,0
Mozambique,Mali,1995,1,0,1
Saint Lucia,Grenada,1995,4,0,4
Togo,Liberia,1995,0,0,0
North Macedonia,Bulgaria,1995,0,0,0
Egypt,Tunisia,1995,1,0,1
Peru,Chile,1995,6,0,6
Belgium,United States,1995,1,0,1
Chile,Iceland,1995,1,1,2
Congo,Sierra Leone,1995,0,2,2
Senegal,Togo,1995,5,1,6
Tanzania,Egypt,1995,1,2,3
Angola,Guinea,1995,3,0,3
Botswana,Mozambique,1995,0,3,3
DR Congo,Cameroon,1995,2,1,3
Ethiopia,Uganda,1995,0,0,0
Ghana,Niger,1995,1,0,1
Liberia,Tunisia,1995,1,0,1
Mali,Namibia,1995,2,0,2
Zimbabwe,Malawi,1995,1,1,2
Sudan,Algeria,1995,2,0,2
Poland,Israel,1995,4,3,7
Armenia,Spain,1995,0,2,2
Austria,Liechtenstein,1995,7,0,7
Azerbaijan,Romania,1995,1,4,5
Belarus,Malta,1995,1,1,2
Belgium,Cyprus,1995,2,0,2
Croatia,Slovenia,1995,2,0,2
Czech Republic,Netherlands,1995,3,1,4
Denmark,North Macedonia,1995,1,0,1
Estonia,Ukraine,1995,0,1,1
Faroe Islands,Finland,1995,0,4,4
France,Slovakia,1995,4,0,4
Georgia,Albania,1995,2,0,2
Germany,Wales,1995,1,1,2
Greece,Russia,1995,0,3,3
Hungary,Sweden,1995,1,0,1
Republic of Ireland,Portugal,1995,1,0,1
Ivory Coast,Sierra Leone,1995,4,0,4
Latvia,Northern Ireland,1995,0,1,1
Lithuania,Italy,1995,0,1,1
Moldova,Bulgaria,1995,0,3,3
Norway,Luxembourg,1995,5,0,5
San Marino,Scotland,1995,0,2,2
Switzerland,Turkey,1995,1,2,3
Barbados,Saint Lucia,1995,1,1,2
Guernsey,Jersey,1995,1,2,3
Saint Kitts and Nevis,Antigua and Barbuda,1995,1,1,2
Kuwait,Mali,1995,2,1,3
Russia,Faroe Islands,1995,3,0,3
Aruba,Curaçao,1995,3,4,7
Saint Lucia,Barbados,1995,2,1,3
Slovakia,Czech Republic,1995,1,1,2
French Guiana,Martinique,1995,1,3,4
Guadeloupe,Suriname,1995,1,2,3
Armenia,North Macedonia,1995,2,2,4
French Guiana,Guadeloupe,1995,2,2,4
Martinique,Suriname,1995,1,1,2
French Guiana,Suriname,1995,4,0,4
Guadeloupe,Martinique,1995,2,1,3
Ivory Coast,Mali,1995,0,1,1
South Africa,Argentina,1995,1,1,2
Togo,Benin,1995,3,0,3
Bolivia,Paraguay,1995,1,1,2
Curaçao,Aruba,1995,3,2,5
Israel,Brazil,1995,1,2,3
Lithuania,Greece,1995,2,1,3
Morocco,Egypt,1995,0,0,0
Latvia,Estonia,1995,2,0,2
Estonia,Lithuania,1995,0,7,7
Antigua and Barbuda,Saint Kitts and Nevis,1995,2,2,4
Japan,Scotland,1995,0,0,0
Latvia,Lithuania,1995,2,0,2
Canada,Northern Ireland,1995,2,0,2
Cuba,Curaçao,1995,3,0,3
Dominican Republic,Puerto Rico,1995,3,1,4
Ecuador,Scotland,1995,1,2,3
Chile,Northern Ireland,1995,2,1,3
Curaçao,Puerto Rico,1995,2,2,4
Dominican Republic,Cuba,1995,0,3,3
Faroe Islands,San Marino,1995,3,0,3
Liberia,Mali,1995,3,2,5
Norway,Ghana,1995,3,2,5
Cuba,Puerto Rico,1995,9,0,9
Dominican Republic,Curaçao,1995,1,2,3
Canada,Chile,1995,1,2,3
Ivory Coast,Liberia,1995,1,1,2
Japan,Ecuador,1995,3,0,3
United States,Costa Rica,1995,1,2,3
Argentina,Peru,1995,1,0,1
Finland,Denmark,1995,0,1,1
Serbia,Russia,1995,1,2,3
Sweden,Iceland,1995,1,1,2
Algeria,Uganda,1995,1,1,2
England,Japan,1995,2,1,3
Liechtenstein,Republic of Ireland,1995,0,0,0
Portugal,Latvia,1995,3,2,5
Sierra Leone,Niger,1995,5,1,6
Sudan,Tanzania,1995,2,1,3
Angola,Mali,1995,1,0,1
Botswana,Namibia,1995,1,1,2
Brazil,Sweden,1995,1,0,1
Cameroon,Lesotho,1995,4,1,5
Canada,Turkey,1995,1,3,4
DR Congo,Zimbabwe,1995,5,0,5
Ecuador,Zambia,1995,4,1,5
Ethiopia,Egypt,1995,0,2,2
Guinea,Mozambique,1995,0,0,0
Ivory Coast,Morocco,1995,2,0,2
Liberia,Mauritania,1995,2,0,2
Mauritius,Gabon,1995,0,3,3
Togo,Tunisia,1995,0,1,1
South Korea,Costa Rica,1995,1,0,1
Brazil,Japan,1995,3,0,3
Belarus,Netherlands,1995,1,0,1
Bulgaria,Germany,1995,3,2,5
Canada,Turkey,1995,0,3,3
Denmark,Cyprus,1995,4,0,4
Faroe Islands,Scotland,1995,0,2,2
Lithuania,Slovenia,1995,2,1,3
Luxembourg,Czech Republic,1995,1,0,1
North Macedonia,Belgium,1995,0,5,5
Moldova,Albania,1995,2,3,5
Northern Ireland,Latvia,1995,1,2,3
Norway,Malta,1995,2,0,2
Romania,Israel,1995,2,1,3
San Marino,Russia,1995,0,7,7
Spain,Armenia,1995,1,0,1
Wales,Georgia,1995,0,1,1
England,Sweden,1995,3,3,6
Paraguay,Bolivia,1995,0,0,0
Tahiti,New Zealand,1995,2,1,3
Costa Rica,Ecuador,1995,1,2,3
South Korea,Zambia,1995,2,3,5
Sweden,Japan,1995,2,2,4
England,Brazil,1995,1,3,4
Estonia,Slovenia,1995,1,3,4
Finland,Greece,1995,2,1,3
Honduras,Turkey,1995,0,1,1
Iceland,Hungary,1995,2,1,3
Republic of Ireland,Austria,1995,1,3,4
Ukraine,Croatia,1995,1,0,1
United States,Nigeria,1995,3,2,5
Ecuador,Zambia,1995,1,0,1
Argentina,Paraguay,1995,2,1,3
Colombia,Nigeria,1995,1,0,1
Australia,Ghana,1995,2,1,3
United States,Mexico,1995,4,0,4
Venezuela,Bolivia,1995,1,3,4
Chile,Paraguay,1995,0,1,1
Switzerland,Italy,1995,0,1,1
New Zealand,Turkey,1995,1,2,3
Australia,Ghana,1995,1,0,1
Germany,Italy,1995,2,0,2
Mexico,Colombia,1995,0,0,0
Chile,Turkey,1995,0,0,0
Paraguay,New Zealand,1995,3,2,5
Switzerland,Germany,1995,1,2,3
Australia,Ghana,1995,0,1,1
Mexico,Nigeria,1995,2,1,3
Mozambique,Zimbabwe,1995,3,1,4
Uruguay,New Zealand,1995,7,0,7
United States,Colombia,1995,0,0,0
Uruguay,New Zealand,1995,2,2,4
Argentina,Australia,1995,2,0,2
Paraguay,Ecuador,1995,1,0,1
Ivory Coast,Ghana,1995,2,0,2
Peru,Bolivia,1995,4,1,5
Iceland,Faroe Islands,1995,2,0,2
Uruguay,Venezuela,1995,4,1,5
Mexico,Paraguay,1995,1,2,3
Brazil,Ecuador,1995,1,0,1
Colombia,Peru,1995,1,1,2
Argentina,Bolivia,1995,2,1,3
United States,Chile,1995,2,1,3
Mexico,Venezuela,1995,3,1,4
Syria,Egypt,1995,0,0,0
Uruguay,Paraguay,1995,1,0,1
Brazil,Peru,1995,2,0,2
Colombia,Ecuador,1995,1,0,1
Argentina,Chile,1995,4,0,4
United States,Bolivia,1995,0,1,1
Paraguay,Venezuela,1995,3,2,5
Brazil,Colombia,1995,3,0,3
Peru,Ecuador,1995,1,2,3
Uruguay,Mexico,1995,1,1,2
Argentina,United States,1995,0,3,3
Chile,Bolivia,1995,2,2,4
Egypt,Algeria,1995,1,1,2
Mauritania,Togo,1995,2,1,3
Tanzania,Ethiopia,1995,2,0,2
Tunisia,Senegal,1995,4,0,4
Uganda,Sudan,1995,2,0,2
Zambia,Mauritius,1995,2,0,2
Malawi,Cameroon,1995,1,3,4
Mali,Botswana,1995,4,0,4
Mozambique,Angola,1995,2,1,3
Paraguay,Colombia,1995,1,1,2
Uruguay,Bolivia,1995,2,1,3
Isle of Man,Ynys Môn,1995,0,2,2
Gibraltar,Greenland,1995,0,1,1
Jersey,Isle of Wight,1995,2,0,2
Åland Islands,Guernsey,1995,2,2,4
Brazil,Argentina,1995,2,2,4
United States,Mexico,1995,0,0,0
Gibraltar,Isle of Man,1995,2,1,3
Greenland,Ynys Môn,1995,1,2,3
Åland Islands,Isle of Wight,1995,0,5,5
Jersey,Guernsey,1995,1,0,1
Gibraltar,Ynys Môn,1995,2,0,2
Greenland,Isle of Man,1995,4,0,4
Jersey,Åland Islands,1995,3,1,4
Isle of Wight,Guernsey,1995,1,1,2
Jamaica,Saint Lucia,1995,2,1,3
Trinidad and Tobago,Cuba,1995,2,0,2
Uruguay,Colombia,1995,2,0,2
United States,Brazil,1995,0,1,1
Greenland,Isle of Wight,1995,1,2,3
Gibraltar,Jersey,1995,1,0,1
Cayman Islands,Antigua and Barbuda,1995,2,0,2
French Guiana,Saint Vincent and the Grenadines,1995,1,3,4
Jamaica,Cuba,1995,1,2,3
Malaysia,Iraq,1995,1,2,3
Saint Lucia,Trinidad and Tobago,1995,0,5,5
Åland Islands,Isle of Man,1995,4,1,5
Guernsey,Ynys Môn,1995,4,2,6
Gibraltar,Jersey,1995,1,0,1
Algeria,Tunisia,1995,2,1,3
Colombia,United States,1995,4,1,5
Norway,France,1995,0,0,0
Gibraltar,Isle of Wight,1995,0,1,1
Cayman Islands,French Guiana,1995,1,0,1
Cuba,Saint Lucia,1995,2,0,2
Jamaica,Trinidad and Tobago,1995,1,0,1
Mali,Ivory Coast,1995,2,2,4
Saint Vincent and the Grenadines,Antigua and Barbuda,1995,5,1,6
Uruguay,Brazil,1995,1,1,2
Antigua and Barbuda,French Guiana,1995,2,1,3
Cayman Islands,Trinidad and Tobago,1995,2,9,11
Lithuania,Belarus,1995,1,1,2
Algeria,Tanzania,1995,2,1,3
Angola,Botswana,1995,4,0,4
Burkina Faso,Ivory Coast,1995,1,1,2
Cameroon,Zimbabwe,1995,1,0,1
Cayman Islands,Cuba,1995,0,3,3
Congo,Ghana,1995,0,2,2
Egypt,Uganda,1995,6,0,6
Guinea,Mali,1995,4,1,5
Mauritania,Tunisia,1995,0,0,0
Namibia,Mozambique,1995,0,0,0
Senegal,Liberia,1995,3,0,3
Sudan,Ethiopia,1995,3,0,3
Canada,Jamaica,1995,3,1,4
Indonesia,Singapore,1995,0,0,0
Canada,Trinidad and Tobago,1995,3,1,4
Jamaica,Trinidad and Tobago,1995,1,0,1
Japan,Costa Rica,1995,3,0,3
Japan,Brazil,1995,1,5,6
South Korea,Brazil,1995,0,1,1
Liechtenstein,Portugal,1995,0,7,7
Armenia,Denmark,1995,0,2,2
Azerbaijan,Slovakia,1995,0,1,1
Cook Islands,New Caledonia,1995,0,9,9
Estonia,Lithuania,1995,0,1,1
Fiji,Papua New Guinea,1995,2,2,4
Finland,Russia,1995,0,6,6
France,Poland,1995,1,1,2
Guam,Vanuatu,1995,0,6,6
Hungary,Israel,1995,0,2,2
Iceland,Switzerland,1995,0,2,2
Latvia,Austria,1995,3,2,5
Malta,Albania,1995,2,1,3
Norway,Czech Republic,1995,1,1,2
Scotland,Greece,1995,1,0,1
Solomon Islands,Wallis Islands and Futuna,1995,12,1,13
Sweden,United States,1995,1,0,1
Tahiti,Wallis Islands and Futuna,1995,13,0,13
Jamaica,Zambia,1995,1,1,2
New Caledonia,Solomon Islands,1995,0,1,1
Cook Islands,Wallis Islands and Futuna,1995,2,1,3
Tahiti,Solomon Islands,1995,4,2,6
Fiji,Guam,1995,8,0,8
Jamaica,Zambia,1995,3,1,4
New Caledonia,Wallis Islands and Futuna,1995,10,0,10
Papua New Guinea,Vanuatu,1995,0,3,3
Cook Islands,Solomon Islands,1995,0,16,16
Tahiti,New Caledonia,1995,2,0,2
Fiji,Vanuatu,1995,3,1,4
Guam,Papua New Guinea,1995,0,9,9
Tahiti,Cook Islands,1995,11,0,11
Belgium,Germany,1995,1,2,3
Fiji,Solomon Islands,1995,3,3,6
Tahiti,Vanuatu,1995,3,0,3
Fiji,Vanuatu,1995,3,0,3
Tahiti,Solomon Islands,1995,2,0,2
Turkey,North Macedonia,1995,2,1,3
Croatia,Estonia,1995,7,1,8
Portugal,Northern Ireland,1995,1,1,2
Albania,Bulgaria,1995,1,1,2
Austria,Republic of Ireland,1995,3,1,4
Belgium,Denmark,1995,1,3,4
Czech Republic,Norway,1995,2,0,2
England,Colombia,1995,0,0,0
Faroe Islands,Russia,1995,2,5,7
France,Azerbaijan,1995,10,0,10
Germany,Georgia,1995,4,1,5
Italy,Slovenia,1995,1,0,1
Latvia,Liechtenstein,1995,1,0,1
Lithuania,Ukraine,1995,1,3,4
Luxembourg,Malta,1995,1,0,1
North Macedonia,Armenia,1995,1,2,3
Netherlands,Belarus,1995,1,0,1
Poland,Romania,1995,0,0,0
San Marino,Greece,1995,0,4,4
Scotland,Finland,1995,1,0,1
Slovakia,Israel,1995,1,0,1
Spain,Cyprus,1995,6,0,6
Sweden,Switzerland,1995,0,0,0
Turkey,Hungary,1995,2,0,2
Wales,Moldova,1995,1,0,1
Greece,Serbia,1995,0,2,2
Israel,Uruguay,1995,3,1,4
Japan,Paraguay,1995,1,2,3
Spain,Argentina,1995,2,1,3
Trinidad and Tobago,Jamaica,1995,1,0,1
Jamaica,Costa Rica,1995,2,0,2
South Africa,Mozambique,1995,3,2,5
Finland,Turkey,1995,0,0,0
Armenia,Belgium,1995,0,2,2
Belarus,Czech Republic,1995,0,2,2
Bulgaria,Albania,1995,3,0,3
Croatia,Italy,1995,1,1,2
Germany,Moldova,1995,6,1,7
United States,Saudi Arabia,1995,4,3,7
Argentina,Colombia,1995,0,0,0
Austria,Portugal,1995,1,1,2
Brazil,Uruguay,1995,2,0,2
Chile,Canada,1995,2,0,2
Cyprus,North Macedonia,1995,1,1,2
Denmark,Spain,1995,1,1,2
Georgia,Bulgaria,1995,2,1,3
Iceland,Turkey,1995,0,0,0
Republic of Ireland,Latvia,1995,2,1,3
Israel,Azerbaijan,1995,2,0,2
Liechtenstein,Northern Ireland,1995,0,4,4
Lithuania,Estonia,1995,5,0,5
Luxembourg,Belarus,1995,0,0,0
Malta,Netherlands,1995,0,4,4
Mexico,Saudi Arabia,1995,2,1,3
Norway,England,1995,0,0,0
Romania,France,1995,1,3,4
Russia,Greece,1995,2,1,3
San Marino,Faroe Islands,1995,1,3,4
Slovakia,Poland,1995,4,1,5
Slovenia,Ukraine,1995,3,2,5
Sweden,Scotland,1995,2,0,2
Switzerland,Hungary,1995,3,0,3
Wales,Germany,1995,1,2,3
Jamaica,Honduras,1995,1,0,1
Jamaica,Trinidad and Tobago,1995,1,0,1
Mali,Algeria,1995,0,2,2
Uzbekistan,Nigeria,1995,2,3,5
Burkina Faso,Tunisia,1995,2,2,4
Cayman Islands,Jamaica,1995,1,5,6
Gabon,Sierra Leone,1995,1,0,1
Panama,Nicaragua,1995,2,0,2
Cayman Islands,Trinidad and Tobago,1995,0,7,7
Japan,Saudi Arabia,1995,2,1,3
Bolivia,Ecuador,1995,2,2,4
Myanmar,Bangladesh,1995,4,0,4
China PR,Colombia,1995,2,1,3
Japan,Saudi Arabia,1995,2,1,3
Myanmar,Sri Lanka,1995,2,0,2
Nicaragua,Panama,1995,0,5,5
South Korea,Saudi Arabia,1995,1,1,2
Bangladesh,Sri Lanka,1995,1,0,1
Algeria,Mauritania,1995,4,0,4
Myanmar,Bangladesh,1995,1,2,3
Tunisia,Algeria,1995,2,0,2
Zambia,Jamaica,1995,4,2,6
Tunisia,Mauritania,1995,2,1,3
Argentina,Brazil,1995,0,1,1
New Zealand,Australia,1995,0,0,0
Nigeria,Uzbekistan,1995,1,0,1
Hungary,Iceland,1995,1,0,1
Italy,Ukraine,1995,3,1,4
El Salvador,Serbia,1995,1,4,5
Malta,Belarus,1995,0,2,2
Albania,Wales,1995,1,1,2
Australia,New Zealand,1995,3,0,3
Azerbaijan,Poland,1995,0,0,0
Cyprus,Belgium,1995,1,1,2
Czech Republic,Luxembourg,1995,3,0,3
Denmark,Armenia,1995,3,1,4
England,Switzerland,1995,3,1,4
France,Israel,1995,2,0,2
Germany,Bulgaria,1995,3,1,4
Greece,Faroe Islands,1995,5,0,5
Italy,Lithuania,1995,4,0,4
Moldova,Georgia,1995,3,2,5
Morocco,Mali,1995,2,0,2
Netherlands,Norway,1995,3,0,3
Northern Ireland,Austria,1995,5,3,8
Portugal,Republic of Ireland,1995,3,0,3
Russia,Finland,1995,3,1,4
Scotland,San Marino,1995,5,0,5
Slovakia,Romania,1995,0,2,2
Slovenia,Croatia,1995,1,2,3
Spain,North Macedonia,1995,3,0,3
Sweden,Turkey,1995,2,2,4
Mexico,Serbia,1995,1,4,5
Cape Verde,Mali,1995,1,0,1
Mauritania,Gambia,1995,2,1,3
Solomon Islands,Tahiti,1995,0,1,1
Guinea-Bissau,Senegal,1995,2,1,3
Sierra Leone,Guinea,1995,2,0,2
Dominica,Saint Lucia,1995,2,1,3
Mali,Gambia,1995,1,0,1
Mauritania,Cape Verde,1995,1,1,2
Saint Vincent and the Grenadines,Barbados,1995,2,0,2
Senegal,Guinea,1995,3,0,3
Sierra Leone,Guinea-Bissau,1995,2,0,2
Egypt,Zimbabwe,1995,2,2,4
Guinea-Bissau,Guinea,1995,2,1,3
Senegal,Sierra Leone,1995,1,1,2
South Africa,Zambia,1995,2,2,4
Grenada,Barbados,1995,1,0,1
Saint Lucia,Saint Vincent and the Grenadines,1995,2,1,3
South Africa,Egypt,1995,2,0,2
Zambia,Zimbabwe,1995,1,1,2
Mauritania,Guinea-Bissau,1995,1,0,1
Sierra Leone,Cape Verde,1995,2,0,2
Algeria,Ivory Coast,1995,0,0,0
Egypt,Zambia,1995,3,1,4
Gabon,Cameroon,1995,1,2,3
Jamaica,Norway,1995,1,1,2
South Africa,Zimbabwe,1995,2,0,2
Uganda,Rwanda,1995,0,0,0
Cape Verde,Guinea-Bissau,1995,1,0,1
Kenya,Zanzibar,1995,2,0,2
Tanzania,Ethiopia,1995,2,2,4
Algeria,Cameroon,1995,4,0,4
Dominica,Saint Vincent and the Grenadines,1995,1,0,1
Gabon,Ivory Coast,1995,0,2,2
Mauritania,Sierra Leone,1995,0,0,0
El Salvador,Belize,1995,3,0,3
Honduras,Panama,1995,2,0,2
Mexico,Colombia,1995,2,2,4
Trinidad and Tobago,Norway,1995,3,2,5
Tunisia,Burkina Faso,1995,3,0,3
Zanzibar,Rwanda,1995,2,1,3
Albania,Bosnia and Herzegovina,1995,2,0,2
Gabon,Algeria,1995,2,1,3
Ivory Coast,Cameroon,1995,2,1,3
Kenya,Rwanda,1995,1,0,1
Uganda,Zanzibar,1995,0,1,1
Costa Rica,Belize,1995,2,1,3
Guatemala,Panama,1995,1,0,1
Tanzania,Somalia,1995,7,0,7
Algeria,Ivory Coast,1995,0,0,0
Gabon,Cameroon,1995,0,0,0
Uganda,Kenya,1995,0,0,0
Antigua and Barbuda,Jamaica,1995,1,2,3
El Salvador,Costa Rica,1995,2,1,3
Ethiopia,Somalia,1995,5,0,5
Grenada,Saint Vincent and the Grenadines,1995,1,0,1
Honduras,Guatemala,1995,2,0,2
Ethiopia,Zanzibar,1995,1,1,2
Mexico,Slovenia,1995,1,2,3
Saint Kitts and Nevis,Jamaica,1995,0,3,3
El Salvador,Guatemala,1995,0,1,1
Honduras,Costa Rica,1995,1,1,2
Ivory Coast,Mali,1995,2,1,3
Kenya,Ethiopia,1995,2,1,3
El Salvador,Costa Rica,1995,2,1,3
Honduras,Guatemala,1995,3,0,3
DR Congo,Congo,1995,2,2,4
England,Portugal,1995,1,1,2
Republic of Ireland,Netherlands,1995,0,2,2
Kuwait,Czech Republic,1995,1,2,3
South Africa,Germany,1995,0,0,0
Sierra Leone,Liberia,1995,1,0,1
Brazil,Colombia,1995,3,1,4
Jamaica,Mexico,1995,2,1,3
Argentina,Venezuela,1995,6,0,6
Burkina Faso,Gabon,1995,2,5,7
Basque Country,Paraguay,1995,1,1,2
Zambia,Tunisia,1995,2,0,2
Cameroon,Liberia,1995,1,0,1
Kuwait,Kazakhstan,1995,0,0,0
Mali,Gabon,1995,1,2,3
Egypt,Ghana,1995,1,2,3
Saudi Arabia,Kazakhstan,1995,3,0,3
Lebanon,Kazakhstan,1996,2,1,3
Morocco,Tunisia,1996,3,1,4
Saudi Arabia,Ghana,1996,1,1,2
Trinidad and Tobago,Venezuela,1996,0,0,0
Sierra Leone,Liberia,1996,2,1,3
Trinidad and Tobago,Venezuela,1996,0,0,0
Zimbabwe,Gabon,1996,1,2,3
Egypt,Tunisia,1996,2,1,3
Zimbabwe,Ghana,1996,1,1,2
Canada,Honduras,1996,3,1,4
Trinidad and Tobago,El Salvador,1996,2,3,5
Mexico,Saint Vincent and the Grenadines,1996,5,0,5
Mozambique,Gabon,1996,1,0,1
Brazil,Canada,1996,4,1,5
South Africa,Cameroon,1996,3,0,3
United States,Trinidad and Tobago,1996,3,2,5
Guatemala,Mexico,1996,0,1,1
Honduras,Brazil,1996,0,5,5
Ivory Coast,Ghana,1996,0,2,2
Jamaica,Cuba,1996,1,1,2
Zambia,Algeria,1996,0,0,0
Egypt,Angola,1996,2,1,3
Sierra Leone,Burkina Faso,1996,2,1,3
Gabon,Liberia,1996,1,2,3
Guatemala,Saint Vincent and the Grenadines,1996,3,0,3
Lebanon,Cyprus,1996,1,0,1
Tunisia,Mozambique,1996,1,1,2
United States,El Salvador,1996,2,0,2
Armenia,Morocco,1996,0,6,6
Algeria,Sierra Leone,1996,2,0,2
Cameroon,Egypt,1996,2,1,3
United States,Brazil,1996,0,1,1
DR Congo,Gabon,1996,0,2,2
Ghana,Tunisia,1996,2,1,3
Mexico,Guatemala,1996,1,0,1
Burkina Faso,Zambia,1996,1,5,6
South Africa,Angola,1996,1,0,1
Mexico,Brazil,1996,2,0,2
Mozambique,Ivory Coast,1996,0,1,1
United States,Guatemala,1996,3,0,3
Angola,Cameroon,1996,3,3,6
Burkina Faso,Algeria,1996,1,2,3
Greece,Israel,1996,2,1,3
Saudi Arabia,Kyrgyzstan,1996,3,0,3
Sierra Leone,Zambia,1996,0,4,4
South Africa,Egypt,1996,0,1,1
Liberia,DR Congo,1996,0,2,2
Mozambique,Ghana,1996,0,2,2
Tunisia,Ivory Coast,1996,3,1,4
Yemen,Kyrgyzstan,1996,1,0,1
South Africa,Algeria,1996,2,1,3
Zambia,Egypt,1996,3,1,4
Gabon,Tunisia,1996,1,1,2
Ghana,DR Congo,1996,1,0,1
Saudi Arabia,Yemen,1996,4,0,4
China PR,Macau,1996,7,1,8
Hong Kong,Philippines,1996,8,0,8
Saudi Arabia,Kyrgyzstan,1996,2,0,2
South Africa,Ghana,1996,3,0,3
Zambia,Tunisia,1996,2,4,6
Hong Kong,Macau,1996,4,1,5
Philippines,China PR,1996,0,7,7
Kyrgyzstan,Yemen,1996,3,1,4
Venezuela,Ecuador,1996,0,1,1
South Africa,Tunisia,1996,2,0,2
Zambia,Ghana,1996,1,0,1
Bolivia,Chile,1996,1,1,2
Hong Kong,China PR,1996,0,2,2
Macau,Philippines,1996,5,1,6
Saudi Arabia,Yemen,1996,1,0,1
Canary Islands,Venezuela,1996,5,1,6
Chile,Mexico,1996,2,1,3
Iceland,Slovenia,1996,1,7,8
Malta,Russia,1996,0,2,2
Morocco,Luxembourg,1996,2,0,2
Spain,Norway,1996,1,0,1
Iceland,Russia,1996,0,3,3
Malta,Slovenia,1996,0,0,0
Thailand,Finland,1996,1,0,1
Australia,Japan,1996,1,4,5
Lebanon,Ecuador,1996,1,0,1
Malta,Iceland,1996,1,4,5
Peru,Bolivia,1996,1,3,4
Russia,Slovenia,1996,3,1,4
Australia,Japan,1996,3,0,3
Bolivia,Paraguay,1996,4,1,5
Chile,Peru,1996,4,0,4
Turkey,Belarus,1996,3,2,5
Azerbaijan,Estonia,1996,0,0,0
Oman,Ecuador,1996,0,2,2
Thailand,Finland,1996,5,2,7
Qatar,Ecuador,1996,1,1,2
Japan,Poland,1996,5,0,5
Cyprus,Estonia,1996,1,0,1
France,Greece,1996,3,1,4
Israel,Lithuania,1996,4,2,6
Portugal,Germany,1996,1,2,3
Japan,Sweden,1996,1,1,2
Kuwait,Ecuador,1996,0,3,3
Thailand,Indonesia,1996,4,1,5
Estonia,Faroe Islands,1996,2,2,4
Kuwait,Oman,1996,1,0,1
Australia,Sweden,1996,0,2,2
Qatar,Ecuador,1996,1,2,3
Azerbaijan,Faroe Islands,1996,3,0,3
Australia,Sweden,1996,0,0,0
Croatia,Poland,1996,2,1,3
Malaysia,Indonesia,1996,1,1,2
Oman,Kuwait,1996,0,3,3
Jamaica,Guatemala,1996,2,0,2
Indonesia,India,1996,7,1,8
Syria,Kuwait,1996,0,2,2
Colombia,Honduras,1996,2,1,3
Malaysia,India,1996,5,2,7
Trinidad and Tobago,Haiti,1996,2,0,2
Bolivia,Peru,1996,2,0,2
Dominica,Antigua and Barbuda,1996,3,3,6
Turkmenistan,Kuwait,1996,2,2,4
Cyprus,Latvia,1996,1,0,1
Croatia,South Korea,1996,3,0,3
Luxembourg,Switzerland,1996,1,1,2
Kuwait,Finland,1996,0,1,1
Dominica,Saint Lucia,1996,0,1,1
United Arab Emirates,South Korea,1996,3,2,5
Egypt,Morocco,1996,0,2,2
Colombia,Trinidad and Tobago,1996,3,0,3
Kuwait,Turkmenistan,1996,2,0,2
United Arab Emirates,Egypt,1996,0,0,0
Curaçao,Grenada,1996,0,1,1
South Korea,Morocco,1996,2,2,4
Dominican Republic,Aruba,1996,3,2,5
French Guiana,Suriname,1996,1,2,3
Egypt,South Korea,1996,1,1,2
Croatia,Israel,1996,2,0,2
Czech Republic,Turkey,1996,3,0,3
United Arab Emirates,Morocco,1996,1,0,1
England,Bulgaria,1996,1,0,1
Austria,Switzerland,1996,1,0,1
Belgium,France,1996,0,2,2
Brazil,Ghana,1996,8,2,10
Cyprus,Georgia,1996,0,2,2
Germany,Denmark,1996,2,0,2
Guatemala,Venezuela,1996,3,0,3
Honduras,Nicaragua,1996,1,0,1
Republic of Ireland,Russia,1996,0,2,2
North Macedonia,Malta,1996,1,0,1
Northern Ireland,Norway,1996,0,2,2
Poland,Slovenia,1996,0,0,0
Portugal,Greece,1996,1,0,1
Scotland,Australia,1996,1,0,1
Serbia,Romania,1996,1,0,1
Slovakia,Belarus,1996,4,0,4
Saint Kitts and Nevis,Anguilla,1996,8,0,8
Colombia,Bolivia,1996,4,1,5
Guyana,Grenada,1996,1,2,3
Sint Maarten,Anguilla,1996,4,0,4
Antigua and Barbuda,Dominica,1996,1,3,4
Aruba,Dominican Republic,1996,1,3,4
Saint Kitts and Nevis,Sint Maarten,1996,3,0,3
Suriname,Jamaica,1996,0,1,1
Congo,DR Congo,1996,2,1,3
Grenada,Guyana,1996,6,0,6
Azerbaijan,Turkey,1996,0,1,1
Moldova,Ukraine,1996,2,2,4
Croatia,Hungary,1996,4,1,5
Suriname,French Guiana,1996,1,1,2
Ethiopia,Ghana,1996,2,0,2
Gambia,Senegal,1996,1,2,3
Jamaica,Suriname,1996,1,0,1
Paraguay,Bosnia and Herzegovina,1996,3,0,3
Qatar,Kuwait,1996,3,1,4
Saint Lucia,Dominica,1996,1,1,2
Argentina,Bolivia,1996,3,1,4
Belgium,Russia,1996,0,0,0
Bosnia and Herzegovina,Albania,1996,0,0,0
Colombia,Paraguay,1996,1,0,1
Czech Republic,Republic of Ireland,1996,2,0,2
Denmark,Scotland,1996,2,0,2
Ecuador,Peru,1996,4,1,5
England,Croatia,1996,0,0,0
Estonia,Iceland,1996,0,3,3
Greece,Slovenia,1996,2,0,2
Hungary,Austria,1996,0,2,2
Jamaica,Barbados,1996,2,0,2
North Macedonia,Liechtenstein,1996,3,0,3
Martinique,Saint Lucia,1996,1,0,1
Netherlands,Germany,1996,0,1,1
Northern Ireland,Sweden,1996,1,2,3
Norway,Spain,1996,0,0,0
Romania,Georgia,1996,5,0,5
Serbia,Faroe Islands,1996,3,1,4
Slovakia,Bulgaria,1996,0,0,0
South Africa,Brazil,1996,2,3,5
Switzerland,Wales,1996,2,0,2
Venezuela,Uruguay,1996,0,2,2
Cayman Islands,Cuba,1996,0,4,4
Haiti,Dominican Republic,1996,6,0,6
Turkmenistan,Iran,1996,1,1,2
Barbados,Jamaica,1996,2,0,2
DR Congo,Congo,1996,3,1,4
Haiti,Dominican Republic,1996,1,1,2
Saint Lucia,Martinique,1996,0,1,1
Suriname,Guyana,1996,2,1,3
Turkmenistan,Iran,1996,0,1,1
Israel,South Korea,1996,4,5,9
Poland,Belarus,1996,1,1,2
Turkey,Ukraine,1996,3,2,5
Dominican Republic,Curaçao,1996,2,1,3
El Salvador,Bolivia,1996,1,1,2
Guyana,Suriname,1996,2,1,3
Nicaragua,Guatemala,1996,0,1,1
Saint Kitts and Nevis,Saint Lucia,1996,5,1,6
Jersey,Guernsey,1996,0,0,0
Greece,Georgia,1996,2,1,3
Tajikistan,Uzbekistan,1996,4,0,4
Sweden,Slovakia,1996,2,1,3
Guatemala,Nicaragua,1996,2,1,3
Curaçao,Dominican Republic,1996,0,0,0
Malawi,Zambia,1996,0,1,1
Tahiti,Solomon Islands,1996,2,1,3
Burkina Faso,Niger,1996,0,0,0
Cayman Islands,Cuba,1996,0,1,1
Haiti,Grenada,1996,6,1,7
Lebanon,Turkmenistan,1996,3,1,4
Malawi,Zambia,1996,1,1,2
Eswatini,Mozambique,1996,0,1,1
Cayman Islands,Cuba,1996,0,5,5
Dominica,Barbados,1996,0,1,1
South Korea,Sweden,1996,0,2,2
Iran,Qatar,1996,2,0,2
Mauritania,Senegal,1996,0,0,0
England,Hungary,1996,3,0,3
Grenada,Haiti,1996,0,1,1
Mexico,Slovakia,1996,5,2,7
Barbados,Dominica,1996,1,0,1
Gambia,Guinea,1996,1,1,2
Guernsey,Jersey,1996,0,1,1
Saint Lucia,Saint Kitts and Nevis,1996,0,1,1
Zambia,Tanzania,1996,1,0,1
Slovenia,United Arab Emirates,1996,2,2,4
Zambia,Tanzania,1996,0,0,0
China PR,England,1996,0,3,3
Kuwait,Syria,1996,3,1,4
Mexico,Serbia,1996,0,0,0
Trinidad and Tobago,Jamaica,1996,1,0,1
Cuba,Saint Vincent and the Grenadines,1996,2,0,2
Martinique,Haiti,1996,1,0,1
Mauritius,Madagascar,1996,0,0,0
Qatar,Russia,1996,2,5,7
Uganda,Kenya,1996,1,1,2
Chile,Bolivia,1996,2,0,2
Gabon,Ivory Coast,1996,0,1,1
Ghana,Egypt,1996,0,2,2
Jamaica,Saint Kitts and Nevis,1996,4,1,5
Japan,Serbia,1996,1,0,1
Malawi,Mozambique,1996,1,0,1
Trinidad and Tobago,Suriname,1996,3,0,3
Tunisia,Senegal,1996,2,0,2
Turkmenistan,Lebanon,1996,0,1,1
Uganda,Kenya,1996,1,2,3
United States,Scotland,1996,2,1,3
Belarus,Azerbaijan,1996,2,2,4
Cuba,Martinique,1996,1,0,1
Bulgaria,North Macedonia,1996,3,0,3
Suriname,Jamaica,1996,3,1,4
Trinidad and Tobago,Saint Kitts and Nevis,1996,5,1,6
Austria,Czech Republic,1996,1,0,1
Colombia,Scotland,1996,1,0,1
Cuba,Haiti,1996,0,0,0
Estonia,Turkey,1996,0,0,0
France,Finland,1996,2,0,2
Republic of Ireland,Portugal,1996,0,1,1
Italy,Belgium,1996,2,2,4
Japan,Mexico,1996,3,2,5
Netherlands,China PR,1996,2,0,2
Northern Ireland,Germany,1996,1,1,2
Russia,United Arab Emirates,1996,1,0,1
Saint Kitts and Nevis,Suriname,1996,1,1,2
Mauritania,Burkina Faso,1996,0,0,0
Gambia,Liberia,1996,2,1,3
Germany,France,1996,0,1,1
Guinea-Bissau,Guinea,1996,3,2,5
Hungary,Italy,1996,0,2,2
Iceland,North Macedonia,1996,1,1,2
Malawi,South Africa,1996,0,1,1
Namibia,Mozambique,1996,2,0,2
Qatar,Iran,1996,0,1,1
Romania,Moldova,1996,3,1,4
Sudan,Zambia,1996,2,0,2
Sweden,Belarus,1996,5,1,6
Switzerland,Czech Republic,1996,1,2,3
Uganda,Angola,1996,0,2,2
Belize,Panama,1996,1,2,3
Bulgaria,United Arab Emirates,1996,4,1,5
Burundi,Sierra Leone,1996,1,0,1
Congo,Ivory Coast,1996,2,0,2
Denmark,Ghana,1996,1,0,1
Ecuador,Argentina,1996,2,0,2
Finland,Turkey,1996,1,2,3
Republic of Ireland,Croatia,1996,2,2,4
Kenya,Algeria,1996,3,1,4
Madagascar,Zimbabwe,1996,1,2,3
Mauritius,DR Congo,1996,1,5,6
Norway,Azerbaijan,1996,5,0,5
Peru,Colombia,1996,1,1,2
Russia,Poland,1996,2,0,2
Rwanda,Tunisia,1996,1,3,4
San Marino,Wales,1996,0,5,5
Serbia,Malta,1996,6,0,6
Eswatini,Gabon,1996,0,1,1
Togo,Senegal,1996,2,1,3
Trinidad and Tobago,Martinique,1996,2,1,3
Uruguay,Paraguay,1996,0,2,2
Venezuela,Chile,1996,1,1,2
Cuba,Suriname,1996,4,0,4
Oman,Bahrain,1996,3,0,3
Germany,Liechtenstein,1996,9,1,10
Netherlands,Republic of Ireland,1996,3,1,4
Canada,Costa Rica,1996,0,1,1
France,Armenia,1996,2,0,2
Iceland,Cyprus,1996,2,1,3
Martinique,Suriname,1996,1,1,2
Trinidad and Tobago,Cuba,1996,2,0,2
England,Switzerland,1996,1,1,2
Mexico,Bolivia,1996,1,0,1
Tanzania,Ghana,1996,0,0,0
Denmark,Portugal,1996,1,1,2
Germany,Czech Republic,1996,2,0,2
Ivory Coast,Burkina Faso,1996,1,1,2
Lebanon,Kuwait,1996,3,5,8
Nigeria,Togo,1996,1,3,4
Panama,Belize,1996,4,1,5
Spain,Bulgaria,1996,1,1,2
United States,Republic of Ireland,1996,2,1,3
Cuba,Haiti,1996,6,1,7
Iran,Nepal,1996,8,0,8
Netherlands,Scotland,1996,0,0,0
Romania,France,1996,0,1,1
Sri Lanka,Oman,1996,0,3,3
Italy,Russia,1996,2,1,3
Turkey,Croatia,1996,0,1,1
Iran,Sri Lanka,1996,7,0,7
Mexico,Republic of Ireland,1996,2,2,4
Nepal,Oman,1996,0,7,7
Tanzania,Sudan,1996,0,0,0
United States,Bolivia,1996,0,2,2
Barbados,Trinidad and Tobago,1996,0,4,4
Bulgaria,Romania,1996,1,0,1
Switzerland,Netherlands,1996,0,2,2
Algeria,Kenya,1996,1,0,1
Czech Republic,Italy,1996,2,1,3
Iran,Oman,1996,2,0,2
Kazakhstan,Qatar,1996,1,0,1
Portugal,Turkey,1996,1,0,1
Sri Lanka,Nepal,1996,3,1,4
Bolivia,Republic of Ireland,1996,0,3,3
Dominican Republic,Trinidad and Tobago,1996,1,4,5
England,Scotland,1996,2,0,2
France,Spain,1996,1,1,2
Senegal,Togo,1996,1,1,2
South Africa,Malawi,1996,3,0,3
Angola,Uganda,1996,3,1,4
Burkina Faso,Mauritania,1996,2,0,2
DR Congo,Mauritius,1996,2,0,2
Croatia,Denmark,1996,3,0,3
Gabon,Eswatini,1996,2,0,2
Guinea,Guinea-Bissau,1996,3,1,4
Ivory Coast,Congo,1996,1,1,2
Mozambique,Namibia,1996,1,1,2
Russia,Germany,1996,0,3,3
Sierra Leone,Burundi,1996,0,1,1
Tunisia,Rwanda,1996,2,0,2
United States,Mexico,1996,2,2,4
Zambia,Sudan,1996,3,0,3
Zimbabwe,Madagascar,1996,2,2,4
Ghana,Tanzania,1996,2,1,3
Oman,Nepal,1996,2,1,3
Sri Lanka,Iran,1996,0,4,4
England,Netherlands,1996,4,1,5
France,Bulgaria,1996,3,1,4
Romania,Spain,1996,1,2,3
Scotland,Switzerland,1996,1,0,1
Croatia,Portugal,1996,0,3,3
Italy,Germany,1996,0,0,0
Nepal,Iran,1996,0,4,4
Oman,Sri Lanka,1996,10,0,10
Russia,Czech Republic,1996,3,3,6
Turkey,Denmark,1996,0,3,3
Uzbekistan,Tajikistan,1996,5,0,5
Kuwait,Lebanon,1996,0,0,0
Peru,Armenia,1996,4,0,4
Nepal,Sri Lanka,1996,0,2,2
Oman,Iran,1996,1,2,3
Syria,Kazakhstan,1996,2,0,2
England,Spain,1996,0,0,0
France,Netherlands,1996,0,0,0
Honduras,Venezuela,1996,1,0,1
Barbados,Jamaica,1996,0,1,1
Czech Republic,Portugal,1996,1,0,1
Germany,Croatia,1996,2,1,3
Liberia,Gambia,1996,4,0,4
Saint Kitts and Nevis,Saint Vincent and the Grenadines,1996,2,2,4
Trinidad and Tobago,Dominican Republic,1996,8,0,8
Paraguay,Armenia,1996,1,2,3
England,Germany,1996,1,1,2
France,Czech Republic,1996,0,0,0
Myanmar,Singapore,1996,0,4,4
Thailand,Maldives,1996,8,0,8
China PR,New Zealand,1996,2,0,2
Qatar,Syria,1996,1,0,1
Maldives,Singapore,1996,0,2,2
Thailand,Myanmar,1996,5,1,6
Czech Republic,Germany,1996,1,2,3
Ecuador,Armenia,1996,3,0,3
Haiti,Cuba,1996,1,1,2
Jamaica,Barbados,1996,2,0,2
Saint Vincent and the Grenadines,Saint Kitts and Nevis,1996,0,0,0
Myanmar,Maldives,1996,3,1,4
Thailand,Singapore,1996,1,1,2
Maldives,Thailand,1996,0,8,8
Singapore,Myanmar,1996,2,2,4
Qatar,Kazakhstan,1996,3,0,3
Chile,Ecuador,1996,4,1,5
Malawi,Tanzania,1996,3,2,5
Bolivia,Venezuela,1996,6,1,7
Myanmar,Thailand,1996,1,7,8
Colombia,Uruguay,1996,3,1,4
Estonia,Latvia,1996,1,1,2
Peru,Argentina,1996,0,0,0
Singapore,Maldives,1996,5,2,7
Latvia,Lithuania,1996,1,2,3
Malawi,Tanzania,1996,1,0,1
Myanmar,Maldives,1996,4,1,5
Estonia,Lithuania,1996,1,1,2
Singapore,Thailand,1996,2,2,4
Malawi,Tanzania,1996,1,1,2
Kazakhstan,Syria,1996,0,1,1
China PR,Uruguay,1996,1,1,2
Syria,Qatar,1996,3,1,4
Panama,Venezuela,1996,0,2,2
Honduras,Panama,1996,1,1,2
Paraguay,Bolivia,1996,2,0,2
Honduras,Trinidad and Tobago,1996,0,0,0
Jamaica,Panama,1996,0,0,0
Panama,Trinidad and Tobago,1996,1,0,1
Belarus,Lithuania,1996,2,2,4
Costa Rica,Honduras,1996,1,1,2
Guatemala,Panama,1996,1,0,1
Vietnam,Taiwan,1996,4,1,5
South Korea,Guam,1996,9,0,9
Panama,Honduras,1996,2,1,3
Vietnam,Guam,1996,9,0,9
Benin,Mauritania,1996,4,1,5
China PR,Paraguay,1996,0,2,2
South Korea,Taiwan,1996,4,0,4
Jordan,Pakistan,1996,4,0,4
Botswana,Namibia,1996,0,0,0
Congo,Togo,1996,0,0,0
Honduras,Costa Rica,1996,0,0,0
Iraq,Pakistan,1996,3,0,3
Mauritius,Seychelles,1996,1,0,1
Uganda,Ethiopia,1996,1,1,2
Vietnam,South Korea,1996,0,4,4
Jordan,Iraq,1996,0,1,1
Ukraine,Lithuania,1996,5,2,7
Greece,Albania,1996,2,1,3
Honduras,El Salvador,1996,2,1,3
Hungary,United Arab Emirates,1996,3,1,4
Iceland,Malta,1996,2,1,3
Latvia,Finland,1996,0,0,0
Panama,Guatemala,1996,1,0,1
Peru,Costa Rica,1996,3,0,3
Romania,Israel,1996,2,0,2
Sweden,Denmark,1996,0,1,1
Turkey,Moldova,1996,2,0,2
Ecuador,Costa Rica,1996,1,1,2
Rwanda,Uganda,1996,0,0,0
Guatemala,Honduras,1996,1,1,2
Belarus,United Arab Emirates,1996,0,1,1
Oman,Mali,1996,1,0,1
Togo,Benin,1996,2,0,2
El Salvador,Honduras,1996,1,2,3
Oman,Mali,1996,1,1,2
Panama,Jamaica,1996,2,0,2
Seychelles,Mauritius,1996,1,1,2
Ethiopia,Uganda,1996,1,1,2
Honduras,Cuba,1996,4,0,4
Japan,Uruguay,1996,5,3,8
Namibia,Botswana,1996,6,0,6
Togo,Congo,1996,1,0,1
Guatemala,Jamaica,1996,2,1,3
Poland,Cyprus,1996,2,2,4
Honduras,Cuba,1996,2,2,4
Oman,Sudan,1996,0,0,0
Russia,Brazil,1996,2,2,4
Morocco,DR Congo,1996,7,0,7
Canada,Panama,1996,3,1,4
Guatemala,Cuba,1996,1,1,2
Mauritania,Benin,1996,0,0,0
United States,El Salvador,1996,3,1,4
Armenia,Portugal,1996,0,0,0
Austria,Scotland,1996,0,0,0
Azerbaijan,Switzerland,1996,1,0,1
Belarus,Estonia,1996,1,0,1
Belgium,Turkey,1996,2,1,3
Faroe Islands,Slovakia,1996,1,2,3
France,Mexico,1996,2,0,2
Liechtenstein,Republic of Ireland,1996,0,5,5
Netherlands,Brazil,1996,2,2,4
Northern Ireland,Ukraine,1996,0,1,1
Oman,Sudan,1996,0,1,1
Romania,Lithuania,1996,3,0,3
Wales,San Marino,1996,6,0,6
Argentina,Paraguay,1996,1,1,2
Bolivia,Peru,1996,0,0,0
Colombia,Chile,1996,4,1,5
Ecuador,Venezuela,1996,1,0,1
Greece,Bosnia and Herzegovina,1996,3,0,3
Hungary,Finland,1996,1,0,1
Israel,Bulgaria,1996,2,1,3
Latvia,Sweden,1996,1,2,3
Moldova,England,1996,0,3,3
Norway,Georgia,1996,1,0,1
Russia,Cyprus,1996,4,0,4
Singapore,Malaysia,1996,1,1,2
Slovenia,Denmark,1996,0,2,2
Trinidad and Tobago,Costa Rica,1996,0,1,1
Cambodia,Vietnam,1996,1,3,4
Laos,Indonesia,1996,1,5,6
Philippines,Thailand,1996,0,5,5
Czech Republic,Iceland,1996,2,1,3
Faroe Islands,Spain,1996,2,6,8
Jamaica,Costa Rica,1996,2,0,2
Malaysia,Philippines,1996,7,0,7
Poland,Germany,1996,0,2,2
Singapore,Brunei,1996,3,0,3
Myanmar,Cambodia,1996,5,0,5
Laos,Vietnam,1996,1,1,2
Lebanon,Oman,1996,1,2,3
Singapore,Philippines,1996,3,0,3
Thailand,Brunei,1996,6,0,6
Myanmar,Vietnam,1996,1,4,5
Indonesia,Cambodia,1996,3,0,3
Brunei,Philippines,1996,1,0,1
El Salvador,Cuba,1996,5,0,5
Thailand,Malaysia,1996,1,1,2
Indonesia,Myanmar,1996,6,1,7
Laos,Cambodia,1996,1,0,1
Brunei,Malaysia,1996,0,6,6
Singapore,Thailand,1996,0,1,1
Japan,Uzbekistan,1996,1,0,1
Laos,Myanmar,1996,2,4,6
Vietnam,Indonesia,1996,1,1,2
Malaysia,Indonesia,1996,3,1,4
Thailand,Vietnam,1996,4,2,6
Australia,Ghana,1996,2,0,2
South Africa,Kenya,1996,1,0,1
Indonesia,Vietnam,1996,2,3,5
Jamaica,Honduras,1996,3,0,3
Senegal,Mali,1996,1,0,1
Thailand,Malaysia,1996,1,0,1
Papua New Guinea,Solomon Islands,1996,1,1,2
Oman,Zambia,1996,0,0,0
Czech Republic,Malta,1996,6,0,6
Ghana,Kenya,1996,1,0,1
Romania,United Arab Emirates,1996,1,2,3
Solomon Islands,Vanuatu,1996,1,1,2
South Africa,Australia,1996,2,0,2
El Salvador,Venezuela,1996,0,1,1
Papua New Guinea,Vanuatu,1996,2,1,3
Qatar,Sri Lanka,1996,3,0,3
Australia,Kenya,1996,4,0,4
Honduras,Mexico,1996,2,1,3
India,Philippines,1996,2,0,2
South Africa,Ghana,1996,0,0,0
Guinea,Gabon,1996,0,1,1
Panama,Cuba,1996,1,3,4
Saudi Arabia,Zambia,1996,2,1,3
Slovakia,Malta,1996,6,0,6
Mali,Guinea,1996,0,0,0
Qatar,Philippines,1996,5,0,5
Sri Lanka,India,1996,1,1,2
El Salvador,Guatemala,1996,2,1,3
South Korea,China PR,1996,3,1,4
Oman,Mozambique,1996,0,2,2
Poland,United Arab Emirates,1996,1,0,1
Saudi Arabia,Zambia,1996,1,3,4
Syria,Sudan,1996,1,2,3
Philippines,Sri Lanka,1996,0,3,3
Qatar,India,1996,6,0,6
Gabon,Mali,1996,1,1,2
Oman,New Zealand,1996,0,1,1
Syria,Sudan,1996,1,0,1
Zimbabwe,Tanzania,1996,1,0,1
Oman,New Zealand,1996,1,2,3
Lebanon,Bahrain,1996,2,3,5
Saudi Arabia,New Zealand,1996,3,0,3
Ecuador,Jamaica,1996,2,1,3
Kuwait,Iran,1996,0,1,1
Estonia,Belarus,1996,1,0,1
Latvia,Scotland,1996,0,2,2
Lithuania,Iceland,1996,2,0,2
Moldova,Italy,1996,1,3,4
Northern Ireland,Armenia,1996,1,1,2
Qatar,New Zealand,1996,3,2,5
Togo,Tanzania,1996,2,1,3
Ukraine,Portugal,1996,2,1,3
Wales,Netherlands,1996,1,3,4
Algeria,Ivory Coast,1996,4,1,5
Benin,Mali,1996,1,2,3
Central African Republic,Guinea,1996,2,3,5
DR Congo,Liberia,1996,0,0,0
Ethiopia,Senegal,1996,1,2,3
Faroe Islands,Serbia,1996,1,8,9
Finland,Switzerland,1996,2,3,5
Gabon,Cameroon,1996,0,0,0
Ghana,Angola,1996,2,1,3
Mauritius,Malawi,1996,1,2,3
Panama,El Salvador,1996,1,1,2
Sudan,Zimbabwe,1996,0,3,3
Trinidad and Tobago,Guatemala,1996,1,1,2
Tunisia,Sierra Leone,1996,2,0,2
Zambia,Mozambique,1996,1,0,1
Oman,Azerbaijan,1996,2,0,2
Bosnia and Herzegovina,Croatia,1996,1,4,5
Kuwait,Cyprus,1996,1,1,2
Luxembourg,Bulgaria,1996,1,2,3
Uruguay,Bolivia,1996,1,0,1
Albania,Portugal,1996,0,3,3
Armenia,Germany,1996,1,5,6
Belarus,Latvia,1996,1,1,2
Costa Rica,Jamaica,1996,0,0,0
Czech Republic,Spain,1996,0,0,0
Denmark,Greece,1996,2,1,3
Ecuador,Colombia,1996,0,1,1
England,Poland,1996,2,1,3
France,Turkey,1996,4,0,4
Iceland,Romania,1996,0,4,4
Republic of Ireland,North Macedonia,1996,3,0,3
Israel,Russia,1996,1,1,2
Italy,Georgia,1996,1,0,1
Lebanon,New Zealand,1996,1,1,2
Lithuania,Liechtenstein,1996,2,1,3
Norway,Hungary,1996,3,0,3
Paraguay,Chile,1996,2,1,3
San Marino,Belgium,1996,0,3,3
Saudi Arabia,Australia,1996,0,0,0
Sweden,Austria,1996,0,1,1
Venezuela,Argentina,1996,2,5,7
Canada,Cuba,1996,2,0,2
Canada,Cuba,1996,2,0,2
Japan,Tunisia,1996,1,0,1
Oman,Saudi Arabia,1996,0,1,1
Brazil,Lithuania,1996,3,1,4
Kuwait,Bahrain,1996,1,0,1
Mexico,Jamaica,1996,2,1,3
Peru,United States,1996,4,1,5
United Arab Emirates,Qatar,1996,0,1,1
Oman,Kuwait,1996,1,2,3
United Arab Emirates,Bahrain,1996,1,1,2
Gabon,Burkina Faso,1996,2,0,2
Qatar,Saudi Arabia,1996,2,2,4
Honduras,El Salvador,1996,1,1,2
Oman,Qatar,1996,0,3,3
Saudi Arabia,Bahrain,1996,3,1,4
Kuwait,United Arab Emirates,1996,1,2,3
Mexico,Ecuador,1996,0,1,1
Slovakia,Faroe Islands,1996,3,0,3
Kuwait,Saudi Arabia,1996,1,0,1
Oman,United Arab Emirates,1996,0,0,0
Bahrain,Qatar,1996,1,2,3
Honduras,Jamaica,1996,0,0,0
Panama,Canada,1996,0,0,0
Tahiti,Australia,1996,0,6,6
United Arab Emirates,Saudi Arabia,1996,2,2,4
Oman,Bahrain,1996,1,1,2
Qatar,Kuwait,1996,1,2,3
Finland,Estonia,1996,2,2,4
Indonesia,Moldova,1996,1,2,3
Australia,Tahiti,1996,5,0,5
Honduras,Colombia,1996,1,2,3
Canada,El Salvador,1996,1,0,1
Lithuania,Indonesia,1996,4,0,4
Togo,Gabon,1996,0,1,1
United States,Guatemala,1996,2,0,2
Bosnia and Herzegovina,Italy,1996,2,1,3
Mexico,Honduras,1996,3,1,4
Saudi Arabia,Bulgaria,1996,1,0,1
Costa Rica,Panama,1996,2,0,2
Uganda,Rwanda,1996,3,2,5
Egypt,Namibia,1996,7,1,8
Thailand,Bulgaria,1996,0,4,4
Uganda,Rwanda,1996,1,1,2
Albania,Armenia,1996,1,1,2
Austria,Latvia,1996,2,1,3
Denmark,France,1996,1,0,1
Georgia,England,1996,0,2,2
Germany,Northern Ireland,1996,1,1,2
Liechtenstein,North Macedonia,1996,1,11,12
Morocco,Sierra Leone,1996,4,0,4
Netherlands,Wales,1996,7,1,8
Nigeria,Burkina Faso,1996,2,0,2
Portugal,Ukraine,1996,1,0,1
South Africa,DR Congo,1996,1,0,1
Angola,Zimbabwe,1996,2,1,3
Azerbaijan,Hungary,1996,0,3,3
Bolivia,Colombia,1996,2,2,4
Congo,Zambia,1996,1,0,1
Croatia,Greece,1996,1,1,2
Cyprus,Israel,1996,2,0,2
El Salvador,Panama,1996,3,2,5
Gabon,Ghana,1996,1,1,2
Guinea,Kenya,1996,3,1,4
Republic of Ireland,Iceland,1996,0,0,0
Liberia,Tunisia,1996,0,1,1
Luxembourg,Russia,1996,0,4,4
Paraguay,Ecuador,1996,1,0,1
Peru,Venezuela,1996,4,1,5
Poland,Moldova,1996,2,1,3
Scotland,Sweden,1996,1,0,1
Serbia,Czech Republic,1996,1,0,1
Slovenia,Bosnia and Herzegovina,1996,1,2,3
Switzerland,Norway,1996,0,1,1
Togo,Cameroon,1996,2,4,6
Turkey,San Marino,1996,7,0,7
United States,Trinidad and Tobago,1996,2,0,2
Tonga,Cook Islands,1996,2,0,2
Chile,Uruguay,1996,1,0,1
Andorra,Estonia,1996,1,6,7
Brazil,Cameroon,1996,2,0,2
Lebanon,Iran,1996,0,0,0
Samoa,Cook Islands,1996,2,1,3
Spain,Slovakia,1996,4,1,5
Tonga,Samoa,1996,1,0,1
United Arab Emirates,Malta,1996,0,0,0
Estonia,Indonesia,1996,3,0,3
Saudi Arabia,Syria,1996,3,1,4
Costa Rica,Guatemala,1996,3,0,3
Jamaica,Mexico,1996,1,0,1
Sudan,Uganda,1996,1,1,2
Kenya,Rwanda,1996,2,1,3
Kuwait,Syria,1996,2,2,4
Saudi Arabia,Mali,1996,1,3,4
United Arab Emirates,Uzbekistan,1996,4,2,6
El Salvador,Mexico,1996,1,3,4
Kuwait,Mali,1996,4,2,6
Rwanda,Zanzibar,1996,1,1,2
Tanzania,Uganda,1996,0,1,1
United Arab Emirates,Uzbekistan,1996,2,0,2
South Korea,Colombia,1996,4,1,5
Guatemala,Costa Rica,1996,1,0,1
Indonesia,Iraq,1996,0,4,4
Kenya,Zanzibar,1996,1,0,1
Mali,Burkina Faso,1996,2,0,2
Sudan,Tanzania,1996,3,2,5
Trinidad and Tobago,United States,1996,0,1,1
Iran,Turkmenistan,1996,0,1,1
China PR,South Korea,1996,2,3,5
United Arab Emirates,Syria,1996,1,1,2
Malta,North Macedonia,1996,0,2,2
Uganda,Kenya,1996,2,0,2
United Arab Emirates,Syria,1996,1,0,1
Saudi Arabia,Indonesia,1996,4,1,5
Sudan,Kenya,1996,1,1,2
Costa Rica,United States,1996,2,1,3
El Salvador,Cuba,1996,3,0,3
Indonesia,Kuwait,1996,2,2,4
United Arab Emirates,South Korea,1996,1,1,2
Iran,Iraq,1996,1,2,3
Lebanon,Georgia,1996,4,2,6
Saudi Arabia,Thailand,1996,6,0,6
China PR,Uzbekistan,1996,0,2,2
Japan,Syria,1996,2,1,3
South Korea,Indonesia,1996,4,2,6
United Arab Emirates,Kuwait,1996,3,2,5
Guatemala,Trinidad and Tobago,1996,2,1,3
Lebanon,Georgia,1996,3,2,5
Saudi Arabia,Iraq,1996,1,0,1
Thailand,Iran,1996,1,3,4
Japan,Uzbekistan,1996,4,0,4
Syria,China PR,1996,0,3,3
Kuwait,South Korea,1996,2,0,2
United Arab Emirates,Indonesia,1996,2,0,2
Czech Republic,Nigeria,1996,2,1,3
Iraq,Thailand,1996,4,1,5
Morocco,Croatia,1996,2,2,4
Saudi Arabia,Iran,1996,0,3,3
Croatia,Czech Republic,1996,1,1,2
Japan,China PR,1996,1,0,1
Morocco,Nigeria,1996,2,0,2
Uzbekistan,Syria,1996,1,2,3
Belgium,Netherlands,1996,0,3,3
Cyprus,Bulgaria,1996,1,3,4
Kenya,Zambia,1996,1,0,1
North Macedonia,Romania,1996,0,3,3
Northern Ireland,Albania,1996,2,0,2
Portugal,Germany,1996,0,0,0
Spain,Serbia,1996,2,0,2
United States,Costa Rica,1996,2,1,3
Wales,Turkey,1996,0,0,0
Argentina,Chile,1996,1,1,2
Bolivia,Paraguay,1996,0,0,0
El Salvador,Canada,1996,0,2,2
Israel,Luxembourg,1996,1,0,1
Kenya,Zambia,1996,0,2,2
Kuwait,Japan,1996,2,0,2
Panama,Cuba,1996,3,1,4
United Arab Emirates,Iraq,1996,1,0,1
Uruguay,Peru,1996,2,0,2
Venezuela,Colombia,1996,0,2,2
South Korea,Iran,1996,2,6,8
Saudi Arabia,China PR,1996,4,3,7
Brazil,Bosnia and Herzegovina,1996,1,0,1
Malta,Spain,1996,0,3,3
Iran,Saudi Arabia,1996,0,0,0
United Arab Emirates,Kuwait,1996,1,0,1
Burkina Faso,Gabon,1996,1,1,2
Costa Rica,Trinidad and Tobago,1996,2,1,3
Guatemala,United States,1996,2,2,4
Iran,Kuwait,1996,1,1,2
United Arab Emirates,Saudi Arabia,1996,0,0,0
Zimbabwe,Tanzania,1996,2,2,4
Benin,Gabon,1996,3,3,6
Burkina Faso,Ghana,1996,2,1,3
Benin,Ghana,1996,1,1,2
Benin,Burkina Faso,1996,1,1,2
Gabon,Ghana,1996,1,1,2
Basque Country,Estonia,1996,3,1,4
Benin,Burkina Faso,1996,0,0,0
Argentina,Serbia,1996,2,3,5
Chile,Armenia,1997,7,0,7
Tunisia,Algeria,1997,0,0,0
Egypt,Belarus,1997,2,0,2
Paraguay,Armenia,1997,2,0,2
Togo,Ghana,1997,4,0,4
Ivory Coast,Guinea,1997,2,1,3
Namibia,Liberia,1997,0,0,0
Sierra Leone,Gabon,1997,1,0,1
Zambia,South Africa,1997,0,0,0
Bolivia,Ecuador,1997,2,0,2
Burkina Faso,Guinea,1997,0,2,2
Cameroon,Angola,1997,0,0,0
DR Congo,Congo,1997,1,1,2
Ghana,Morocco,1997,2,2,4
Kenya,Nigeria,1997,1,1,2
Lebanon,Algeria,1997,2,2,4
Peru,Chile,1997,2,1,3
Tunisia,Egypt,1997,1,0,1
Uruguay,Argentina,1997,0,0,0
Venezuela,Paraguay,1997,0,2,2
Zimbabwe,Togo,1997,3,0,3
United States,Peru,1997,0,1,1
Australia,New Zealand,1997,1,0,1
South Korea,Norway,1997,1,0,1
Benin,Togo,1997,1,1,2
Mozambique,Zimbabwe,1997,1,2,3
United States,Mexico,1997,0,2,2
Australia,South Korea,1997,2,1,3
Israel,Greece,1997,1,1,2
Italy,Northern Ireland,1997,2,0,2
Mexico,Peru,1997,0,0,0
New Zealand,Norway,1997,0,3,3
Portugal,France,1997,0,2,2
Australia,Norway,1997,1,0,1
South Korea,New Zealand,1997,3,1,4
Malawi,Zambia,1997,0,2,2
Cameroon,Namibia,1997,4,0,4
Chile,Honduras,1997,3,2,5
Guinea,Tunisia,1997,1,0,1
Ivory Coast,Benin,1997,1,0,1
Lebanon,Estonia,1997,2,0,2
Liberia,Togo,1997,1,2,3
Mali,Algeria,1997,1,0,1
Mozambique,Mauritius,1997,3,0,3
Eswatini,Lesotho,1997,3,1,4
Tanzania,DR Congo,1997,1,2,3
Zimbabwe,Ghana,1997,0,0,0
China PR,United States,1997,2,1,3
China PR,United States,1997,1,1,2
Bolivia,Slovakia,1997,0,1,1
Lebanon,Jordan,1997,1,0,1
Costa Rica,Slovakia,1997,2,2,4
Mexico,Ecuador,1997,3,1,4
Jordan,Lebanon,1997,0,0,0
Russia,Serbia,1997,1,1,2
Colombia,Slovakia,1997,1,0,1
Lebanon,Jordan,1997,0,0,0
Thailand,Japan,1997,1,1,2
Russia,Switzerland,1997,2,1,3
Estonia,Scotland,1997,0,0,0
Northern Ireland,Belgium,1997,3,0,3
Thailand,Sweden,1997,0,0,0
Wales,Republic of Ireland,1997,0,0,0
Bolivia,Chile,1997,1,1,2
Colombia,Argentina,1997,0,1,1
Ecuador,Uruguay,1997,4,0,4
England,Italy,1997,0,1,1
Jamaica,Venezuela,1997,0,0,0
Paraguay,Peru,1997,2,1,3
Spain,Malta,1997,4,0,4
Turkey,Finland,1997,1,1,2
Japan,Sweden,1997,0,1,1
Cyprus,Latvia,1997,2,0,2
Lithuania,Poland,1997,0,0,0
Cyprus,Poland,1997,2,3,5
Latvia,Lithuania,1997,1,0,1
Tonga,Solomon Islands,1997,0,4,4
Iraq,Jordan,1997,1,0,1
Senegal,Mali,1997,1,1,2
Thailand,Sweden,1997,1,3,4
Cyprus,Lithuania,1997,1,0,1
Fiji,Solomon Islands,1997,1,2,3
Latvia,Poland,1997,2,3,5
Kuwait,Egypt,1997,2,0,2
Costa Rica,Venezuela,1997,5,2,7
Greece,Portugal,1997,0,0,0
Guyana,French Guiana,1997,2,0,2
Botswana,Eswatini,1997,0,0,0
China PR,Singapore,1997,3,1,4
Fiji,Solomon Islands,1997,3,2,5
Jamaica,Bermuda,1997,1,0,1
Malaysia,Finland,1997,2,1,3
Bosnia and Herzegovina,Vietnam,1997,4,0,4
Hong Kong,South Korea,1997,0,2,2
Indonesia,Zimbabwe,1997,0,0,0
Benin,Algeria,1997,1,1,2
Botswana,Lesotho,1997,1,4,5
China PR,Finland,1997,2,1,3
Ethiopia,Egypt,1997,1,1,2
Guyana,French Guiana,1997,2,2,4
Jamaica,Bermuda,1997,3,2,5
Malaysia,Singapore,1997,0,0,0
Mali,Ivory Coast,1997,1,2,3
Mauritius,Zambia,1997,0,0,0
Tanzania,Liberia,1997,1,1,2
Togo,DR Congo,1997,1,1,2
Zimbabwe,Angola,1997,1,0,1
Bosnia and Herzegovina,Zimbabwe,1997,2,2,4
Indonesia,Vietnam,1997,1,0,1
Malaysia,China PR,1997,0,2,2
Singapore,Finland,1997,0,1,1
Bosnia and Herzegovina,Indonesia,1997,2,0,2
Brazil,Poland,1997,4,2,6
France,Netherlands,1997,2,1,3
Israel,Germany,1997,0,1,1
Vietnam,Zimbabwe,1997,0,6,6
China PR,Zimbabwe,1997,3,1,4
Malaysia,Bosnia and Herzegovina,1997,0,1,1
Azerbaijan,Estonia,1997,0,2,2
Botswana,Malawi,1997,1,4,5
Solomon Islands,Tonga,1997,9,0,9
Bosnia and Herzegovina,China PR,1997,0,3,3
Jamaica,United States,1997,0,0,0
Lesotho,Zambia,1997,0,2,2
Mexico,Canada,1997,4,0,4
Saudi Arabia,Syria,1997,3,0,3
Thailand,South Korea,1997,1,3,4
Eswatini,Mozambique,1997,0,4,4
Aruba,Curaçao,1997,2,1,3
Bahrain,Oman,1997,1,0,1
Costa Rica,Cameroon,1997,5,0,5
Saudi Arabia,Indonesia,1997,2,0,2
Thailand,Hong Kong,1997,2,0,2
Cyprus,Greece,1997,0,4,4
Czech Republic,Poland,1997,2,1,3
Israel,Sweden,1997,0,1,1
North Macedonia,Australia,1997,0,1,1
Martinique,Saint Lucia,1997,1,0,1
Saudi Arabia,Indonesia,1997,3,1,4
Serbia,Russia,1997,0,0,0
El Salvador,Guatemala,1997,0,0,0
Saint Lucia,Saint Vincent and the Grenadines,1997,3,2,5
Thailand,Japan,1997,3,1,4
Costa Rica,Mexico,1997,0,0,0
Malaysia,Bangladesh,1997,2,0,2
Namibia,Zimbabwe,1997,2,1,3
United States,Canada,1997,3,0,3
Austria,Slovenia,1997,0,2,2
Bangladesh,Taiwan,1997,1,3,4
Kuwait,Bahrain,1997,3,1,4
Malaysia,Saudi Arabia,1997,0,0,0
Malta,Hungary,1997,1,4,5
United Arab Emirates,Lebanon,1997,2,1,3
Bangladesh,Saudi Arabia,1997,1,4,5
Malaysia,Taiwan,1997,2,0,2
Azerbaijan,Turkmenistan,1997,3,0,3
Bolivia,Jamaica,1997,6,0,6
Costa Rica,United States,1997,3,2,5
Nepal,Macau,1997,1,1,2
Oman,Japan,1997,0,1,1
Panama,Belize,1997,1,1,2
Guatemala,Ecuador,1997,0,0,0
Macau,Japan,1997,0,10,10
Oman,Nepal,1997,1,0,1
Nepal,Japan,1997,0,6,6
Oman,Macau,1997,4,0,4
Saudi Arabia,Bangladesh,1997,3,0,3
Albania,Ukraine,1997,0,1,1
Croatia,Denmark,1997,1,1,2
Cyprus,Russia,1997,1,1,2
England,Mexico,1997,2,0,2
Italy,Moldova,1997,3,0,3
Netherlands,San Marino,1997,4,0,4
Northern Ireland,Portugal,1997,0,0,0
Romania,Liechtenstein,1997,8,0,8
Saudi Arabia,Malaysia,1997,3,0,3
Scotland,Estonia,1997,2,0,2
Sierra Leone,Senegal,1997,2,1,3
Tanzania,Burkina Faso,1997,3,2,5
United Arab Emirates,Norway,1997,1,4,5
Wales,Belgium,1997,1,2,3
Belize,Panama,1997,0,1,1
China PR,Iraq,1997,0,2,2
Gabon,Togo,1997,2,1,3
Georgia,Armenia,1997,7,0,7
Hong Kong,Thailand,1997,3,2,5
Bangladesh,Malaysia,1997,0,1,1
Luxembourg,Israel,1997,0,3,3
Malta,Slovakia,1997,0,2,2
Saudi Arabia,Taiwan,1997,6,0,6
India,China PR,1997,0,0,0
Albania,Germany,1997,2,3,5
Azerbaijan,Finland,1997,1,2,3
Barbados,Grenada,1997,1,1,2
Bolivia,Argentina,1997,2,1,3
Bosnia and Herzegovina,Greece,1997,0,1,1
Brazil,Chile,1997,4,0,4
Bulgaria,Cyprus,1997,4,1,5
Croatia,Slovenia,1997,3,3,6
Czech Republic,Serbia,1997,1,2,3
Dominica,British Virgin Islands,1997,6,1,7
France,Sweden,1997,1,0,1
Hungary,Australia,1997,1,3,4
Lithuania,Romania,1997,0,1,1
North Macedonia,Republic of Ireland,1997,3,2,5
Paraguay,Colombia,1997,2,1,3
Peru,Ecuador,1997,1,1,2
Poland,Italy,1997,0,0,0
Scotland,Austria,1997,2,0,2
Sint Maarten,Anguilla,1997,3,0,3
Switzerland,Latvia,1997,1,0,1
Trinidad and Tobago,Guyana,1997,3,0,3
Turkey,Netherlands,1997,1,0,1
Ukraine,Northern Ireland,1997,2,1,3
Uruguay,Venezuela,1997,3,1,4
China PR,Ghana,1997,0,0,0
British Virgin Islands,Anguilla,1997,4,2,6
Dominica,Sint Maarten,1997,1,0,1
Grenada,Guyana,1997,5,1,6
Trinidad and Tobago,Barbados,1997,0,1,1
Nigeria,Guinea,1997,2,1,3
Sierra Leone,Ghana,1997,1,1,2
Angola,Togo,1997,3,1,4
Cameroon,Zimbabwe,1997,1,0,1
Canada,El Salvador,1997,0,0,0
Congo,South Africa,1997,2,0,2
Dominica,Anguilla,1997,5,0,5
Gabon,Morocco,1997,0,4,4
Guyana,Barbados,1997,0,2,2
India,Iraq,1997,0,1,1
Indonesia,Cambodia,1997,8,0,8
Kenya,Burkina Faso,1997,4,3,7
Liberia,Egypt,1997,1,0,1
Namibia,Tunisia,1997,1,2,3
Sint Maarten,British Virgin Islands,1997,3,2,5
Trinidad and Tobago,Grenada,1997,2,3,5
India,Ghana,1997,2,2,4
Jordan,United Arab Emirates,1997,0,0,0
DR Congo,Zambia,1997,2,2,4
India,Iraq,1997,1,1,2
Bahrain,United Arab Emirates,1997,1,2,3
India,China PR,1997,1,2,3
Kuwait,Iran,1997,0,2,2
Malawi,Mozambique,1997,2,2,4
El Salvador,Guatemala,1997,1,1,2
Indonesia,Yemen,1997,0,0,0
Lebanon,Singapore,1997,1,1,2
Mexico,Jamaica,1997,6,0,6
Bahrain,Jordan,1997,1,0,1
Guatemala,Costa Rica,1997,1,1,2
Honduras,Panama,1997,5,0,5
Thailand,Kuwait,1997,3,1,4
Costa Rica,Nicaragua,1997,5,1,6
Honduras,El Salvador,1997,3,0,3
Zambia,Malawi,1997,4,0,4
Jordan,Bahrain,1997,4,1,5
Cambodia,Yemen,1997,0,1,1
Cameroon,Congo,1997,2,0,2
El Salvador,Panama,1997,2,0,2
Guatemala,Nicaragua,1997,6,1,7
United States,Mexico,1997,2,2,4
China PR,Myanmar,1997,5,0,5
Iran,Kenya,1997,3,0,3
United Arab Emirates,Bahrain,1997,3,0,3
China PR,South Korea,1997,0,2,2
Guatemala,El Salvador,1997,1,0,1
Honduras,Costa Rica,1997,0,4,4
Costa Rica,El Salvador,1997,1,0,1
Guatemala,Honduras,1997,1,0,1
Turkmenistan,Azerbaijan,1997,2,0,2
Namibia,Egypt,1997,2,3,5
Sierra Leone,Morocco,1997,0,1,1
Singapore,Kuwait,1997,0,1,1
United Arab Emirates,Jordan,1997,2,0,2
Burkina Faso,Nigeria,1997,1,2,3
Cambodia,Indonesia,1997,1,1,2
Cameroon,Togo,1997,2,0,2
Canada,Jamaica,1997,0,0,0
China PR,Iran,1997,0,0,0
DR Congo,South Africa,1997,1,2,3
Dominica,Martinique,1997,1,2,3
Ghana,Gabon,1997,3,0,3
Guatemala,Costa Rica,1997,1,1,2
Honduras,El Salvador,1997,0,0,0
Kenya,Guinea,1997,1,0,1
Lebanon,Libya,1997,2,0,2
Tunisia,Liberia,1997,2,0,2
Zambia,Congo,1997,3,0,3
Zimbabwe,Angola,1997,0,0,0
Bermuda,Saint Martin,1997,2,1,3
Chile,Venezuela,1997,6,0,6
Slovakia,Iceland,1997,3,1,4
Argentina,Ecuador,1997,2,1,3
Armenia,Northern Ireland,1997,0,0,0
Austria,Estonia,1997,2,0,2
Brazil,Mexico,1997,4,0,4
Colombia,Peru,1997,0,1,1
Denmark,Slovenia,1997,4,0,4
England,Georgia,1997,2,0,2
Germany,Ukraine,1997,2,0,2
Greece,Croatia,1997,0,1,1
Israel,Cyprus,1997,2,0,2
Italy,Poland,1997,3,0,3
Latvia,Belarus,1997,2,0,2
Liechtenstein,Lithuania,1997,0,2,2
Malta,Faroe Islands,1997,1,2,3
Norway,Finland,1997,1,1,2
Paraguay,Uruguay,1997,3,1,4
Romania,Republic of Ireland,1997,1,0,1
Russia,Luxembourg,1997,3,0,3
San Marino,Netherlands,1997,0,6,6
Serbia,Spain,1997,1,1,2
Sweden,Scotland,1997,2,1,3
Switzerland,Hungary,1997,1,0,1
Syria,Libya,1997,1,1,2
Turkey,Belgium,1997,1,3,4
Fiji,New Caledonia,1997,5,1,6
Trinidad and Tobago,Jamaica,1997,1,1,2
Aruba,Jamaica,1997,0,6,6
El Salvador,Costa Rica,1997,2,1,3
Martinique,Dominica,1997,7,0,7
Tajikistan,Vietnam,1997,4,0,4
Turkmenistan,China PR,1997,1,4,5
Guernsey,Jersey,1997,2,1,3
Ukraine,Armenia,1997,1,1,2
Ivory Coast,Senegal,1997,4,1,5
Kuwait,Lebanon,1997,2,0,2
Yemen,Uzbekistan,1997,0,1,1
Costa Rica,Jamaica,1997,3,1,4
Kazakhstan,Pakistan,1997,3,0,3
Tajikistan,China PR,1997,0,1,1
Turkmenistan,Vietnam,1997,2,1,3
Yemen,Cambodia,1997,7,0,7
Estonia,Latvia,1997,1,3,4
Jamaica,El Salvador,1997,1,0,1
Republic of Ireland,Liechtenstein,1997,5,0,5
Japan,South Korea,1997,1,1,2
Thailand,Northern Ireland,1997,0,0,0
Sweden,Poland,1997,2,2,4
Pakistan,Iraq,1997,2,6,8
England,South Africa,1997,2,1,3
Singapore,Lebanon,1997,1,2,3
Turkmenistan,Tajikistan,1997,1,2,3
Uzbekistan,Cambodia,1997,6,0,6
Vietnam,China PR,1997,1,3,4
Kuwait,Zambia,1997,2,1,3
Scotland,Wales,1997,0,1,1
El Salvador,Ecuador,1997,0,2,2
South Korea,Hong Kong,1997,4,0,4
Norway,Brazil,1997,4,2,6
Burkina Faso,Mali,1997,2,0,2
Morocco,Ethiopia,1997,4,0,4
Papua New Guinea,New Zealand,1997,1,0,1
Poland,England,1997,0,2,2
Tanzania,Namibia,1997,0,0,0
Tunisia,Algeria,1997,0,1,1
Canada,Costa Rica,1997,1,0,1
China PR,Turkmenistan,1997,1,0,1
Indonesia,Uzbekistan,1997,1,1,2
South Korea,Thailand,1997,0,0,0
Malta,Scotland,1997,2,3,5
Vietnam,Tajikistan,1997,0,4,4
Zambia,Cameroon,1997,3,0,3
Maldives,Iran,1997,0,17,17
France,Brazil,1997,1,1,2
England,Italy,1997,2,0,2
Estonia,Azerbaijan,1997,1,0,1
Kyrgyzstan,Iran,1997,0,7,7
South Africa,Netherlands,1997,0,2,2
Syria,Maldives,1997,12,0,12
Togo,Burkina Faso,1997,0,0,0
United States,Paraguay,1997,0,0,0
Kuwait,Singapore,1997,4,0,4
Senegal,Algeria,1997,0,0,0
Iraq,Kazakhstan,1997,1,2,3
Kyrgyzstan,Maldives,1997,3,0,3
Palestine,Jordan,1997,0,0,0
Syria,Iran,1997,0,1,1
Belgium,San Marino,1997,6,0,6
Fiji,New Zealand,1997,0,1,1
France,England,1997,0,1,1
Georgia,Moldova,1997,2,0,2
North Macedonia,Iceland,1997,1,0,1
Morocco,Ghana,1997,1,0,1
Nigeria,Kenya,1997,3,0,3
Portugal,Albania,1997,2,0,2
Ukraine,Germany,1997,0,0,0
Angola,Cameroon,1997,1,1,2
Argentina,Peru,1997,2,0,2
Belarus,Scotland,1997,0,1,1
Bulgaria,Luxembourg,1997,4,0,4
China PR,Tajikistan,1997,0,0,0
Congo,DR Congo,1997,1,0,1
Denmark,Bosnia and Herzegovina,1997,2,0,2
Ecuador,Chile,1997,1,1,2
Egypt,Tunisia,1997,0,0,0
El Salvador,Mexico,1997,0,1,1
Estonia,Sweden,1997,2,3,5
Faroe Islands,Malta,1997,2,1,3
Finland,Azerbaijan,1997,3,0,3
Guinea,Burkina Faso,1997,3,1,4
Hungary,Norway,1997,1,1,2
Italy,Brazil,1997,3,3,6
Japan,Croatia,1997,4,3,7
Latvia,Austria,1997,1,3,4
Liberia,Namibia,1997,1,2,3
Russia,Israel,1997,2,0,2
Serbia,Slovakia,1997,2,0,2
South Africa,Zambia,1997,3,0,3
Spain,Czech Republic,1997,1,0,1
Togo,Zimbabwe,1997,2,1,3
Uruguay,Colombia,1997,1,1,2
Venezuela,Bolivia,1997,1,1,2
Vietnam,Turkmenistan,1997,0,4,4
Iran,Kyrgyzstan,1997,3,1,4
Maldives,Syria,1997,0,12,12
England,Brazil,1997,0,1,1
Argentina,Ecuador,1997,0,0,0
Australia,Solomon Islands,1997,13,0,13
Chile,Paraguay,1997,0,1,1
France,Italy,1997,2,2,4
Iceland,Lithuania,1997,0,0,0
Iran,Maldives,1997,9,0,9
Kyrgyzstan,Syria,1997,2,1,3
New Zealand,Papua New Guinea,1997,7,0,7
Pakistan,Kazakhstan,1997,0,7,7
Bolivia,Venezuela,1997,1,0,1
Croatia,Turkey,1997,1,1,2
Ghana,Serbia,1997,1,3,4
South Korea,Egypt,1997,3,1,4
Peru,Uruguay,1997,1,0,1
Australia,Tahiti,1997,5,0,5
Brazil,Costa Rica,1997,5,0,5
Iran,Syria,1997,2,2,4
Maldives,Kyrgyzstan,1997,0,6,6
Mexico,Colombia,1997,2,1,3
Yemen,Indonesia,1997,1,1,2
Argentina,Chile,1997,2,0,2
Egypt,Serbia,1997,0,0,0
South Korea,Ghana,1997,3,0,3
Paraguay,Ecuador,1997,0,2,2
Poland,Georgia,1997,4,1,5
Bolivia,Peru,1997,2,0,2
Fiji,Papua New Guinea,1997,3,1,4
Japan,Turkey,1997,1,0,1
Mozambique,Tanzania,1997,3,0,3
Solomon Islands,Tahiti,1997,4,1,5
Uruguay,Venezuela,1997,2,0,2
Brazil,Mexico,1997,3,2,5
Colombia,Costa Rica,1997,4,1,5
Egypt,Ghana,1997,2,0,2
South Korea,Serbia,1997,1,1,2
Argentina,Paraguay,1997,1,1,2
Australia,Solomon Islands,1997,6,2,8
Chile,Ecuador,1997,1,2,3
United States,Israel,1997,2,1,3
Bolivia,Uruguay,1997,1,0,1
New Zealand,Fiji,1997,5,0,5
Peru,Venezuela,1997,2,0,2
Australia,Tahiti,1997,2,0,2
Brazil,Colombia,1997,2,0,2
Mexico,Costa Rica,1997,1,1,2
Iraq,Pakistan,1997,6,1,7
Uzbekistan,Indonesia,1997,3,0,3
Antigua and Barbuda,Saint Lucia,1997,1,1,2
Bolivia,Colombia,1997,2,1,3
Morocco,Egypt,1997,1,0,1
Papua New Guinea,Fiji,1997,0,1,1
Peru,Argentina,1997,2,1,3
Tahiti,Solomon Islands,1997,1,1,2
Angola,Ghana,1997,1,0,1
Antigua and Barbuda,Saint Lucia,1997,1,0,1
Brazil,Paraguay,1997,2,0,2
Cameroon,Gabon,1997,2,2,4
China PR,Vietnam,1997,4,0,4
Ecuador,Mexico,1997,1,1,2
Estonia,Andorra,1997,4,1,5
Ivory Coast,Algeria,1997,2,1,3
Japan,Macau,1997,10,0,10
Lebanon,Kuwait,1997,1,3,4
Liberia,DR Congo,1997,2,1,3
Mali,Benin,1997,3,1,4
Mozambique,Zambia,1997,2,2,4
Nepal,Oman,1997,0,6,6
Senegal,Ethiopia,1997,3,0,3
Tajikistan,Turkmenistan,1997,5,0,5
Tanzania,Togo,1997,1,0,1
Bolivia,Mexico,1997,3,1,4
Japan,Nepal,1997,3,0,3
Latvia,Andorra,1997,4,1,5
Macau,Oman,1997,0,2,2
Brazil,Peru,1997,7,0,7
DR Congo,Uganda,1997,0,0,0
Japan,Oman,1997,1,1,2
Macau,Nepal,1997,2,1,3
Mexico,Peru,1997,1,0,1
Namibia,Malawi,1997,4,1,5
New Zealand,Australia,1997,0,3,3
Bolivia,Brazil,1997,1,3,4
Cambodia,Uzbekistan,1997,1,4,5
El Salvador,United States,1997,1,1,2
Jamaica,Cuba,1997,3,0,3
Kazakhstan,Iraq,1997,3,1,4
Jersey,Frøya,1997,4,1,5
Gibraltar,Guernsey,1997,1,2,3
Ynys Môn,Hitra,1997,8,0,8
Shetland,Isle of Wight,1997,0,0,0
Jersey,Greenland,1997,2,1,3
Frøya,Guernsey,1997,1,2,3
Ynys Môn,Shetland,1997,4,0,4
Hitra,Isle of Wight,1997,0,4,4
Guernsey,Greenland,1997,0,0,0
Frøya,Gibraltar,1997,0,4,4
Barbados,Trinidad and Tobago,1997,1,1,2
Gibraltar,Greenland,1997,5,1,6
Jersey,Guernsey,1997,4,0,4
Frøya,Greenland,1997,2,1,3
Jersey,Gibraltar,1997,3,2,5
Ynys Môn,Isle of Wight,1997,0,0,0
Shetland,Hitra,1997,2,1,3
Frøya,Hitra,1997,4,1,5
Shetland,Gibraltar,1997,2,1,3
Isle of Wight,Guernsey,1997,3,1,4
Jersey,Ynys Môn,1997,2,1,3
Jamaica,Grenada,1997,1,1,2
Martinique,Trinidad and Tobago,1997,2,1,3
Chile,Colombia,1997,4,1,5
Tanzania,Zambia,1997,2,2,4
Tunisia,Mali,1997,1,0,1
Antigua and Barbuda,Grenada,1997,1,3,4
Australia,New Zealand,1997,2,0,2
Malawi,Botswana,1997,0,0,0
Paraguay,Argentina,1997,1,2,3
Peru,Bolivia,1997,2,1,3
Saint Kitts and Nevis,Martinique,1997,2,0,2
Venezuela,Ecuador,1997,1,1,2
Antigua and Barbuda,Jamaica,1997,0,2,2
Saint Kitts and Nevis,Trinidad and Tobago,1997,0,3,3
Lithuania,Estonia,1997,2,1,3
Estonia,Latvia,1997,1,2,3
Saint Kitts and Nevis,Grenada,1997,2,1,3
Trinidad and Tobago,Jamaica,1997,1,1,2
Lithuania,Latvia,1997,1,0,1
Benin,Ivory Coast,1997,0,0,0
DR Congo,Tanzania,1997,1,1,2
Egypt,Senegal,1997,2,0,2
Ethiopia,Morocco,1997,0,1,1
Gabon,Kenya,1997,1,0,1
Ghana,Zimbabwe,1997,2,1,3
Jamaica,Grenada,1997,4,1,5
Mauritius,Mozambique,1997,1,3,4
Togo,Liberia,1997,4,0,4
Trinidad and Tobago,Saint Kitts and Nevis,1997,4,0,4
Tunisia,Guinea,1997,1,0,1
Argentina,Venezuela,1997,2,0,2
Bolivia,Uruguay,1997,1,0,1
Chile,Paraguay,1997,2,1,3
Colombia,Ecuador,1997,1,0,1
Iceland,Norway,1997,0,1,1
Mozambique,Namibia,1997,1,1,2
Algeria,Benin,1997,2,0,2
Angola,Zimbabwe,1997,2,1,3
Cameroon,Kenya,1997,1,1,2
DR Congo,Togo,1997,1,0,1
Egypt,Ethiopia,1997,8,1,9
Gabon,Namibia,1997,1,1,2
Iceland,Faroe Islands,1997,1,0,1
Ivory Coast,Mali,1997,4,2,6
Liberia,Tanzania,1997,1,0,1
Morocco,Senegal,1997,3,0,3
Mozambique,Malawi,1997,2,1,3
Zambia,Mauritius,1997,1,0,1
Zambia,Mozambique,1997,2,1,3
Belarus,Israel,1997,2,3,5
Estonia,Faroe Islands,1997,0,2,2
Hungary,Malta,1997,3,0,3
Jamaica,Colombia,1997,1,0,1
Slovakia,Switzerland,1997,1,0,1
Sweden,Lithuania,1997,1,0,1
Cameroon,Nigeria,1997,0,1,1
Tunisia,Zambia,1997,3,1,4
United States,Ecuador,1997,0,1,1
Cameroon,Zambia,1997,3,3,6
Malawi,Tanzania,1997,2,2,4
Tunisia,Nigeria,1997,2,0,2
Costa Rica,El Salvador,1997,0,0,0
South Korea,Brazil,1997,1,2,3
Japan,Brazil,1997,0,3,3
Burkina Faso,Kenya,1997,2,4,6
Morocco,Gabon,1997,2,0,2
South Africa,Congo,1997,1,0,1
Zambia,DR Congo,1997,2,0,2
Canada,Iran,1997,0,1,1
Egypt,Liberia,1997,5,0,5
Ghana,Sierra Leone,1997,0,2,2
Guinea,Nigeria,1997,1,0,1
Togo,Angola,1997,1,1,2
Tunisia,Namibia,1997,4,0,4
Zimbabwe,Cameroon,1997,1,2,3
Greece,Cyprus,1997,2,1,3
Latvia,Azerbaijan,1997,0,0,0
Belarus,Sweden,1997,1,2,3
Bosnia and Herzegovina,Denmark,1997,3,0,3
Bulgaria,Israel,1997,1,0,1
Colombia,Bolivia,1997,3,0,3
Czech Republic,Faroe Islands,1997,2,0,2
Ecuador,Paraguay,1997,2,1,3
Estonia,Austria,1997,0,3,3
Finland,Norway,1997,0,4,4
Hungary,Switzerland,1997,1,1,2
Republic of Ireland,Lithuania,1997,0,0,0
Liechtenstein,Iceland,1997,0,4,4
Northern Ireland,Germany,1997,1,3,4
Portugal,Armenia,1997,3,1,4
Romania,North Macedonia,1997,4,2,6
Russia,Serbia,1997,0,1,1
Turkey,Wales,1997,6,4,10
Ukraine,Albania,1997,1,0,1
Uruguay,Chile,1997,1,0,1
Venezuela,Peru,1997,0,3,3
Lebanon,Iraq,1997,0,2,2
South Korea,Tajikistan,1997,4,1,5
Peru,Colombia,1997,2,1,3
Slovakia,Czech Republic,1997,2,1,3
Uzbekistan,Yemen,1997,5,1,6
South Korea,China PR,1997,0,0,0
Jamaica,Trinidad and Tobago,1997,6,1,7
Namibia,Zambia,1997,1,1,2
China PR,Kazakhstan,1997,3,0,3
United Arab Emirates,Iran,1997,3,1,4
Nepal,Pakistan,1997,0,2,2
Maldives,Bangladesh,1997,1,1,2
Armenia,Albania,1997,3,0,3
Austria,Sweden,1997,1,0,1
Azerbaijan,Norway,1997,0,1,1
Croatia,Bosnia and Herzegovina,1997,3,2,5
El Salvador,Colombia,1997,2,2,4
Faroe Islands,Czech Republic,1997,0,2,2
Germany,Portugal,1997,1,1,2
Iceland,Republic of Ireland,1997,2,2,4
South Korea,Kazakhstan,1997,3,0,3
Latvia,Estonia,1997,1,0,1
Liechtenstein,Romania,1997,1,8,9
Lithuania,North Macedonia,1997,2,0,2
Netherlands,Belgium,1997,3,1,4
Poland,Hungary,1997,1,0,1
Slovenia,Greece,1997,0,3,3
Sri Lanka,Pakistan,1997,2,0,2
Switzerland,Finland,1997,1,2,3
India,Bangladesh,1997,3,0,3
Jamaica,Canada,1997,1,0,1
Japan,Uzbekistan,1997,6,3,9
Luxembourg,Cyprus,1997,1,3,4
Scotland,Belarus,1997,4,1,5
United States,Costa Rica,1997,1,0,1
Nepal,Sri Lanka,1997,1,3,4
Maldives,India,1997,2,2,4
Albania,Northern Ireland,1997,1,0,1
Belarus,Austria,1997,0,1,1
Bosnia and Herzegovina,Slovenia,1997,1,0,1
Brazil,Ecuador,1997,4,2,6
Bulgaria,Russia,1997,1,0,1
Chile,Argentina,1997,1,2,3
Colombia,Venezuela,1997,1,0,1
Denmark,Croatia,1997,3,1,4
England,Moldova,1997,4,0,4
Georgia,Italy,1997,0,0,0
Germany,Armenia,1997,4,0,4
Hungary,Azerbaijan,1997,3,1,4
Lithuania,Republic of Ireland,1997,1,2,3
Norway,Switzerland,1997,5,0,5
Paraguay,Bolivia,1997,2,1,3
Peru,Uruguay,1997,2,1,3
Romania,Iceland,1997,4,0,4
San Marino,Turkey,1997,0,5,5
Slovakia,Serbia,1997,1,1,2
Sri Lanka,Maldives,1997,1,2,3
Sweden,Latvia,1997,1,0,1
India,Pakistan,1997,2,0,2
South Korea,Uzbekistan,1997,2,1,3
United Arab Emirates,Kazakhstan,1997,4,0,4
China PR,Iran,1997,2,4,6
India,Maldives,1997,5,1,6
Pakistan,Sri Lanka,1997,1,0,1
El Salvador,Canada,1997,4,1,5
Indonesia,Tanzania,1997,3,1,4
Jamaica,Costa Rica,1997,1,0,1
Saudi Arabia,Kuwait,1997,2,1,3
Iran,Saudi Arabia,1997,1,1,2
Qatar,Kuwait,1997,0,2,2
United Arab Emirates,Japan,1997,0,0,0
Kazakhstan,Uzbekistan,1997,1,1,2
Libya,Bahrain,1997,2,1,3
Indonesia,New Zealand,1997,5,0,5
El Salvador,Guatemala,1997,0,1,1
Malta,Czech Republic,1997,0,1,1
Moldova,Georgia,1997,0,1,1
Poland,Lithuania,1997,2,0,2
Slovakia,Spain,1997,1,2,3
Bahrain,Chad,1997,1,1,2
Libya,Jordan,1997,1,1,2
Saudi Arabia,Mali,1997,5,1,6
Kuwait,Iran,1997,1,1,2
Qatar,China PR,1997,1,1,2
Tanzania,Zambia,1997,0,0,0
Uzbekistan,United Arab Emirates,1997,2,3,5
Algeria,Kenya,1997,0,1,1
Japan,South Korea,1997,1,2,3
Algeria,Zambia,1997,0,1,1
Tanzania,Kenya,1997,0,1,1
China PR,Saudi Arabia,1997,1,0,1
Iran,Qatar,1997,3,0,3
Kenya,Zambia,1997,0,0,0
United States,Jamaica,1997,1,1,2
Kazakhstan,Japan,1997,1,1,2
South Korea,United Arab Emirates,1997,3,0,3
Saint Kitts and Nevis,Cuba,1997,0,2,2
Tanzania,Algeria,1997,0,1,1
Mexico,El Salvador,1997,5,0,5
Moldova,Poland,1997,0,3,3
Norway,Colombia,1997,0,0,0
Brazil,Morocco,1997,2,0,2
Kuwait,China PR,1997,1,2,3
Armenia,Ukraine,1997,0,2,2
Austria,Belarus,1997,4,0,4
Belgium,Wales,1997,3,2,5
Cyprus,Luxembourg,1997,2,0,2
Czech Republic,Slovakia,1997,3,0,3
Finland,Hungary,1997,1,1,2
France,South Africa,1997,2,1,3
Georgia,Poland,1997,3,0,3
Germany,Albania,1997,4,3,7
Greece,Denmark,1997,0,0,0
Iceland,Liechtenstein,1997,4,0,4
Republic of Ireland,Romania,1997,1,1,2
Italy,England,1997,0,0,0
Kazakhstan,South Korea,1997,1,1,2
North Macedonia,Lithuania,1997,1,2,3
Malta,Serbia,1997,0,5,5
Netherlands,Turkey,1997,0,0,0
Portugal,Northern Ireland,1997,1,0,1
Russia,Bulgaria,1997,4,2,6
Saudi Arabia,Qatar,1997,1,0,1
Scotland,Latvia,1997,2,0,2
Slovenia,Croatia,1997,1,3,4
Spain,Faroe Islands,1997,3,1,4
Sweden,Estonia,1997,1,0,1
Switzerland,Azerbaijan,1997,5,0,5
Uzbekistan,Japan,1997,1,1,2
Argentina,Uruguay,1997,0,0,0
Canada,Mexico,1997,2,2,4
Ecuador,Bolivia,1997,1,0,1
Paraguay,Venezuela,1997,1,0,1
Peru,Chile,1997,0,4,4
Iran,China PR,1997,4,1,5
Kuwait,Saudi Arabia,1997,2,1,3
Haiti,Jamaica,1997,0,1,1
Kazakhstan,United Arab Emirates,1997,3,0,3
Uzbekistan,South Korea,1997,1,5,6
Haiti,Cuba,1997,2,2,4
Martinique,Cameroon,1997,2,1,3
Cuba,Cameroon,1997,1,1,2
Haiti,Martinique,1997,3,0,3
Kuwait,Qatar,1997,0,1,1
Saudi Arabia,Iran,1997,1,0,1
Saint Lucia,Jamaica,1997,1,3,4
Uzbekistan,Kazakhstan,1997,4,0,4
Antigua and Barbuda,Jamaica,1997,0,3,3
Japan,United Arab Emirates,1997,1,1,2
Croatia,Ukraine,1997,2,0,2
Hungary,Serbia,1997,1,7,8
Republic of Ireland,Belgium,1997,1,1,2
Russia,Italy,1997,1,1,2
Saint Kitts and Nevis,Jamaica,1997,1,1,2
China PR,Qatar,1997,2,3,5
Iran,Kuwait,1997,0,0,0
South Korea,Japan,1997,0,2,2
Ivory Coast,Burkina Faso,1997,0,0,0
Mexico,United States,1997,0,0,0
Eswatini,Mauritius,1997,0,1,1
United Arab Emirates,Uzbekistan,1997,0,0,0
Tunisia,Bosnia and Herzegovina,1997,2,1,3
Saudi Arabia,China PR,1997,1,1,2
Chile,Guatemala,1997,4,1,5
Qatar,Iran,1997,2,0,2
Japan,Kazakhstan,1997,5,1,6
Canada,United States,1997,0,3,3
El Salvador,Jamaica,1997,2,2,4
Mexico,Costa Rica,1997,3,3,6
United Arab Emirates,South Korea,1997,1,3,4
Brazil,Wales,1997,3,0,3
China PR,Kuwait,1997,1,0,1
France,Scotland,1997,2,1,3
Qatar,Saudi Arabia,1997,0,1,1
Mali,Mauritania,1997,3,1,4
Belgium,Republic of Ireland,1997,2,1,3
England,Cameroon,1997,2,0,2
Germany,South Africa,1997,3,0,3
Italy,Russia,1997,1,0,1
Serbia,Hungary,1997,5,0,5
Ukraine,Croatia,1997,1,1,2
Argentina,Colombia,1997,1,1,2
Chile,Bolivia,1997,3,0,3
Costa Rica,Canada,1997,3,1,4
Jamaica,Mexico,1997,0,0,0
Japan,Iran,1997,3,2,5
Peru,Paraguay,1997,1,0,1
Uruguay,Ecuador,1997,5,3,8
United States,El Salvador,1997,4,2,6
Senegal,Mali,1997,1,2,3
Spain,Romania,1997,1,1,2
Iran,Australia,1997,1,1,2
Morocco,Togo,1997,3,0,3
Philippines,Estonia,1997,0,1,1
Gambia,Cape Verde,1997,3,1,4
Mauritania,Senegal,1997,1,1,2
Australia,Iran,1997,2,2,4
Guinea,Mali,1997,0,0,0
Sierra Leone,Guinea-Bissau,1997,2,1,3
Gambia,Mauritania,1997,2,1,3
Senegal,Cape Verde,1997,2,0,2
Guinea,Sierra Leone,1997,3,0,3
Mali,Guinea-Bissau,1997,6,1,7
Cape Verde,Mauritania,1997,2,2,4
Gambia,Senegal,1997,0,0,0
Egypt,Ghana,1997,3,2,5
Guinea,Guinea-Bissau,1997,2,0,2
Mali,Sierra Leone,1997,1,1,2
Gambia,Mali,1997,1,2,3
Guinea,Senegal,1997,1,2,3
Gambia,Guinea,1997,2,2,4
Mali,Senegal,1997,1,0,1
Saudi Arabia,Iceland,1997,0,0,0
South Africa,Brazil,1997,1,2,3
Mexico,Australia,1997,1,3,4
Saudi Arabia,Brazil,1997,0,3,3
South Africa,Czech Republic,1997,2,2,4
United Arab Emirates,Uruguay,1997,0,2,2
Australia,Brazil,1997,0,0,0
Saudi Arabia,Mexico,1997,0,5,5
Czech Republic,Uruguay,1997,1,2,3
United Arab Emirates,South Africa,1997,1,0,1
Brazil,Mexico,1997,3,2,5
Saudi Arabia,Australia,1997,1,0,1
Martinique,Trinidad and Tobago,1997,3,0,3
United Arab Emirates,Czech Republic,1997,1,6,7
Uruguay,South Africa,1997,4,3,7
Zambia,Nigeria,1997,0,0,0
Egypt,Togo,1997,7,2,9
Lesotho,Eswatini,1997,0,0,0
Martinique,Trinidad and Tobago,1997,3,2,5
Brazil,Czech Republic,1997,2,0,2
Uruguay,Australia,1997,0,1,1
Egypt,Algeria,1997,1,2,3
Brazil,Australia,1997,6,0,6
Czech Republic,Uruguay,1997,1,0,1
Mozambique,Lesotho,1997,1,1,2
Algeria,Togo,1997,0,1,1
Egypt,Cameroon,1997,2,0,2
Catalonia,Bulgaria,1997,1,1,2
Cameroon,Togo,1997,3,1,4
Egypt,Algeria,1997,1,2,3
Basque Country,Yugoslavia,1997,3,1,4
Burkina Faso,Ivory Coast,1997,2,0,2
Lesotho,Eswatini,1997,0,0,0
Malawi,Zimbabwe,1998,1,0,1
Barbados,Trinidad and Tobago,1998,0,1,1
Burkina Faso,Mozambique,1998,1,0,1
Guinea,Togo,1998,1,0,1
Malawi,Zimbabwe,1998,0,2,2
Burkina Faso,Mozambique,1998,4,2,6
Trinidad and Tobago,Jamaica,1998,0,0,0
Malawi,Zambia,1998,0,1,1
Eswatini,Botswana,1998,1,1,2
Burkina Faso,Mali,1998,0,0,0
Togo,Mozambique,1998,1,2,3
Lesotho,Botswana,1998,0,0,0
Ghana,Mozambique,1998,0,0,0
Morocco,Angola,1998,2,1,3
Gambia,Zambia,1998,0,2,2
Lesotho,Zimbabwe,1998,0,2,2
Ghana,Mozambique,1998,3,1,4
Costa Rica,Honduras,1998,1,4,5
El Salvador,Trinidad and Tobago,1998,2,0,2
Turkey,Albania,1998,1,4,5
Namibia,South Africa,1998,3,2,5
United States,Sweden,1998,1,0,1
Botswana,Mozambique,1998,1,2,3
Thailand,Egypt,1998,1,1,2
Egypt,South Korea,1998,0,2,2
Liberia,Burkina Faso,1998,1,2,3
Cameroon,Angola,1998,1,0,1
France,Spain,1998,1,0,1
Iran,Nigeria,1998,0,1,1
Italy,Slovakia,1998,3,0,3
Tunisia,Serbia,1998,0,3,3
Ivory Coast,Mozambique,1998,4,1,5
Jamaica,Sweden,1998,0,0,0
Thailand,South Korea,1998,0,2,2
Togo,Mali,1998,2,1,3
Niger,Namibia,1998,2,1,3
Egypt,South Korea,1998,1,1,2
Iran,Chile,1998,1,1,2
Tunisia,Guinea,1998,4,1,5
Burkina Faso,Namibia,1998,3,1,4
Guatemala,El Salvador,1998,0,0,0
Honduras,Trinidad and Tobago,1998,1,3,4
Ivory Coast,Cameroon,1998,1,0,1
Togo,Mali,1998,0,4,4
United States,Cuba,1998,3,0,3
Brazil,Jamaica,1998,0,0,0
Cuba,Costa Rica,1998,2,7,9
Mali,Tunisia,1998,0,1,1
New Zealand,Chile,1998,0,0,0
Trinidad and Tobago,Mexico,1998,2,4,6
Brazil,Guatemala,1998,1,1,2
Cyprus,Finland,1998,1,1,2
Iceland,Slovenia,1998,2,3,5
Morocco,Niger,1998,3,0,3
Georgia,Latvia,1998,2,1,3
Malta,Albania,1998,1,1,2
Slovenia,Slovakia,1998,1,1,2
Australia,Chile,1998,0,1,1
Burkina Faso,Cameroon,1998,0,1,1
Iceland,Slovakia,1998,1,2,3
Mexico,Honduras,1998,2,0,2
New Zealand,South Korea,1998,0,1,1
United States,Costa Rica,1998,2,1,3
Albania,Georgia,1998,0,3,3
Algeria,Guinea,1998,0,1,1
El Salvador,Brazil,1998,0,4,4
Guatemala,Jamaica,1998,2,3,5
Ivory Coast,Namibia,1998,4,3,7
Malta,Latvia,1998,2,1,3
Paraguay,Poland,1998,4,0,4
South Africa,Angola,1998,0,0,0
DR Congo,Togo,1998,2,1,3
Cyprus,Slovenia,1998,1,0,1
Finland,Slovakia,1998,0,2,2
Ghana,Tunisia,1998,2,0,2
Jamaica,El Salvador,1998,2,0,2
Zambia,Morocco,1998,1,1,2
Albania,Latvia,1998,2,2,4
Egypt,Mozambique,1998,2,0,2
Malta,Georgia,1998,1,3,4
United States,Brazil,1998,1,0,1
Australia,South Korea,1998,1,0,1
Burkina Faso,Algeria,1998,2,1,3
Cameroon,Guinea,1998,2,2,4
England,Chile,1998,0,2,2
South Africa,Ivory Coast,1998,1,1,2
Angola,Namibia,1998,3,3,6
Ghana,Togo,1998,1,2,3
Jamaica,Mexico,1998,0,1,1
Tunisia,DR Congo,1998,2,1,3
Morocco,Mozambique,1998,3,0,3
Zambia,Egypt,1998,0,4,4
Australia,Japan,1998,0,3,3
Brazil,Jamaica,1998,1,0,1
Burkina Faso,Guinea,1998,1,0,1
Cameroon,Algeria,1998,2,1,3
United States,Mexico,1998,0,1,1
Ghana,DR Congo,1998,0,1,1
Ivory Coast,Angola,1998,5,2,7
South Africa,Namibia,1998,4,1,5
Tunisia,Togo,1998,3,1,4
Egypt,Morocco,1998,0,1,1
Zambia,Mozambique,1998,3,1,4
Greece,Russia,1998,1,1,2
Israel,Turkey,1998,4,0,4
Oman,Germany,1998,0,2,2
Cameroon,DR Congo,1998,0,1,1
Burkina Faso,Tunisia,1998,1,1,2
Ivory Coast,Egypt,1998,0,0,0
United States,Netherlands,1998,0,2,2
Antigua and Barbuda,Dominica,1998,1,1,2
Jamaica,Nigeria,1998,2,2,4
Morocco,South Africa,1998,1,2,3
Saudi Arabia,Germany,1998,0,3,3
Argentina,Serbia,1998,3,1,4
Mexico,Netherlands,1998,2,3,5
Belgium,United States,1998,2,0,2
Burkina Faso,Egypt,1998,0,2,2
DR Congo,South Africa,1998,1,2,3
France,Norway,1998,3,3,6
Israel,Poland,1998,2,0,2
Burkina Faso,DR Congo,1998,4,4,8
South Africa,Egypt,1998,0,2,2
Barbados,Saint Kitts and Nevis,1998,6,2,8
China PR,Hong Kong,1998,1,0,1
Japan,South Korea,1998,2,1,3
Aruba,French Guiana,1998,1,0,1
Saint Lucia,Saint Kitts and Nevis,1998,2,0,2
Suriname,Curaçao,1998,3,3,6
China PR,South Korea,1998,1,2,3
Japan,Hong Kong,1998,5,1,6
Aruba,Curaçao,1998,0,1,1
Saint Vincent and the Grenadines,Saint Kitts and Nevis,1998,4,2,6
Suriname,French Guiana,1998,2,2,4
Aruba,Suriname,1998,3,3,6
Curaçao,French Guiana,1998,2,1,3
Japan,China PR,1998,0,2,2
Hong Kong,South Korea,1998,0,1,1
Eswatini,Angola,1998,0,1,1
Argentina,Bulgaria,1998,2,0,2
Haiti,Puerto Rico,1998,4,0,4
Dominican Republic,Puerto Rico,1998,3,1,4
Myanmar,Brunei,1998,4,1,5
United States,Paraguay,1998,2,2,4
Haiti,Dominican Republic,1998,5,0,5
Laos,Brunei,1998,2,1,3
Myanmar,Laos,1998,3,0,3
Mexico,Paraguay,1998,1,1,2
Romania,Israel,1998,0,1,1
Saint Lucia,Barbados,1998,2,1,3
Martinique,Barbados,1998,4,1,5
Saint Lucia,Saint Vincent and the Grenadines,1998,3,2,5
Azerbaijan,Moldova,1998,1,0,1
Saint Lucia,Martinique,1998,1,2,3
United States Virgin Islands,British Virgin Islands,1998,1,0,1
Singapore,Philippines,1998,1,0,1
Austria,Hungary,1998,2,3,5
Belgium,Norway,1998,2,2,4
Colombia,Serbia,1998,0,0,0
Czech Republic,Republic of Ireland,1998,2,1,3
Germany,Brazil,1998,1,2,3
North Macedonia,Bulgaria,1998,1,0,1
Malta,Finland,1998,0,2,2
Northern Ireland,Slovakia,1998,1,0,1
Poland,Slovenia,1998,2,0,2
Russia,France,1998,1,0,1
Scotland,Denmark,1998,0,1,1
Spain,Sweden,1998,4,0,4
Switzerland,England,1998,1,1,2
Wales,Jamaica,1998,0,0,0
Cambodia,Philippines,1998,1,1,2
Singapore,Cambodia,1998,3,0,3
Colombia,Paraguay,1998,1,1,2
Antigua and Barbuda,Saint Lucia,1998,1,1,2
Dominica,Guadeloupe,1998,1,1,2
South Korea,Japan,1998,2,1,3
Saint Kitts and Nevis,British Virgin Islands,1998,4,0,4
Guadeloupe,British Virgin Islands,1998,3,0,3
Saint Kitts and Nevis,Dominica,1998,1,2,3
Dominica,British Virgin Islands,1998,4,1,5
Saint Kitts and Nevis,Guadeloupe,1998,2,1,3
Romania,Greece,1998,2,1,3
Iran,Kuwait,1998,1,1,2
Grenada,Anguilla,1998,14,1,15
Israel,Argentina,1998,2,1,3
Mexico,Peru,1998,1,0,1
Slovakia,South Korea,1998,0,0,0
North Macedonia,South Korea,1998,2,2,4
Antigua and Barbuda,Grenada,1998,2,1,3
Guyana,Anguilla,1998,14,0,14
Zimbabwe,Namibia,1998,5,2,7
Iran,Hungary,1998,0,2,2
Jamaica,North Macedonia,1998,1,2,3
Latvia,Lithuania,1998,1,2,3
Austria,United States,1998,0,3,3
Belgium,Romania,1998,1,1,2
Bulgaria,Morocco,1998,2,1,3
Chile,Colombia,1998,2,2,4
Croatia,Poland,1998,4,1,5
Denmark,Norway,1998,0,2,2
England,Portugal,1998,3,0,3
Germany,Nigeria,1998,1,0,1
Hungary,North Macedonia,1998,0,0,0
Iran,Jamaica,1998,1,0,1
Republic of Ireland,Argentina,1998,0,2,2
Italy,Paraguay,1998,3,1,4
Northern Ireland,Switzerland,1998,1,0,1
Russia,Turkey,1998,1,0,1
Scotland,Finland,1998,1,1,2
Serbia,South Korea,1998,3,1,4
Slovenia,Czech Republic,1998,1,3,4
Sweden,France,1998,0,0,0
Azerbaijan,Uzbekistan,1998,2,1,3
Brazil,Argentina,1998,0,1,1
Chile,Lithuania,1998,1,0,1
Tunisia,Georgia,1998,1,1,2
Angola,Zambia,1998,1,1,2
Jamaica,Saudi Arabia,1998,0,0,0
Jersey,Guernsey,1998,2,0,2
Cayman Islands,Cuba,1998,2,2,4
Cuba,Bermuda,1998,2,1,3
Estonia,Mexico,1998,0,6,6
Saudi Arabia,Trinidad and Tobago,1998,2,1,3
Cayman Islands,Bermuda,1998,2,0,2
Iceland,Saudi Arabia,1998,1,1,2
Argentina,Bosnia and Herzegovina,1998,5,0,5
Corsica,Cameroon,1998,0,1,1
Estonia,Azerbaijan,1998,0,0,0
South Korea,Jamaica,1998,2,1,3
United States,North Macedonia,1998,0,0,0
Zambia,Mozambique,1998,1,0,1
Japan,Paraguay,1998,1,1,2
Latvia,Israel,1998,1,5,6
Saudi Arabia,Namibia,1998,2,1,3
Canada,North Macedonia,1998,1,0,1
Argentina,Chile,1998,1,0,1
Cameroon,Burkina Faso,1998,2,0,2
South Korea,Jamaica,1998,0,0,0
Norway,Mexico,1998,5,2,7
South Africa,Zambia,1998,1,1,2
Czech Republic,Paraguay,1998,1,0,1
Brittany,Cameroon,1998,1,1,2
England,Saudi Arabia,1998,0,0,0
Republic of Ireland,Mexico,1998,0,0,0
Chile,Uruguay,1998,2,2,4
Japan,Czech Republic,1998,0,0,0
Mozambique,Zimbabwe,1998,0,2,2
United States,Kuwait,1998,2,0,2
Argentina,South Africa,1998,2,0,2
Austria,Tunisia,1998,2,1,3
Belgium,France,1998,0,1,1
Finland,Germany,1998,0,0,0
Hungary,Lithuania,1998,1,0,1
South Korea,Czech Republic,1998,2,2,4
Morocco,England,1998,0,1,1
Netherlands,Cameroon,1998,0,0,0
Norway,Saudi Arabia,1998,6,0,6
Poland,Russia,1998,3,1,4
Saint Kitts and Nevis,Trinidad and Tobago,1998,4,1,5
Sweden,Denmark,1998,3,0,3
Belgium,England,1998,0,0,0
Morocco,France,1998,2,2,4
Serbia,Nigeria,1998,3,0,3
Georgia,Russia,1998,1,1,2
Germany,Colombia,1998,3,1,4
Namibia,Angola,1998,1,1,2
United States,Scotland,1998,0,0,0
Chile,Tunisia,1998,3,2,5
Japan,Mexico,1998,1,2,3
Luxembourg,Cameroon,1998,0,2,2
Netherlands,Paraguay,1998,5,1,6
Austria,Liechtenstein,1998,6,0,6
Sweden,Italy,1998,1,0,1
Andorra,Brazil,1998,0,3,3
Belgium,Colombia,1998,2,0,2
Croatia,Iran,1998,2,0,2
North Macedonia,Bosnia and Herzegovina,1998,1,1,2
Malta,Wales,1998,0,3,3
Romania,Paraguay,1998,3,2,5
Saudi Arabia,Mexico,1998,0,0,0
Serbia,Japan,1998,1,0,1
Spain,Northern Ireland,1998,4,1,5
Chile,Morocco,1998,1,1,2
Estonia,Faroe Islands,1998,5,0,5
South Korea,China PR,1998,1,1,2
Bulgaria,Algeria,1998,2,0,2
Denmark,Cameroon,1998,1,2,3
Finland,France,1998,0,1,1
Germany,Luxembourg,1998,7,0,7
Netherlands,Nigeria,1998,5,1,6
Belgium,Paraguay,1998,1,0,1
Croatia,Australia,1998,7,0,7
Iceland,South Africa,1998,1,1,2
Kenya,Seychelles,1998,1,1,2
Romania,Moldova,1998,5,1,6
Switzerland,Serbia,1998,1,1,2
Tunisia,Wales,1998,4,0,4
Belarus,Lithuania,1998,5,0,5
Brazil,Scotland,1998,2,1,3
Morocco,Norway,1998,2,2,4
Cameroon,Austria,1998,1,1,2
Italy,Chile,1998,2,2,4
France,South Africa,1998,3,0,3
Paraguay,Bulgaria,1998,0,0,0
Saudi Arabia,Denmark,1998,0,1,1
South Korea,Mexico,1998,1,3,4
Netherlands,Belgium,1998,0,0,0
Seychelles,Kenya,1998,0,1,1
Spain,Nigeria,1998,2,3,5
Argentina,Japan,1998,1,0,1
Jamaica,Croatia,1998,1,3,4
Serbia,Iran,1998,1,0,1
England,Tunisia,1998,2,0,2
Germany,United States,1998,2,0,2
Romania,Colombia,1998,1,0,1
Brazil,Morocco,1998,3,0,3
Scotland,Norway,1998,1,1,2
Chile,Austria,1998,1,1,2
Italy,Cameroon,1998,3,0,3
France,Saudi Arabia,1998,4,0,4
South Africa,Denmark,1998,1,1,2
Nigeria,Bulgaria,1998,1,0,1
Spain,Paraguay,1998,0,0,0
Belgium,Mexico,1998,2,2,4
Japan,Croatia,1998,0,1,1
Netherlands,South Korea,1998,5,0,5
Argentina,Jamaica,1998,5,0,5
Germany,Serbia,1998,2,2,4
United States,Iran,1998,1,2,3
Colombia,Tunisia,1998,1,0,1
Estonia,Andorra,1998,2,1,3
Romania,England,1998,2,1,3
Brazil,Norway,1998,1,2,3
Chile,Cameroon,1998,1,1,2
Italy,Austria,1998,2,1,3
Scotland,Morocco,1998,0,3,3
Andorra,Azerbaijan,1998,0,0,0
France,Denmark,1998,2,1,3
Nigeria,Paraguay,1998,1,3,4
South Africa,Saudi Arabia,1998,2,2,4
Spain,Bulgaria,1998,6,1,7
Belgium,South Korea,1998,1,1,2
Estonia,Latvia,1998,0,2,2
Germany,Iran,1998,2,0,2
Netherlands,Mexico,1998,2,2,4
United States,Serbia,1998,0,1,1
Argentina,Croatia,1998,1,0,1
Azerbaijan,Lithuania,1998,2,1,3
Colombia,England,1998,0,2,2
Japan,Jamaica,1998,1,2,3
Latvia,Andorra,1998,2,0,2
Romania,Tunisia,1998,1,1,2
Brazil,Chile,1998,4,1,5
Italy,Norway,1998,1,0,1
Thailand,China PR,1998,0,3,3
Estonia,Lithuania,1998,0,0,0
France,Paraguay,1998,1,0,1
Nigeria,Denmark,1998,1,4,5
Germany,Mexico,1998,2,1,3
Lithuania,Andorra,1998,4,0,4
Netherlands,Serbia,1998,2,1,3
Argentina,England,1998,2,2,4
Romania,Croatia,1998,0,1,1
Oman,Syria,1998,1,2,3
Brazil,Denmark,1998,3,2,5
France,Italy,1998,0,0,0
Germany,Croatia,1998,0,3,3
Netherlands,Argentina,1998,2,1,3
Rwanda,Tanzania,1998,2,0,2
Malawi,Mozambique,1998,2,1,3
Rwanda,Tanzania,1998,2,2,4
Brazil,Netherlands,1998,1,1,2
France,Croatia,1998,2,1,3
Malawi,Mozambique,1998,2,2,4
Uganda,Tanzania,1998,3,0,3
Malawi,Mozambique,1998,0,0,0
Netherlands,Croatia,1998,1,2,3
France,Brazil,1998,3,0,3
Ukraine,Poland,1998,1,2,3
Malawi,Zimbabwe,1998,1,0,1
Uganda,Kenya,1998,3,3,6
Mozambique,Angola,1998,1,1,2
Lebanon,Palestine,1998,3,1,4
Malawi,Zimbabwe,1998,0,0,0
Syria,Jordan,1998,3,0,3
Curaçao,Haiti,1998,0,4,4
Jamaica,Cayman Islands,1998,4,0,4
Martinique,Dominica,1998,5,1,6
Senegal,Cape Verde,1998,1,0,1
Trinidad and Tobago,Antigua and Barbuda,1998,3,2,5
Lebanon,Jordan,1998,0,2,2
Palestine,Syria,1998,1,2,3
Antigua and Barbuda,Dominica,1998,2,1,3
Burkina Faso,Niger,1998,1,0,1
Cayman Islands,Haiti,1998,0,1,1
Jamaica,Curaçao,1998,3,2,5
Trinidad and Tobago,Martinique,1998,2,1,3
Benin,Ghana,1998,0,1,1
Antigua and Barbuda,Martinique,1998,5,1,6
Curaçao,Cayman Islands,1998,0,2,2
Jamaica,Haiti,1998,2,1,3
Jordan,Palestine,1998,1,1,2
Lebanon,Syria,1998,0,1,1
Niger,Ivory Coast,1998,1,0,1
Senegal,Mali,1998,3,1,4
Trinidad and Tobago,Dominica,1998,8,0,8
Jamaica,Antigua and Barbuda,1998,1,0,1
Trinidad and Tobago,Haiti,1998,4,1,5
Guam,Northern Mariana Islands,1998,2,1,3
Antigua and Barbuda,Haiti,1998,2,3,5
Kenya,Djibouti,1998,3,0,3
Libya,Algeria,1998,0,2,2
Trinidad and Tobago,Jamaica,1998,1,2,3
Namibia,Malawi,1998,2,1,3
Palau,Guam,1998,2,15,17
Uganda,Rwanda,1998,5,0,5
Botswana,Mozambique,1998,0,0,0
Burundi,Tanzania,1998,1,0,1
Chad,Congo,1998,1,1,2
Equatorial Guinea,Gabon,1998,0,2,2
Lesotho,Mauritius,1998,1,1,2
Mali,Cape Verde,1998,3,0,3
Niger,Liberia,1998,2,1,3
São Tomé and Príncipe,Togo,1998,0,4,4
Eswatini,Madagascar,1998,1,2,3
Guam,Northern Mariana Islands,1998,0,3,3
Zambia,Namibia,1998,1,1,2
Benin,Niger,1998,1,1,2
Azerbaijan,Georgia,1998,1,0,1
Algeria,Libya,1998,3,0,3
Kenya,Djibouti,1998,9,1,10
Malawi,Namibia,1998,0,1,1
Mozambique,Botswana,1998,2,1,3
Tanzania,Burundi,1998,0,1,1
Thailand,Uzbekistan,1998,4,1,5
Angola,Benin,1998,2,0,2
Cape Verde,Mali,1998,0,0,0
Congo,Chad,1998,0,0,0
Gabon,Equatorial Guinea,1998,3,0,3
Liberia,Niger,1998,2,0,2
Lithuania,Moldova,1998,1,1,2
Rwanda,Uganda,1998,0,0,0
Armenia,Lebanon,1998,1,0,1
Poland,Israel,1998,2,0,2
Togo,São Tomé and Príncipe,1998,2,0,2
Austria,France,1998,2,2,4
Bosnia and Herzegovina,Faroe Islands,1998,1,0,1
Cyprus,Albania,1998,3,2,5
Czech Republic,Denmark,1998,1,0,1
Hungary,Slovenia,1998,2,1,3
Iceland,Latvia,1998,4,1,5
Lithuania,Belarus,1998,0,3,3
Norway,Romania,1998,0,0,0
Portugal,Mozambique,1998,2,1,3
Slovakia,Finland,1998,0,0,0
Sweden,Russia,1998,1,0,1
Ukraine,Georgia,1998,4,0,4
Estonia,Moldova,1998,0,1,1
Burkina Faso,Togo,1998,1,1,2
Mauritius,Lesotho,1998,3,1,4
Malaysia,Singapore,1998,0,2,2
Vietnam,Laos,1998,4,1,5
Indonesia,Philippines,1998,3,0,3
Thailand,Myanmar,1998,1,1,2
Malaysia,Laos,1998,0,0,0
Vietnam,Singapore,1998,0,0,0
Indonesia,Myanmar,1998,6,2,8
Thailand,Philippines,1998,3,1,4
Angola,Zimbabwe,1998,2,1,3
Burkina Faso,Ivory Coast,1998,1,1,2
Singapore,Laos,1998,4,1,5
Vietnam,Malaysia,1998,1,0,1
Burkina Faso,Senegal,1998,1,1,2
Myanmar,Philippines,1998,5,2,7
Thailand,Indonesia,1998,3,2,5
Cook Islands,Samoa,1998,2,1,3
Malta,Germany,1998,1,2,3
Morocco,Senegal,1998,2,0,2
Romania,Liechtenstein,1998,7,0,7
Serbia,Switzerland,1998,1,1,2
Singapore,Indonesia,1998,2,1,3
Tonga,American Samoa,1998,3,0,3
Cook Islands,American Samoa,1998,4,3,7
Tahiti,Tonga,1998,5,0,5
Vietnam,Thailand,1998,3,0,3
Armenia,Andorra,1998,3,1,4
Austria,Israel,1998,1,1,2
Belarus,Denmark,1998,0,0,0
Bosnia and Herzegovina,Estonia,1998,1,1,2
Cook Islands,Tonga,1998,2,2,4
Cyprus,Spain,1998,3,2,5
Fiji,New Caledonia,1998,3,0,3
Finland,Moldova,1998,3,2,5
Georgia,Albania,1998,1,0,1
Germany,Romania,1998,1,1,2
Iceland,France,1998,1,1,2
Indonesia,Thailand,1998,3,3,6
Republic of Ireland,Croatia,1998,2,0,2
Lithuania,Scotland,1998,0,0,0
Slovakia,Azerbaijan,1998,3,0,3
Solomon Islands,Papua New Guinea,1998,3,1,4
Sweden,England,1998,2,1,3
Tahiti,Samoa,1998,5,1,6
Turkey,Northern Ireland,1998,3,0,3
Ukraine,Russia,1998,3,2,5
Vietnam,Singapore,1998,0,1,1
Wales,Italy,1998,0,2,2
Bulgaria,Poland,1998,0,3,3
Faroe Islands,Czech Republic,1998,0,1,1
Greece,Slovenia,1998,2,2,4
Hungary,Portugal,1998,1,3,4
North Macedonia,Malta,1998,4,0,4
Norway,Latvia,1998,1,3,4
Eswatini,Ghana,1998,0,1,1
Togo,Benin,1998,0,1,1
Papua New Guinea,New Caledonia,1998,1,0,1
Samoa,Tonga,1998,2,0,2
Tahiti,American Samoa,1998,12,0,12
Vanuatu,Fiji,1998,1,2,3
Cook Islands,Tahiti,1998,0,5,5
Samoa,American Samoa,1998,4,0,4
Solomon Islands,New Caledonia,1998,3,2,5
Vanuatu,Papua New Guinea,1998,1,1,2
Kuwait,Lebanon,1998,0,0,0
Fiji,Papua New Guinea,1998,2,0,2
Vanuatu,Solomon Islands,1998,3,1,4
Saudi Arabia,Tanzania,1998,8,0,8
Fiji,Solomon Islands,1998,1,1,2
Namibia,Mozambique,1998,2,1,3
Syria,Oman,1998,3,0,3
Vanuatu,New Caledonia,1998,3,2,5
Bahrain,Libya,1998,2,2,4
Kuwait,North Korea,1998,4,0,4
Saudi Arabia,Sudan,1998,2,1,3
Syria,Oman,1998,0,0,0
Egypt,Ivory Coast,1998,0,0,0
Qatar,Sudan,1998,1,1,2
United Arab Emirates,Libya,1998,5,1,6
Saudi Arabia,Senegal,1998,3,2,5
Bahrain,Syria,1998,2,0,2
Solomon Islands,Papua New Guinea,1998,2,1,3
Togo,Mali,1998,0,1,1
Oman,Zambia,1998,2,0,2
Qatar,Libya,1998,2,1,3
Brazil,Serbia,1998,1,1,2
Estonia,Egypt,1998,2,2,4
Spain,Russia,1998,1,0,1
Libya,Jordan,1998,1,2,3
Oman,Zambia,1998,1,1,2
Australia,Fiji,1998,3,1,4
New Zealand,Tahiti,1998,1,0,1
Kuwait,Syria,1998,4,0,4
Qatar,Jordan,1998,2,0,2
Mali,Burkina Faso,1998,1,0,1
Saudi Arabia,Lebanon,1998,4,1,5
United Arab Emirates,Sudan,1998,4,1,5
Zimbabwe,Zambia,1998,0,1,1
Australia,Cook Islands,1998,16,0,16
New Zealand,Vanuatu,1998,8,1,9
North Macedonia,Egypt,1998,2,2,4
Qatar,United Arab Emirates,1998,2,1,3
Saudi Arabia,Kuwait,1998,2,1,3
Fiji,Cook Islands,1998,3,0,3
Tahiti,Vanuatu,1998,5,1,6
Kuwait,United Arab Emirates,1998,4,1,5
Qatar,Saudi Arabia,1998,1,3,4
Australia,Tahiti,1998,4,1,5
New Zealand,Fiji,1998,1,0,1
Bahrain,Sudan,1998,2,3,5
Kenya,Madagascar,1998,1,1,2
Morocco,Sierra Leone,1998,3,0,3
Namibia,Congo,1998,0,1,1
South Africa,Angola,1998,1,0,1
Australia,New Zealand,1998,0,1,1
Burkina Faso,Nigeria,1998,0,0,0
Cameroon,Ghana,1998,1,3,4
Gabon,Mauritius,1998,2,0,2
Mali,Ivory Coast,1998,0,1,1
Mozambique,Eritrea,1998,3,1,4
Tahiti,Fiji,1998,2,4,6
Togo,Guinea,1998,2,0,2
Tunisia,Liberia,1998,2,1,3
Zambia,DR Congo,1998,1,1,2
Andorra,Ukraine,1998,0,2,2
Armenia,Iceland,1998,0,0,0
Azerbaijan,Hungary,1998,0,4,4
Bosnia and Herzegovina,Czech Republic,1998,1,3,4
Cyprus,Austria,1998,0,3,3
Denmark,Wales,1998,1,2,3
England,Bulgaria,1998,0,0,0
Italy,Switzerland,1998,2,0,2
Latvia,Georgia,1998,1,0,1
Liechtenstein,Slovakia,1998,0,4,4
Lithuania,Faroe Islands,1998,0,0,0
Malta,Croatia,1998,1,4,5
Netherlands,Peru,1998,2,0,2
Northern Ireland,Finland,1998,1,0,1
Poland,Luxembourg,1998,3,0,3
Portugal,Romania,1998,0,1,1
Russia,France,1998,2,3,5
San Marino,Israel,1998,0,5,5
Scotland,Estonia,1998,3,2,5
Slovenia,Norway,1998,1,2,3
Turkey,Germany,1998,1,0,1
Kuwait,Iran,1998,3,0,3
Netherlands,Ghana,1998,0,0,0
Brazil,Ecuador,1998,5,1,6
Bulgaria,Sweden,1998,0,1,1
Croatia,North Macedonia,1998,3,2,5
Czech Republic,Estonia,1998,4,1,5
France,Andorra,1998,2,0,2
Greece,Georgia,1998,3,0,3
Hungary,Romania,1998,1,1,2
Iceland,Russia,1998,1,0,1
Republic of Ireland,Malta,1998,5,0,5
Israel,Spain,1998,1,2,3
Liechtenstein,Azerbaijan,1998,2,1,3
Lithuania,Bosnia and Herzegovina,1998,4,2,6
Luxembourg,England,1998,0,3,3
Moldova,Germany,1998,1,3,4
Norway,Albania,1998,2,2,4
San Marino,Austria,1998,1,4,5
Scotland,Faroe Islands,1998,2,1,3
Slovakia,Portugal,1998,0,3,3
Slovenia,Latvia,1998,1,0,1
Switzerland,Denmark,1998,1,1,2
Turkey,Finland,1998,1,3,4
Ukraine,Armenia,1998,2,0,2
Wales,Belarus,1998,3,2,5
Lebanon,Syria,1998,3,3,6
Qatar,Burkina Faso,1998,2,2,4
United Arab Emirates,Sudan,1998,2,1,3
Lebanon,Sudan,1998,1,1,2
Oman,Burkina Faso,1998,4,2,6
United Arab Emirates,Syria,1998,1,0,1
Oman,Burkina Faso,1998,0,0,0
Sudan,Syria,1998,2,3,5
United Arab Emirates,Lebanon,1998,1,0,1
Bahrain,Burkina Faso,1998,2,1,3
Japan,Egypt,1998,1,0,1
Bahrain,United Arab Emirates,1998,0,1,1
Kuwait,Saudi Arabia,1998,1,2,3
Oman,Qatar,1998,2,1,3
Bahrain,Saudi Arabia,1998,1,1,2
Kuwait,Qatar,1998,6,2,8
United Arab Emirates,Oman,1998,3,2,5
Bulgaria,Algeria,1998,0,0,0
Oman,Saudi Arabia,1998,0,1,1
Qatar,United Arab Emirates,1998,0,0,0
Bahrain,Kuwait,1998,0,2,2
United States,Australia,1998,0,0,0
Tunisia,Zimbabwe,1998,1,1,2
Bahrain,Qatar,1998,0,0,0
Saudi Arabia,United Arab Emirates,1998,1,0,1
Oman,Kuwait,1998,0,5,5
Slovakia,Poland,1998,1,3,4
Tunisia,Latvia,1998,3,0,3
Qatar,Saudi Arabia,1998,0,0,0
Bahrain,Oman,1998,2,2,4
United Arab Emirates,Kuwait,1998,1,4,5
Sri Lanka,Maldives,1998,2,2,4
India,Uzbekistan,1998,0,0,0
El Salvador,Mexico,1998,0,2,2
Guatemala,Honduras,1998,3,3,6
Albania,Greece,1998,0,0,0
Brazil,Russia,1998,5,1,6
Egypt,Norway,1998,1,1,2
El Salvador,Honduras,1998,1,2,3
England,Czech Republic,1998,2,0,2
Georgia,Estonia,1998,3,1,4
Germany,Netherlands,1998,1,1,2
Guatemala,Mexico,1998,2,2,4
Hungary,Switzerland,1998,2,0,2
Italy,Spain,1998,2,2,4
Luxembourg,Belgium,1998,0,0,0
Malta,North Macedonia,1998,1,2,3
Northern Ireland,Moldova,1998,2,2,4
Portugal,Israel,1998,2,0,2
San Marino,Cyprus,1998,0,1,1
Serbia,Republic of Ireland,1998,1,0,1
Hong Kong,Vietnam,1998,1,1,2
India,Uzbekistan,1998,0,4,4
Armenia,Estonia,1998,2,1,3
Thailand,Turkmenistan,1998,3,3,6
Guernsey,Kernow,1998,1,6,7
China PR,South Korea,1998,0,0,0
Singapore,United Arab Emirates,1998,0,4,4
Thailand,Nepal,1998,2,0,2
Azerbaijan,Estonia,1998,2,1,3
United Arab Emirates,North Korea,1998,3,3,6
Mali,Ghana,1998,0,2,2
British Virgin Islands,Saint Vincent and the Grenadines,1998,0,5,5
Burundi,Senegal,1998,1,0,1
South Africa,Egypt,1998,2,1,3
Basque Country,Uruguay,1998,5,1,6
Catalonia,Nigeria,1998,5,0,5
Canary Islands,Latvia,1998,4,0,4
Israel,Serbia,1998,2,0,2
Kuwait,Egypt,1998,1,1,2
Ivory Coast,Togo,1999,3,1,4
Burkina Faso,Gabon,1999,2,1,3
Burkina Faso,Mali,1999,1,0,1
Senegal,Guinea,1999,1,0,1
Bermuda,Antigua and Barbuda,1999,1,0,1
Senegal,Guinea,1999,1,0,1
Bermuda,Antigua and Barbuda,1999,0,1,1
Burkina Faso,Mali,1999,4,1,5
Israel,Estonia,1999,7,0,7
France,Morocco,1999,1,0,1
Israel,Norway,1999,0,1,1
Estonia,Norway,1999,3,3,6
Eritrea,Cameroon,1999,0,0,0
Mauritius,South Africa,1999,1,1,2
Nigeria,Burundi,1999,2,0,2
Senegal,Burkina Faso,1999,1,1,2
Zimbabwe,Malawi,1999,3,0,3
Angola,Gabon,1999,3,1,4
Bolivia,United States,1999,0,0,0
Congo,Mali,1999,0,0,0
DR Congo,Kenya,1999,2,1,3
Ghana,Mozambique,1999,1,0,1
Guinea,Morocco,1999,1,1,2
Ivory Coast,Namibia,1999,3,0,3
Liberia,Uganda,1999,2,0,2
Madagascar,Zambia,1999,1,2,3
Zimbabwe,Malawi,1999,1,0,1
Malta,Bosnia and Herzegovina,1999,2,1,3
Costa Rica,Ecuador,1999,0,0,0
Vietnam,Singapore,1999,1,0,1
Ethiopia,Kenya,1999,2,2,4
Cyprus,Belgium,1999,0,1,1
Greece,Finland,1999,2,1,3
Malta,Poland,1999,0,1,1
Martinique,French Guiana,1999,3,1,4
Venezuela,Argentina,1999,0,2,2
British Virgin Islands,Montserrat,1999,3,1,4
Cyprus,Finland,1999,2,1,3
Greece,Belgium,1999,1,0,1
Slovenia,Switzerland,1999,0,2,2
United States,Germany,1999,3,0,3
British Virgin Islands,Montserrat,1999,3,0,3
Lesotho,Namibia,1999,1,0,1
Oman,Slovenia,1999,0,7,7
Belgium,Czech Republic,1999,0,1,1
Colombia,Germany,1999,3,3,6
Israel,Belarus,1999,2,1,3
Albania,North Macedonia,1999,2,0,2
Croatia,Denmark,1999,0,1,1
Cyprus,San Marino,1999,4,0,4
England,France,1999,0,2,2
Finland,Poland,1999,1,1,2
Republic of Ireland,Paraguay,1999,2,0,2
Italy,Norway,1999,0,0,0
Jamaica,Costa Rica,1999,1,1,2
Malta,Serbia,1999,0,3,3
Mexico,Argentina,1999,0,1,1
Oman,Switzerland,1999,1,2,3
Peru,Ecuador,1999,1,2,3
Portugal,Netherlands,1999,0,0,0
Tunisia,Sweden,1999,0,1,1
Saint Lucia,Antigua and Barbuda,1999,0,0,0
Kuwait,Iran,1999,1,2,3
Bulgaria,Egypt,1999,1,3,4
Ecuador,Peru,1999,1,2,3
Guatemala,Chile,1999,1,1,2
Egypt,Mexico,1999,0,3,3
Botswana,South Africa,1999,1,2,3
Gabon,Burkina Faso,1999,1,1,2
Zimbabwe,Zambia,1999,1,1,2
United States,Chile,1999,2,1,3
Suriname,Guyana,1999,2,1,3
Thailand,North Korea,1999,2,2,4
Bahamas,Turks and Caicos Islands,1999,3,0,3
Costa Rica,Jamaica,1999,9,0,9
Israel,Latvia,1999,2,0,2
Saint Lucia,Grenada,1999,1,2,3
United States Virgin Islands,Turks and Caicos Islands,1999,2,2,4
South Africa,Gabon,1999,4,1,5
Angola,Mauritius,1999,0,2,2
Bahamas,United States Virgin Islands,1999,0,0,0
British Virgin Islands,Antigua and Barbuda,1999,0,2,2
Burundi,Burkina Faso,1999,1,2,3
Cameroon,Mozambique,1999,1,0,1
Congo,Ivory Coast,1999,1,0,1
Ghana,Eritrea,1999,5,0,5
Guyana,Barbados,1999,2,2,4
Kenya,Zambia,1999,0,1,1
Liberia,Algeria,1999,1,1,2
Madagascar,DR Congo,1999,3,1,4
Senegal,Nigeria,1999,1,1,2
Togo,Morocco,1999,2,3,5
Bolivia,Jamaica,1999,0,0,0
Bulgaria,Slovakia,1999,2,0,2
Guatemala,Paraguay,1999,2,3,5
Poland,Armenia,1999,1,0,1
Romania,Estonia,1999,2,0,2
Guatemala,Bolivia,1999,0,3,3
Jamaica,Paraguay,1999,1,3,4
Azerbaijan,Estonia,1999,2,2,4
Barbados,Guyana,1999,2,0,2
Bolivia,Paraguay,1999,0,3,3
Guatemala,Jamaica,1999,2,4,6
Barbados,Antigua and Barbuda,1999,2,0,2
Greece,Croatia,1999,3,2,5
Guadeloupe,Dominica,1999,1,0,1
Hungary,Bosnia and Herzegovina,1999,1,1,2
Luxembourg,Iceland,1999,1,2,3
Malta,Moldova,1999,0,2,2
Romania,Israel,1999,0,2,2
Switzerland,Austria,1999,2,4,6
Mexico,Bolivia,1999,2,1,3
United States,Guatemala,1999,3,1,4
Barbados,Dominica,1999,3,1,4
Guadeloupe,Antigua and Barbuda,1999,2,1,3
Guatemala,Bolivia,1999,2,1,3
United States,Mexico,1999,1,2,3
Antigua and Barbuda,Dominica,1999,1,1,2
Guadeloupe,Barbados,1999,1,0,1
Cyprus,Estonia,1999,1,2,3
British Virgin Islands,Dominican Republic,1999,0,0,0
Costa Rica,Belize,1999,7,0,7
Guatemala,Nicaragua,1999,1,0,1
Haiti,Puerto Rico,1999,2,0,2
British Virgin Islands,Puerto Rico,1999,5,0,5
Guatemala,El Salvador,1999,1,1,2
Haiti,Dominican Republic,1999,4,0,4
Honduras,Belize,1999,5,1,6
Georgia,Ukraine,1999,0,1,1
Costa Rica,Honduras,1999,0,1,1
Dominican Republic,Puerto Rico,1999,2,0,2
El Salvador,Nicaragua,1999,1,0,1
Haiti,British Virgin Islands,1999,6,0,6
Costa Rica,Guatemala,1999,1,0,1
Honduras,El Salvador,1999,3,1,4
Costa Rica,Honduras,1999,1,2,3
Guatemala,El Salvador,1999,1,0,1
Portugal,Azerbaijan,1999,7,0,7
Andorra,Iceland,1999,0,2,2
Armenia,Russia,1999,0,3,3
Belarus,Switzerland,1999,0,1,1
Belgium,Bulgaria,1999,0,1,1
Czech Republic,Lithuania,1999,2,0,2
Denmark,Italy,1999,1,2,3
England,Poland,1999,3,1,4
France,Ukraine,1999,0,0,0
Georgia,Slovenia,1999,1,1,2
Greece,Norway,1999,0,2,2
Hungary,Liechtenstein,1999,5,0,5
Northern Ireland,Germany,1999,0,3,3
Romania,Slovakia,1999,0,0,0
Spain,Austria,1999,9,0,9
Sweden,Luxembourg,1999,2,0,2
Turkey,Moldova,1999,2,0,2
Costa Rica,El Salvador,1999,4,0,4
Honduras,Guatemala,1999,0,2,2
Israel,Cyprus,1999,3,0,3
South Korea,Brazil,1999,1,0,1
Trinidad and Tobago,Jamaica,1999,2,0,2
Belgium,Egypt,1999,0,1,1
Venezuela,Colombia,1999,0,0,0
Azerbaijan,Romania,1999,0,1,1
France,Armenia,1999,2,0,2
Germany,Finland,1999,2,0,2
Italy,Belarus,1999,1,1,2
Jamaica,Paraguay,1999,3,0,3
Japan,Brazil,1999,0,2,2
Latvia,Greece,1999,0,0,0
Liechtenstein,Portugal,1999,0,5,5
Lithuania,Estonia,1999,1,2,3
Luxembourg,Bulgaria,1999,0,2,2
Moldova,Northern Ireland,1999,0,0,0
Netherlands,Argentina,1999,1,1,2
Poland,Sweden,1999,0,1,1
Russia,Andorra,1999,6,1,7
San Marino,Spain,1999,0,6,6
Scotland,Czech Republic,1999,1,2,3
Slovakia,Hungary,1999,0,0,0
Switzerland,Wales,1999,2,0,2
Ukraine,Iceland,1999,1,1,2
Mali,Burkina Faso,1999,5,2,7
Eswatini,Namibia,1999,1,1,2
Algeria,Liberia,1999,4,1,5
Gabon,South Africa,1999,1,0,1
Mauritius,Angola,1999,1,1,2
Uganda,Tunisia,1999,0,2,2
Zambia,Kenya,1999,1,0,1
Burkina Faso,Burundi,1999,3,1,4
DR Congo,Madagascar,1999,2,0,2
Ivory Coast,Congo,1999,2,0,2
Mali,Namibia,1999,2,1,3
Mozambique,Cameroon,1999,1,6,7
Saint Vincent and the Grenadines,Grenada,1999,2,1,3
Mexico,Ecuador,1999,0,0,0
Venezuela,Colombia,1999,1,1,2
Saint Lucia,Martinique,1999,3,1,4
Saint Vincent and the Grenadines,Saint Kitts and Nevis,1999,3,4,7
Martinique,Saint Kitts and Nevis,1999,2,1,3
Saint Vincent and the Grenadines,Saint Lucia,1999,2,2,4
Saint Kitts and Nevis,Saint Lucia,1999,4,3,7
India,Bangladesh,1999,0,0,0
Paraguay,Colombia,1999,0,2,2
Sri Lanka,Maldives,1999,0,0,0
Malawi,Angola,1999,1,2,3
Pakistan,Bangladesh,1999,0,4,4
Sri Lanka,Nepal,1999,2,3,5
Eswatini,Lesotho,1999,4,1,5
India,Pakistan,1999,2,0,2
Nepal,Maldives,1999,2,3,5
Northern Ireland,Canada,1999,1,1,2
Austria,San Marino,1999,7,0,7
Bolivia,Chile,1999,1,1,2
Croatia,Italy,1999,0,0,0
Denmark,South Africa,1999,1,1,2
Georgia,Norway,1999,1,4,5
Germany,Scotland,1999,0,1,1
Greece,Switzerland,1999,1,1,2
Hungary,England,1999,1,1,2
Republic of Ireland,Sweden,1999,2,0,2
Latvia,Albania,1999,0,0,0
Malta,Iceland,1999,1,2,3
Netherlands,Morocco,1999,1,2,3
Paraguay,Mexico,1999,2,1,3
Poland,Czech Republic,1999,2,1,3
Romania,Belgium,1999,1,0,1
Slovenia,Finland,1999,1,1,2
Bangladesh,Nepal,1999,2,1,3
India,Maldives,1999,2,1,3
India,Bangladesh,1999,2,0,2
Maldives,Nepal,1999,2,0,2
Guernsey,Jersey,1999,2,0,2
Curaçao,Grenada,1999,1,3,4
Bermuda,Bahamas,1999,6,0,6
Cuba,Cayman Islands,1999,4,1,5
Spain,Croatia,1999,3,1,4
Grenada,Suriname,1999,0,0,0
Trinidad and Tobago,South Africa,1999,2,0,2
Bermuda,Cayman Islands,1999,4,1,5
Cuba,Bahamas,1999,7,0,7
Curaçao,Suriname,1999,1,1,2
Namibia,Mali,1999,0,0,0
Bermuda,Cuba,1999,1,2,3
Cayman Islands,Bahamas,1999,4,1,5
Jamaica,South Africa,1999,1,1,2
Eswatini,Mozambique,1999,3,1,4
Libya,Senegal,1999,2,1,3
Eswatini,Botswana,1999,2,1,3
Russia,Belarus,1999,1,1,2
Slovakia,Bulgaria,1999,2,0,2
Norway,Jamaica,1999,6,0,6
Haiti,Honduras,1999,0,2,2
Malawi,Namibia,1999,1,1,2
Uganda,Zambia,1999,0,1,1
Sweden,Jamaica,1999,2,1,3
Botswana,Mozambique,1999,0,2,2
Canada,Guatemala,1999,1,0,1
Chile,Costa Rica,1999,3,0,3
El Salvador,Colombia,1999,2,1,3
Republic of Ireland,Northern Ireland,1999,0,1,1
Saint Kitts and Nevis,Antigua and Barbuda,1999,4,1,5
Belgium,Peru,1999,1,1,2
Lesotho,Mauritius,1999,1,2,3
Norway,Georgia,1999,1,0,1
Mali,Senegal,1999,1,1,2
Canada,Guatemala,1999,2,0,2
Ecuador,Iran,1999,1,1,2
Grenada,Guadeloupe,1999,2,1,3
Japan,Belgium,1999,0,0,0
Trinidad and Tobago,Jamaica,1999,1,0,1
Canada,Iran,1999,0,1,1
Cuba,Haiti,1999,3,1,4
Ecuador,Guatemala,1999,3,1,4
Germany,Moldova,1999,6,1,7
Poland,Bulgaria,1999,2,0,2
Albania,Norway,1999,1,2,3
Azerbaijan,Liechtenstein,1999,4,0,4
Bosnia and Herzegovina,Lithuania,1999,2,0,2
Brazil,Netherlands,1999,2,2,4
Denmark,Belarus,1999,1,0,1
England,Sweden,1999,0,0,0
Estonia,Czech Republic,1999,0,2,2
Faroe Islands,Scotland,1999,1,1,2
Finland,Turkey,1999,2,4,6
France,Russia,1999,2,3,5
Georgia,Greece,1999,1,2,3
Guam,Micronesia,1999,3,0,3
Iceland,Armenia,1999,2,0,2
Italy,Wales,1999,4,0,4
Jamaica,Guadeloupe,1999,5,1,6
South Korea,Belgium,1999,1,2,3
Latvia,Slovenia,1999,1,2,3
North Macedonia,Croatia,1999,1,1,2
Namibia,Ivory Coast,1999,1,1,2
Portugal,Slovakia,1999,1,0,1
Romania,Hungary,1999,2,0,2
South Africa,Mauritius,1999,2,0,2
Spain,San Marino,1999,9,0,9
Trinidad and Tobago,Grenada,1999,7,0,7
Uganda,Liberia,1999,1,0,1
Ukraine,Andorra,1999,4,0,4
Burkina Faso,Senegal,1999,2,2,4
Cameroon,Eritrea,1999,1,0,1
Canada,Ecuador,1999,1,2,3
Gabon,Angola,1999,3,1,4
Guatemala,Iran,1999,2,2,4
Haiti,Saint Kitts and Nevis,1999,2,0,2
Israel,Austria,1999,5,0,5
Japan,Peru,1999,0,0,0
Kenya,DR Congo,1999,0,1,1
Mali,Congo,1999,3,1,4
Morocco,Guinea,1999,1,0,1
Tunisia,Algeria,1999,2,0,2
Jamaica,Grenada,1999,2,1,3
Trinidad and Tobago,Guadeloupe,1999,3,2,5
Brazil,Netherlands,1999,3,1,4
Cuba,Saint Kitts and Nevis,1999,2,0,2
Serbia,Malta,1999,4,1,5
Albania,Slovenia,1999,0,1,1
Andorra,France,1999,0,1,1
Armenia,Ukraine,1999,0,0,0
Bulgaria,England,1999,1,1,2
Czech Republic,Scotland,1999,3,2,5
Estonia,Lithuania,1999,1,2,3
Faroe Islands,Bosnia and Herzegovina,1999,2,2,4
Greece,Latvia,1999,1,2,3
Hungary,Slovakia,1999,0,1,1
Republic of Ireland,North Macedonia,1999,1,0,1
Luxembourg,Poland,1999,2,3,5
Mexico,Argentina,1999,2,2,4
Moldova,Finland,1999,0,0,0
Portugal,Liechtenstein,1999,8,0,8
Romania,Azerbaijan,1999,4,0,4
Russia,Iceland,1999,1,0,1
Switzerland,Italy,1999,0,0,0
Wales,Denmark,1999,0,2,2
Cuba,Jamaica,1999,2,0,2
Guam,Micronesia,1999,4,1,5
Trinidad and Tobago,Haiti,1999,6,1,7
South Korea,Mexico,1999,1,1,2
Croatia,Egypt,1999,2,2,4
Kenya,Zanzibar,1999,0,1,1
Trinidad and Tobago,Cuba,1999,2,1,3
United States,Argentina,1999,1,0,1
Venezuela,Ecuador,1999,3,2,5
Brazil,Poland,1999,2,0,2
Croatia,Mexico,1999,2,1,3
South Korea,Egypt,1999,0,0,0
South Africa,Zimbabwe,1999,0,1,1
Thailand,New Zealand,1999,2,2,4
Colombia,Peru,1999,3,3,6
Paraguay,Uruguay,1999,2,3,5
Egypt,Mexico,1999,0,2,2
Saudi Arabia,Jordan,1999,2,1,3
Eritrea,Mozambique,1999,1,0,1
South Korea,Croatia,1999,1,1,2
New Zealand,Poland,1999,0,0,0
Senegal,Burundi,1999,1,0,1
Thailand,Brazil,1999,0,2,2
Algeria,Uganda,1999,2,0,2
Angola,South Africa,1999,2,2,4
Chile,Bolivia,1999,1,0,1
Congo,Namibia,1999,3,0,3
DR Congo,Zambia,1999,0,1,1
Guinea,Togo,1999,2,1,3
Ivory Coast,Mali,1999,0,0,0
Liberia,Tunisia,1999,2,0,2
Madagascar,Kenya,1999,1,1,2
Mauritius,Gabon,1999,2,2,4
Venezuela,Peru,1999,3,0,3
Oman,New Zealand,1999,1,0,1
Saudi Arabia,Jordan,1999,2,0,2
Uganda,Zambia,1999,0,1,1
Peru,Venezuela,1999,3,0,3
Oman,New Zealand,1999,2,2,4
Paraguay,Colombia,1999,2,1,3
Argentina,Lithuania,1999,0,0,0
Brazil,Latvia,1999,3,0,3
Jersey,Åland Islands,1999,1,0,1
Gotland,Hitra,1999,12,1,13
Isle of Man,Shetland,1999,2,1,3
Isle of Wight,Frøya,1999,6,2,8
Greenland,Saare County,1999,4,1,5
Ynys Môn,Rhodes,1999,1,1,2
Jordan,Iraq,1999,0,1,1
Åland Islands,Gibraltar,1999,2,1,3
Gotland,Shetland,1999,3,1,4
Hitra,Isle of Man,1999,0,13,13
Frøya,Greenland,1999,1,3,4
Saare County,Isle of Wight,1999,1,6,7
Rhodes,Guernsey,1999,0,0,0
Paraguay,Bolivia,1999,0,0,0
Peru,Japan,1999,3,2,5
Singapore,New Zealand,1999,0,1,1
Zimbabwe,Egypt,1999,1,1,2
Gibraltar,Jersey,1999,1,5,6
Gotland,Isle of Man,1999,4,4,8
Shetland,Hitra,1999,4,1,5
Isle of Wight,Greenland,1999,7,2,9
Saare County,Frøya,1999,1,4,5
Guernsey,Ynys Môn,1999,1,1,2
Brazil,Venezuela,1999,7,0,7
Chile,Mexico,1999,0,1,1
Jordan,Iraq,1999,1,1,2
Argentina,Ecuador,1999,3,1,4
Malaysia,New Zealand,1999,2,1,3
Uruguay,Colombia,1999,0,1,1
Hitra,Saare County,1999,2,1,3
Guernsey,Frøya,1999,4,2,6
Shetland,Gibraltar,1999,3,2,5
Greenland,Rhodes,1999,0,2,2
Gotland,Åland Islands,1999,1,4,5
Gotland,Greenland,1999,7,2,9
Isle of Wight,Ynys Môn,1999,1,3,4
Isle of Man,Jersey,1999,1,0,1
Lithuania,Indonesia,1999,2,2,4
Paraguay,Japan,1999,4,0,4
Peru,Bolivia,1999,1,0,1
Gibraltar,Frøya,1999,5,1,6
Guernsey,Shetland,1999,6,5,11
Rhodes,Åland Islands,1999,3,2,5
Isle of Wight,Jersey,1999,2,0,2
Ynys Môn,Isle of Man,1999,1,0,1
Brazil,Mexico,1999,2,1,3
Chile,Venezuela,1999,3,0,3
Malaysia,New Zealand,1999,1,5,6
Argentina,Colombia,1999,0,3,3
Lesotho,Angola,1999,0,1,1
Uruguay,Ecuador,1999,2,1,3
Bolivia,Japan,1999,1,1,2
Paraguay,Peru,1999,1,0,1
Brazil,Chile,1999,1,0,1
Malawi,Uganda,1999,0,2,2
Mexico,Venezuela,1999,3,1,4
Colombia,Ecuador,1999,2,1,3
Uruguay,Argentina,1999,0,2,2
Canada,Saudi Arabia,1999,0,2,2
Egypt,New Zealand,1999,1,1,2
Mexico,Peru,1999,3,3,6
Paraguay,Uruguay,1999,1,1,2
Brazil,Argentina,1999,2,1,3
Chile,Colombia,1999,3,2,5
Uzbekistan,Malaysia,1999,3,0,3
Micronesia,Northern Mariana Islands,1999,7,0,7
Jamaica,Saudi Arabia,1999,2,1,3
Uruguay,Chile,1999,1,1,2
Mexico,Brazil,1999,0,2,2
Egypt,New Zealand,1999,1,0,1
Jamaica,Saudi Arabia,1999,0,4,4
Jordan,Syria,1999,1,0,1
Chile,Mexico,1999,1,2,3
Costa Rica,Saudi Arabia,1999,1,0,1
Brazil,Uruguay,1999,3,0,3
Jordan,Syria,1999,4,0,4
Senegal,Eritrea,1999,6,2,8
Eswatini,Zimbabwe,1999,1,1,2
Oman,Kenya,1999,2,2,4
Brazil,Germany,1999,4,0,4
New Zealand,United States,1999,1,2,3
Rwanda,Djibouti,1999,4,1,5
Thailand,Uzbekistan,1999,1,0,1
Bolivia,Egypt,1999,2,2,4
Burundi,Uganda,1999,0,0,0
Ethiopia,Zanzibar,1999,2,0,2
Mexico,Saudi Arabia,1999,5,1,6
Tanzania,Djibouti,1999,2,1,3
Burundi,Somalia,1999,3,0,3
Ethiopia,Sudan,1999,0,0,0
Mexico,Egypt,1999,2,2,4
Saudi Arabia,Bolivia,1999,0,0,0
Brazil,United States,1999,1,0,1
El Salvador,Guatemala,1999,0,2,2
Germany,New Zealand,1999,2,0,2
Kenya,Eritrea,1999,1,0,1
Rwanda,Tanzania,1999,0,0,0
Egypt,Saudi Arabia,1999,1,5,6
Mexico,Bolivia,1999,1,0,1
Somalia,Uganda,1999,0,2,2
Sudan,Zanzibar,1999,1,1,2
New Zealand,Brazil,1999,0,2,2
United States,Germany,1999,2,0,2
Burundi,Tanzania,1999,1,0,1
Namibia,South Africa,1999,1,1,2
Rwanda,Uganda,1999,1,0,1
Brazil,Saudi Arabia,1999,8,2,10
Kenya,Sudan,1999,3,0,3
Mexico,United States,1999,1,0,1
Oman,Kyrgyzstan,1999,3,0,3
Rwanda,Kenya,1999,0,0,0
Tajikistan,Iraq,1999,1,2,3
United States,Saudi Arabia,1999,2,0,2
Mexico,Brazil,1999,4,3,7
Iraq,Oman,1999,2,0,2
Tajikistan,Kyrgyzstan,1999,3,2,5
Ghana,Jamaica,1999,2,1,3
Iraq,Kyrgyzstan,1999,5,1,6
Rwanda,Burundi,1999,0,0,0
Tajikistan,Oman,1999,2,1,3
Zambia,Mozambique,1999,1,1,2
Senegal,Zimbabwe,1999,2,0,2
Zambia,Angola,1999,0,1,1
Lesotho,Eswatini,1999,0,3,3
Zimbabwe,Eritrea,1999,4,0,4
Mozambique,Nigeria,1999,0,1,1
Belarus,Russia,1999,0,2,2
Belgium,Finland,1999,3,4,7
Cyprus,Romania,1999,2,2,4
Czech Republic,Switzerland,1999,3,0,3
Denmark,Netherlands,1999,0,0,0
Estonia,Armenia,1999,2,0,2
Faroe Islands,Iceland,1999,0,1,1
Greece,El Salvador,1999,3,1,4
Hungary,Moldova,1999,1,1,2
Liechtenstein,Bosnia and Herzegovina,1999,0,0,0
Northern Ireland,France,1999,0,1,1
Norway,Lithuania,1999,1,0,1
Poland,Spain,1999,1,2,3
Portugal,Andorra,1999,4,0,4
Serbia,Croatia,1999,0,0,0
Slovakia,Israel,1999,1,0,1
Slovenia,Albania,1999,2,0,2
Sweden,Austria,1999,0,0,0
Ukraine,Bulgaria,1999,1,1,2
Uruguay,Costa Rica,1999,5,4,9
Uzbekistan,Azerbaijan,1999,5,1,6
Greece,El Salvador,1999,3,0,3
Croatia,Malta,1999,2,1,3
Bolivia,Venezuela,1999,0,0,0
Namibia,Eswatini,1999,1,1,2
Nigeria,Ghana,1999,0,0,0
Republic of Ireland,Serbia,1999,2,1,3
Canada,Jamaica,1999,1,0,1
Albania,Latvia,1999,3,3,6
Argentina,Brazil,1999,2,0,2
Austria,Spain,1999,1,3,4
Belarus,Wales,1999,1,2,3
Bosnia and Herzegovina,Scotland,1999,1,2,3
Croatia,Republic of Ireland,1999,1,0,1
Denmark,Switzerland,1999,2,1,3
England,Luxembourg,1999,6,0,6
Faroe Islands,Estonia,1999,0,2,2
Finland,Germany,1999,1,2,3
Iceland,Andorra,1999,3,0,3
Liechtenstein,Hungary,1999,0,0,0
Lithuania,Czech Republic,1999,0,4,4
Netherlands,Belgium,1999,5,5,10
Northern Ireland,Turkey,1999,0,3,3
Norway,Greece,1999,1,0,1
Russia,Armenia,1999,2,0,2
Slovakia,Romania,1999,1,5,6
Slovenia,Georgia,1999,2,1,3
Sweden,Bulgaria,1999,1,0,1
Ukraine,France,1999,0,0,0
Cyprus,Israel,1999,3,2,5
Serbia,North Macedonia,1999,3,1,4
Belgium,Morocco,1999,4,0,4
Brazil,Argentina,1999,4,2,6
Andorra,Russia,1999,1,2,3
Armenia,France,1999,2,3,5
Czech Republic,Bosnia and Herzegovina,1999,3,0,3
Estonia,Scotland,1999,0,0,0
Faroe Islands,Lithuania,1999,0,1,1
Georgia,Latvia,1999,2,2,4
Germany,Northern Ireland,1999,4,0,4
Hungary,Azerbaijan,1999,3,0,3
Iceland,Ukraine,1999,0,1,1
Israel,San Marino,1999,8,0,8
Italy,Denmark,1999,2,3,5
Jamaica,United States,1999,2,2,4
Japan,Iran,1999,1,1,2
Luxembourg,Sweden,1999,0,1,1
North Macedonia,Serbia,1999,2,4,6
Malta,Republic of Ireland,1999,2,3,5
Moldova,Turkey,1999,1,1,2
Norway,Slovenia,1999,4,0,4
Poland,England,1999,0,0,0
Romania,Portugal,1999,1,1,2
Slovakia,Liechtenstein,1999,2,0,2
Spain,Cyprus,1999,8,0,8
Switzerland,Belarus,1999,2,0,2
Trinidad and Tobago,Colombia,1999,4,3,7
Uruguay,Venezuela,1999,2,0,2
Zambia,Saudi Arabia,1999,0,0,0
Bermuda,Cayman Islands,1999,3,1,4
Dominica,Saint Lucia,1999,0,2,2
Bermuda,Cayman Islands,1999,1,0,1
Zambia,Saudi Arabia,1999,1,2,3
South Africa,Saudi Arabia,1999,1,0,1
Cayman Islands,Bahamas,1999,4,0,4
Angola,Namibia,1999,1,0,1
Haiti,Venezuela,1999,3,2,5
Saudi Arabia,South Africa,1999,0,0,0
Namibia,Angola,1999,1,1,2
Scotland,Bosnia and Herzegovina,1999,1,0,1
Canada,Cuba,1999,0,0,0
El Salvador,Haiti,1999,1,1,2
Greece,Albania,1999,2,0,2
Canada,El Salvador,1999,2,1,3
Cuba,Haiti,1999,0,1,1
Albania,Georgia,1999,2,1,3
Andorra,Armenia,1999,0,3,3
Azerbaijan,Slovakia,1999,0,1,1
Belarus,Italy,1999,0,0,0
Croatia,Serbia,1999,2,2,4
Czech Republic,Faroe Islands,1999,2,0,2
Estonia,Bosnia and Herzegovina,1999,1,4,5
Finland,Northern Ireland,1999,4,1,5
France,Iceland,1999,3,2,5
Germany,Turkey,1999,0,0,0
Latvia,Norway,1999,1,2,3
Liechtenstein,Romania,1999,0,3,3
North Macedonia,Republic of Ireland,1999,1,1,2
Netherlands,Brazil,1999,2,2,4
Portugal,Hungary,1999,3,0,3
Russia,Ukraine,1999,1,1,2
Scotland,Lithuania,1999,3,0,3
Slovenia,Greece,1999,0,3,3
Sweden,Poland,1999,2,0,2
Wales,Switzerland,1999,0,2,2
Austria,Cyprus,1999,3,1,4
Bulgaria,Luxembourg,1999,3,0,3
Canada,Haiti,1999,2,1,3
Cuba,El Salvador,1999,3,1,4
Denmark,Iran,1999,0,0,0
England,Belgium,1999,2,1,3
Spain,Israel,1999,3,0,3
Hong Kong,Mauritius,1999,4,3,7
Panama,Trinidad and Tobago,1999,2,2,4
Uruguay,Ecuador,1999,0,0,0
Argentina,Colombia,1999,2,1,3
Mexico,Paraguay,1999,0,1,1
Guatemala,Paraguay,1999,0,0,0
Tunisia,United Arab Emirates,1999,1,0,1
Hong Kong,Cambodia,1999,4,1,5
Mexico,Colombia,1999,0,0,0
Cayman Islands,Jamaica,1999,1,4,5
Hong Kong,Indonesia,1999,1,1,2
Mexico,Ecuador,1999,0,0,0
Cambodia,Indonesia,1999,1,5,6
DR Congo,Congo,1999,1,1,2
Iraq,Estonia,1999,1,1,2
Ivory Coast,Gabon,1999,0,1,1
United Arab Emirates,Turkmenistan,1999,3,1,4
Tunisia,Zambia,1999,2,1,3
Iraq,Turkmenistan,1999,3,0,3
United Arab Emirates,Estonia,1999,2,2,4
Tunisia,Zambia,1999,0,0,0
Bolivia,Paraguay,1999,0,0,0
Turkmenistan,Estonia,1999,1,1,2
United Arab Emirates,Iraq,1999,2,2,4
Burkina Faso,Togo,1999,1,0,1
Cambodia,Hong Kong,1999,0,1,1
Gabon,Equatorial Guinea,1999,4,0,4
Central African Republic,Chad,1999,4,1,5
Burkina Faso,Togo,1999,1,1,2
Chad,São Tomé and Príncipe,1999,5,0,5
Congo,Equatorial Guinea,1999,2,1,3
Gabon,Central African Republic,1999,1,0,1
Congo,Chad,1999,0,2,2
Equatorial Guinea,Central African Republic,1999,4,2,6
Gabon,São Tomé and Príncipe,1999,1,0,1
Congo,São Tomé and Príncipe,1999,1,0,1
Egypt,Ghana,1999,1,2,3
Central African Republic,São Tomé and Príncipe,1999,3,0,3
Chad,Equatorial Guinea,1999,1,0,1
France,Croatia,1999,3,0,3
Gabon,Congo,1999,0,0,0
Greece,Nigeria,1999,2,0,2
Republic of Ireland,Turkey,1999,1,1,2
Israel,Denmark,1999,0,5,5
Italy,Belgium,1999,1,3,4
Netherlands,Czech Republic,1999,1,1,2
Scotland,England,1999,0,2,2
Slovenia,Ukraine,1999,2,1,3
Spain,Brazil,1999,0,0,0
Central African Republic,Congo,1999,4,2,6
Gabon,Chad,1999,2,0,2
Indonesia,Hong Kong,1999,3,1,4
Norway,Germany,1999,0,1,1
São Tomé and Príncipe,Equatorial Guinea,1999,2,0,2
Namibia,Egypt,1999,0,1,1
Denmark,Israel,1999,3,0,3
England,Scotland,1999,0,1,1
Greece,Bulgaria,1999,1,0,1
Honduras,Trinidad and Tobago,1999,3,2,5
Morocco,United States,1999,2,1,3
Peru,Slovakia,1999,2,1,3
Spain,Argentina,1999,0,2,2
Turkey,Republic of Ireland,1999,0,0,0
Ukraine,Slovenia,1999,1,1,2
Uruguay,Paraguay,1999,0,1,1
Libya,Togo,1999,2,1,3
Indonesia,Cambodia,1999,9,2,11
Senegal,Ivory Coast,1999,3,0,3
Bangladesh,Uzbekistan,1999,0,6,6
Gabon,Nigeria,1999,0,2,2
United Arab Emirates,India,1999,3,1,4
Guatemala,Slovakia,1999,0,1,1
Sri Lanka,Uzbekistan,1999,0,6,6
United Arab Emirates,Bangladesh,1999,3,0,3
Lebanon,Malta,1999,0,0,0
Costa Rica,Slovakia,1999,4,0,4
India,Uzbekistan,1999,2,3,5
Sri Lanka,Bangladesh,1999,1,3,4
Gabon,Togo,1999,0,0,0
Congo,Burkina Faso,1999,2,1,3
South Africa,Sweden,1999,1,0,1
Sri Lanka,India,1999,1,3,4
United Arab Emirates,Uzbekistan,1999,0,1,1
Zimbabwe,Libya,1999,2,1,3
Congo,Togo,1999,2,1,3
Gabon,Burkina Faso,1999,3,2,5
India,Bangladesh,1999,2,2,4
United Arab Emirates,Sri Lanka,1999,6,0,6
Congo,DR Congo,1999,0,1,1
Peru,Honduras,1999,0,0,0
Gambia,Sierra Leone,1999,0,0,0
Malawi,Libya,1999,1,2,3
Panama,Cuba,1999,1,0,1
Malawi,Rwanda,1999,1,1,2
Senegal,Gambia,1999,3,0,3
Saint Lucia,Dominica,1999,3,1,4
Malawi,Rwanda,1999,1,1,2
Saint Lucia,Dominica,1999,2,1,3
Greece,Ghana,1999,1,1,2
Malawi,Rwanda,1999,1,2,3
Greece,Moldova,1999,2,0,2
Honduras,Zambia,1999,7,1,8
Dominica,Saint Lucia,1999,2,1,3
Greece,Estonia,1999,2,2,4
Dominica,Saint Lucia,1999,2,1,3
Morocco,Senegal,1999,0,0,0
Tunisia,Ghana,1999,2,0,2
Libya,Gabon,1999,2,0,2
Catalonia,Yugoslavia,1999,1,0,1
Gabon,Togo,1999,3,2,5
Malaysia,Singapore,1999,1,0,1
Andalusia,Estonia,1999,1,0,1
Costa Rica,Honduras,1999,1,1,2
Ivory Coast,Burkina Faso,1999,3,1,4
Libya,Togo,1999,2,0,2
Basque Country,Nigeria,1999,5,1,6
Egypt,Togo,2000,2,1,3
Tunisia,Togo,2000,7,0,7
Trinidad and Tobago,Canada,2000,0,0,0
Burkina Faso,Gabon,2000,1,1,2
Guatemala,Armenia,2000,1,1,2
Ivory Coast,Egypt,2000,2,0,2
Mexico,Iran,2000,2,1,3
Bermuda,Canada,2000,0,2,2
Burkina Faso,Cameroon,2000,2,2,4
Senegal,Cameroon,2000,0,0,0
China PR,New Zealand,2000,1,0,1
Jamaica,New Zealand,2000,2,1,3
United States,Iran,2000,1,1,2
Ghana,Tunisia,2000,2,0,2
Morocco,Trinidad and Tobago,2000,1,0,1
Panama,Guatemala,2000,2,0,2
Togo,Egypt,2000,1,0,1
Burkina Faso,Algeria,2000,1,0,1
Malta,Qatar,2000,2,0,2
New Zealand,South Korea,2000,0,1,1
Ghana,Cameroon,2000,1,1,2
China PR,Philippines,2000,8,0,8
Egypt,Zambia,2000,2,0,2
New Zealand,South Korea,2000,0,0,0
Nigeria,Tunisia,2000,4,2,6
South Africa,Gabon,2000,3,1,4
Vietnam,Guam,2000,11,0,11
DR Congo,Algeria,2000,0,0,0
Ivory Coast,Togo,2000,1,1,2
Qatar,Bosnia and Herzegovina,2000,2,0,2
Burkina Faso,Senegal,2000,1,3,4
Morocco,Congo,2000,1,0,1
China PR,Guam,2000,19,0,19
Costa Rica,Trinidad and Tobago,2000,2,1,3
Guatemala,Panama,2000,1,1,2
Spain,Poland,2000,3,0,3
Uganda,Libya,2000,3,2,5
Vietnam,Philippines,2000,3,0,3
Ghana,Togo,2000,2,0,2
South Africa,DR Congo,2000,1,0,1
Cameroon,Ivory Coast,2000,3,0,3
Egypt,Senegal,2000,1,0,1
Nigeria,Congo,2000,0,0,0
United States Virgin Islands,Saint Lucia,2000,0,9,9
Algeria,Gabon,2000,3,1,4
Chile,United States,2000,1,2,3
Philippines,Guam,2000,2,0,2
Tunisia,Morocco,2000,0,0,0
Vietnam,China PR,2000,0,2,2
Zambia,Burkina Faso,2000,1,1,2
United States Virgin Islands,Saint Lucia,2000,0,2,2
Cameroon,Togo,2000,0,1,1
Faroe Islands,Finland,2000,0,1,1
Ghana,Ivory Coast,2000,0,2,2
Iceland,Norway,2000,0,0,0
Kuwait,Syria,2000,4,0,4
British Virgin Islands,Saint Lucia,2000,2,3,5
Egypt,Burkina Faso,2000,4,2,6
Zambia,Senegal,2000,2,2,4
Armenia,Moldova,2000,2,1,3
DR Congo,Gabon,2000,0,0,0
Costa Rica,Chile,2000,1,0,1
Cyprus,Lithuania,2000,2,1,3
Finland,Iceland,2000,0,1,1
Romania,Latvia,2000,2,0,2
South Africa,Algeria,2000,1,1,2
Saint Kitts and Nevis,Saint Lucia,2000,0,1,1
Nigeria,Morocco,2000,2,0,2
Tunisia,Congo,2000,1,0,1
Cyprus,Armenia,2000,3,2,5
Faroe Islands,Iceland,2000,2,3,5
Kuwait,Iran,2000,1,1,2
Moldova,Lithuania,2000,2,1,3
Norway,Sweden,2000,1,1,2
Romania,Georgia,2000,1,1,2
Guatemala,Chile,2000,2,1,3
Japan,Mexico,2000,0,1,1
Albania,Andorra,2000,3,0,3
Cameroon,Algeria,2000,2,1,3
Cayman Islands,Jamaica,2000,0,0,0
Cyprus,Romania,2000,3,2,5
Georgia,Armenia,2000,2,1,3
Ghana,South Africa,2000,0,1,1
Latvia,Lithuania,2000,1,2,3
Malta,Azerbaijan,2000,3,0,3
Egypt,Tunisia,2000,0,1,1
Nigeria,Senegal,2000,2,1,3
Singapore,Malaysia,2000,3,1,4
Albania,Azerbaijan,2000,1,0,1
Malta,Andorra,2000,1,1,2
Mexico,Czech Republic,2000,1,2,3
Syria,North Korea,2000,5,1,6
Bulgaria,Slovakia,2000,1,0,1
Cayman Islands,Jamaica,2000,0,1,1
Chile,Australia,2000,2,1,3
Honduras,El Salvador,2000,5,1,6
Andorra,Azerbaijan,2000,0,0,0
Cameroon,Tunisia,2000,3,0,3
Hong Kong,Singapore,2000,0,0,0
Kuwait,Turkmenistan,2000,6,1,7
Malta,Albania,2000,0,1,1
Nepal,Yemen,2000,0,3,3
Nigeria,South Africa,2000,2,0,2
Australia,Slovakia,2000,0,0,0
Chile,Bulgaria,2000,3,2,5
Colombia,Jamaica,2000,1,0,1
Nepal,Bhutan,2000,3,0,3
South Africa,Tunisia,2000,2,2,4
United States,Haiti,2000,3,0,3
Yemen,Turkmenistan,2000,0,1,1
Costa Rica,Canada,2000,2,2,4
Dominican Republic,British Virgin Islands,2000,1,0,1
Macau,Brunei,2000,1,0,1
Mexico,Trinidad and Tobago,2000,4,0,4
Nigeria,Cameroon,2000,2,2,4
Singapore,Japan,2000,0,3,3
Syria,North Korea,2000,0,0,0
Haiti,Peru,2000,1,1,2
Jamaica,Honduras,2000,0,2,2
Kuwait,Bhutan,2000,20,0,20
Turkmenistan,Nepal,2000,5,0,5
Australia,Bulgaria,2000,1,1,2
Canada,South Korea,2000,0,0,0
Chile,Slovakia,2000,0,2,2
Malaysia,Maldives,2000,2,0,2
Trinidad and Tobago,Guatemala,2000,4,2,6
Bhutan,Turkmenistan,2000,0,8,8
Honduras,Colombia,2000,2,0,2
Japan,Brunei,2000,9,0,9
Kuwait,Yemen,2000,2,0,2
Lebanon,North Korea,2000,1,0,1
Macau,Singapore,2000,0,1,1
Panama,El Salvador,2000,4,1,5
United States,Peru,2000,1,0,1
Barbados,Saint Kitts and Nevis,2000,1,0,1
South Korea,Costa Rica,2000,2,2,4
Malaysia,Maldives,2000,3,0,3
Mexico,Guatemala,2000,1,1,2
Kuwait,Nepal,2000,5,0,5
Yemen,Bhutan,2000,11,2,13
Dominica,Antigua and Barbuda,2000,2,0,2
Honduras,Peru,2000,3,5,8
Oman,Switzerland,2000,1,4,5
United Arab Emirates,Slovenia,2000,1,1,2
United States,Colombia,2000,2,2,4
Costa Rica,Trinidad and Tobago,2000,1,2,3
Lesotho,Eswatini,2000,1,0,1
Macau,Japan,2000,0,3,3
Mexico,Canada,2000,1,2,3
Singapore,Brunei,2000,1,0,1
Thailand,Finland,2000,0,0,0
Kernow,Guernsey,2000,1,2,3
Oman,United Arab Emirates,2000,0,1,1
Belgium,Portugal,2000,1,1,2
Colombia,Peru,2000,2,1,3
Croatia,Spain,2000,0,0,0
England,Argentina,2000,0,0,0
Estonia,Finland,2000,2,4,6
France,Poland,2000,1,0,1
Greece,Austria,2000,4,1,5
Hungary,Australia,2000,0,3,3
Republic of Ireland,Czech Republic,2000,3,2,5
Israel,Russia,2000,4,1,5
Italy,Sweden,2000,1,0,1
Lebanon,Jordan,2000,1,1,2
Luxembourg,Northern Ireland,2000,1,3,4
North Macedonia,Serbia,2000,1,2,3
Netherlands,Germany,2000,2,1,3
Oman,Slovenia,2000,0,4,4
Qatar,Wales,2000,0,1,1
Thailand,Brazil,2000,0,7,7
Turkey,Norway,2000,0,2,2
United Arab Emirates,Switzerland,2000,1,0,1
Trinidad and Tobago,Canada,2000,0,1,1
British Virgin Islands,Anguilla,2000,3,4,7
Thailand,Estonia,2000,2,1,3
Botswana,Lesotho,2000,1,0,1
British Virgin Islands,Anguilla,2000,5,0,5
Canada,Colombia,2000,2,0,2
Thailand,Finland,2000,5,1,6
Barbados,Antigua and Barbuda,2000,2,2,4
El Salvador,Panama,2000,3,1,4
Uzbekistan,Mongolia,2000,8,1,9
Zambia,Lesotho,2000,2,0,2
Honduras,Nicaragua,2000,3,0,3
Trinidad and Tobago,Curaçao,2000,5,0,5
Anguilla,Bahamas,2000,1,3,4
Barbados,Grenada,2000,2,2,4
Bolivia,Haiti,2000,9,2,11
British Virgin Islands,Bermuda,2000,1,5,6
Cuba,Cayman Islands,2000,4,0,4
Dominican Republic,Montserrat,2000,3,0,3
El Salvador,Belize,2000,5,0,5
Ethiopia,Sudan,2000,1,0,1
Saint Lucia,Suriname,2000,1,0,1
Saint Vincent and the Grenadines,United States Virgin Islands,2000,9,0,9
Zimbabwe,Lesotho,2000,2,1,3
Syria,Jordan,2000,0,0,0
Ecuador,Honduras,2000,1,3,4
Jordan,Lebanon,2000,1,1,2
Cuba,Nicaragua,2000,4,0,4
Qatar,Sudan,2000,3,0,3
Aruba,Puerto Rico,2000,4,2,6
Haiti,Dominica,2000,4,0,4
Jordan,Bosnia and Herzegovina,2000,0,0,0
United States,Tunisia,2000,1,1,2
Zambia,Malawi,2000,1,1,2
Jordan,Syria,2000,0,0,0
Zambia,Malawi,2000,0,1,1
Japan,China PR,2000,0,0,0
Jordan,Bosnia and Herzegovina,2000,1,2,3
Venezuela,Bolivia,2000,0,0,0
Jordan,Syria,2000,0,0,0
Curaçao,Trinidad and Tobago,2000,1,1,2
Grenada,Barbados,2000,2,3,5
Puerto Rico,Aruba,2000,2,2,4
Saint Kitts and Nevis,Turks and Caicos Islands,2000,8,0,8
Bahamas,Anguilla,2000,2,1,3
Belize,Guatemala,2000,1,2,3
Bermuda,British Virgin Islands,2000,9,0,9
Botswana,Eswatini,2000,3,0,3
Cayman Islands,Cuba,2000,0,0,0
Dominica,Haiti,2000,1,3,4
Montserrat,Dominican Republic,2000,1,3,4
Nicaragua,Panama,2000,0,2,2
Suriname,Saint Lucia,2000,1,0,1
United States Virgin Islands,Saint Vincent and the Grenadines,2000,1,5,6
Bahrain,Kazakhstan,2000,0,1,1
Namibia,Zimbabwe,2000,2,1,3
Saint Kitts and Nevis,Turks and Caicos Islands,2000,6,0,6
Bahrain,Qatar,2000,1,0,1
Chile,Honduras,2000,5,2,7
Cyprus,Iran,2000,0,0,0
Gambia,Mauritania,2000,0,0,0
Bahrain,Jordan,2000,1,1,2
Malaysia,Taiwan,2000,3,0,3
Tanzania,Malawi,2000,1,1,2
Thailand,North Korea,2000,0,0,0
Zambia,Botswana,2000,3,0,3
Tanzania,Malawi,2000,4,3,7
Malaysia,North Korea,2000,1,1,2
Thailand,Taiwan,2000,2,0,2
Colombia,Brazil,2000,0,0,0
El Salvador,Haiti,2000,3,1,4
Malta,Northern Ireland,2000,0,3,3
Serbia,China PR,2000,1,0,1
Argentina,Chile,2000,4,1,5
Austria,Sweden,2000,1,1,2
Belgium,Netherlands,2000,2,2,4
Bosnia and Herzegovina,North Macedonia,2000,1,0,1
Bulgaria,Belarus,2000,4,1,5
Croatia,Germany,2000,1,1,2
Czech Republic,Australia,2000,3,1,4
Ecuador,Venezuela,2000,2,0,2
Greece,Romania,2000,2,0,2
Hungary,Poland,2000,0,0,0
Israel,Georgia,2000,1,1,2
Malaysia,Thailand,2000,3,2,5
Peru,Paraguay,2000,2,0,2
Portugal,Denmark,2000,2,1,3
Scotland,France,2000,0,2,2
Spain,Italy,2000,2,0,2
Switzerland,Norway,2000,2,2,4
Uruguay,Bolivia,2000,1,0,1
Wales,Finland,2000,1,2,3
Gambia,Mauritania,2000,0,0,0
Jordan,Kazakhstan,2000,0,1,1
Maldives,Iran,2000,0,8,8
Qatar,Palestine,2000,1,0,1
Syria,Bahrain,2000,1,0,1
Aruba,Barbados,2000,1,3,4
Haiti,Bahamas,2000,9,0,9
Zambia,Kenya,2000,1,0,1
Bahrain,Maldives,2000,4,1,5
Cuba,Suriname,2000,1,0,1
Guatemala,El Salvador,2000,0,1,1
Palestine,Pakistan,2000,2,0,2
Panama,Honduras,2000,1,0,1
Qatar,Kazakhstan,2000,3,1,4
Syria,Iran,2000,0,1,1
Trinidad and Tobago,Dominican Republic,2000,3,0,3
Bahrain,Iran,2000,1,0,1
Malaysia,Taiwan,2000,2,3,5
Palestine,Jordan,2000,1,5,6
Qatar,Pakistan,2000,5,0,5
Syria,Maldives,2000,2,1,3
Thailand,North Korea,2000,5,3,8
Myanmar,Mongolia,2000,2,0,2
South Korea,Laos,2000,9,0,9
Kazakhstan,Palestine,2000,2,0,2
Malaysia,North Korea,2000,1,4,5
Pakistan,Jordan,2000,0,5,5
Thailand,Taiwan,2000,1,0,1
Myanmar,Laos,2000,4,0,4
Djibouti,DR Congo,2000,1,1,2
South Korea,Mongolia,2000,6,0,6
Mauritania,Tunisia,2000,1,2,3
Botswana,Zambia,2000,0,1,1
Fiji,Papua New Guinea,2000,5,0,5
Guinea-Bissau,Togo,2000,0,0,0
Madagascar,Gabon,2000,2,0,2
Malawi,Kenya,2000,2,0,2
New Caledonia,Solomon Islands,2000,4,2,6
Pakistan,Kazakhstan,2000,0,4,4
Qatar,Jordan,2000,2,2,4
São Tomé and Príncipe,Sierra Leone,2000,2,0,2
Seychelles,Namibia,2000,1,1,2
Tanzania,Ghana,2000,0,1,1
Thailand,Malaysia,2000,3,2,5
Uganda,Guinea,2000,4,4,8
Benin,Senegal,2000,1,1,2
Cape Verde,Algeria,2000,0,0,0
Central African Republic,Zimbabwe,2000,0,1,1
Chad,Liberia,2000,0,1,1
Equatorial Guinea,Congo,2000,1,3,4
Eritrea,Nigeria,2000,0,0,0
Ethiopia,Burkina Faso,2000,2,1,3
Gambia,Morocco,2000,0,1,1
Iran,Bahrain,2000,3,0,3
South Korea,Myanmar,2000,4,0,4
Laos,Mongolia,2000,2,1,3
Lesotho,South Africa,2000,0,2,2
Libya,Mali,2000,3,0,3
Rwanda,Ivory Coast,2000,2,2,4
Sudan,Mozambique,2000,1,0,1
Eswatini,Angola,2000,0,1,1
Syria,Maldives,2000,2,1,3
Fiji,New Caledonia,2000,2,1,3
Solomon Islands,Vanuatu,2000,2,1,3
Bahrain,Maldives,2000,1,0,1
Fiji,Vanuatu,2000,4,1,5
Iran,Syria,2000,1,1,2
New Caledonia,Papua New Guinea,2000,6,1,7
Ethiopia,DR Congo,2000,1,2,3
Bahrain,Syria,2000,0,1,1
Iran,Maldives,2000,3,0,3
Solomon Islands,Papua New Guinea,2000,4,2,6
Vanuatu,New Caledonia,2000,6,0,6
Fiji,Solomon Islands,2000,2,2,4
Malawi,Mozambique,2000,2,1,3
Papua New Guinea,Vanuatu,2000,1,4,5
Antigua and Barbuda,Bermuda,2000,0,0,0
Bahamas,Haiti,2000,0,4,4
Barbados,Aruba,2000,4,0,4
Belize,El Salvador,2000,1,3,4
Dominican Republic,Trinidad and Tobago,2000,0,1,1
Nicaragua,Honduras,2000,0,1,1
Saint Vincent and the Grenadines,Saint Kitts and Nevis,2000,1,0,1
Suriname,Cuba,2000,0,0,0
Uganda,Kenya,2000,2,2,4
Cameroon,Somalia,2000,3,0,3
Mali,Burkina Faso,2000,2,1,3
Egypt,Mauritius,2000,2,0,2
Algeria,Cape Verde,2000,2,0,2
Gabon,Madagascar,2000,1,0,1
Kenya,Malawi,2000,0,0,0
Morocco,Gambia,2000,2,0,2
Namibia,Seychelles,2000,3,0,3
Nigeria,Eritrea,2000,4,0,4
Sierra Leone,São Tomé and Príncipe,2000,4,0,4
South Africa,Lesotho,2000,1,0,1
Saint Kitts and Nevis,Saint Vincent and the Grenadines,2000,1,2,3
Tunisia,Mauritania,2000,3,0,3
Zambia,Botswana,2000,1,0,1
Angola,Eswatini,2000,7,1,8
Bermuda,Antigua and Barbuda,2000,1,1,2
Burkina Faso,Ethiopia,2000,3,0,3
Cameroon,Somalia,2000,3,0,3
Congo,Equatorial Guinea,2000,2,1,3
DR Congo,Djibouti,2000,9,1,10
Egypt,Mauritius,2000,4,2,6
Ghana,Tanzania,2000,3,2,5
Guinea,Uganda,2000,3,0,3
Ivory Coast,Rwanda,2000,2,0,2
Liberia,Chad,2000,0,0,0
Mali,Libya,2000,3,1,4
Mozambique,Sudan,2000,2,1,3
Senegal,Benin,2000,1,0,1
Togo,Guinea-Bissau,2000,3,0,3
Zimbabwe,Central African Republic,2000,3,1,4
Hong Kong,China PR,2000,0,1,1
Andorra,Belarus,2000,2,0,2
Armenia,Georgia,2000,0,0,0
Austria,Croatia,2000,1,2,3
Bolivia,Colombia,2000,1,1,2
Brazil,Ecuador,2000,3,2,5
Bulgaria,Ukraine,2000,0,1,1
Chile,Peru,2000,1,1,2
Czech Republic,Israel,2000,4,1,5
Denmark,Sweden,2000,0,1,1
France,Slovenia,2000,3,2,5
Germany,Switzerland,2000,1,1,2
Republic of Ireland,Greece,2000,0,1,1
Italy,Portugal,2000,2,0,2
South Korea,Japan,2000,1,0,1
Liechtenstein,Faroe Islands,2000,0,1,1
Lithuania,Latvia,2000,2,1,3
Luxembourg,Estonia,2000,1,1,2
North Macedonia,Albania,2000,1,0,1
Netherlands,Scotland,2000,0,0,0
Northern Ireland,Hungary,2000,0,1,1
Norway,Belgium,2000,0,2,2
Paraguay,Uruguay,2000,1,0,1
Poland,Finland,2000,0,0,0
Romania,Cyprus,2000,2,0,2
Russia,United States,2000,2,0,2
San Marino,Moldova,2000,0,1,1
Venezuela,Argentina,2000,0,4,4
Antigua and Barbuda,Dominica,2000,3,2,5
British Virgin Islands,Sint Maarten,2000,0,0,0
South Africa,Mauritius,2000,3,0,3
British Virgin Islands,Antigua and Barbuda,2000,1,1,2
Dominica,Sint Maarten,2000,3,1,4
Jersey,Guernsey,2000,1,0,1
Maldives,Sri Lanka,2000,1,1,2
Bangladesh,India,2000,1,1,2
Cape Verde,Gambia,2000,1,1,2
Maldives,Bangladesh,2000,1,1,2
Guinea,Mali,2000,3,1,4
Guinea-Bissau,Mauritania,2000,1,0,1
India,Sri Lanka,2000,0,1,1
Cape Verde,Sierra Leone,2000,1,0,1
Gambia,Senegal,2000,1,1,2
Bangladesh,Sri Lanka,2000,0,1,1
Cuba,Barbados,2000,1,1,2
El Salvador,Guatemala,2000,1,1,2
Guinea,Mauritania,2000,1,1,2
Honduras,Panama,2000,3,1,4
Mali,Guinea-Bissau,2000,3,2,5
Trinidad and Tobago,Haiti,2000,3,1,4
Cape Verde,Senegal,2000,2,2,4
Gambia,Sierra Leone,2000,2,2,4
Maldives,India,2000,1,0,1
Guinea,Guinea-Bissau,2000,2,1,3
Mali,Mauritania,2000,2,2,4
Maldives,Sri Lanka,2000,1,1,2
Cape Verde,Guinea,2000,2,0,2
Senegal,Mali,2000,2,2,4
Jordan,Lebanon,2000,1,1,2
Cape Verde,Senegal,2000,1,0,1
Guinea,Mali,2000,2,0,2
Jamaica,Panama,2000,0,1,1
Zimbabwe,Namibia,2000,3,2,5
Thailand,Uzbekistan,2000,2,0,2
Guatemala,Belize,2000,0,0,0
Haiti,Trinidad and Tobago,2000,1,1,2
Malawi,Angola,2000,0,0,0
Barbados,Cuba,2000,1,1,2
Lebanon,Saudi Arabia,2000,0,0,0
Panama,Nicaragua,2000,4,0,4
Jordan,Kyrgyzstan,2000,2,0,2
Lebanon,Iraq,2000,1,2,3
Wales,Brazil,2000,0,3,3
Iran,Kazakhstan,2000,3,0,3
Slovakia,Saudi Arabia,2000,1,1,2
Syria,Palestine,2000,1,0,1
China PR,Serbia,2000,0,2,2
Jordan,Iraq,2000,0,0,0
Kyrgyzstan,Lebanon,2000,0,2,2
Algeria,Burkina Faso,2000,2,0,2
Kazakhstan,Syria,2000,0,4,4
Palestine,Iran,2000,1,1,2
Canada,Trinidad and Tobago,2000,1,0,1
Cuba,Haiti,2000,0,1,1
England,Brazil,2000,1,1,2
Iraq,Kyrgyzstan,2000,4,0,4
Jamaica,Colombia,2000,0,3,3
Jordan,Lebanon,2000,0,0,0
Netherlands,Romania,2000,2,1,3
Norway,Slovakia,2000,2,0,2
Croatia,France,2000,0,2,2
Iran,Syria,2000,1,0,1
Kazakhstan,Palestine,2000,3,2,5
South Korea,Serbia,2000,0,0,0
Macau,Hong Kong,2000,0,1,1
Malta,South Africa,2000,0,1,1
Cuba,Haiti,2000,1,1,2
Canada,Honduras,2000,2,1,3
Republic of Ireland,Scotland,2000,1,2,3
South Korea,Serbia,2000,0,0,0
England,Ukraine,2000,2,0,2
Hungary,Saudi Arabia,2000,2,2,4
Iraq,Syria,2000,0,0,0
Jordan,Iran,2000,0,1,1
Russia,Slovakia,2000,1,1,2
Venezuela,Panama,2000,3,1,4
Botswana,Mozambique,2000,2,0,2
Eswatini,Lesotho,2000,0,1,1
Iran,Syria,2000,1,0,1
Jordan,Iraq,2000,1,4,5
Lesotho,Mozambique,2000,0,0,0
Portugal,Wales,2000,3,0,3
Singapore,Qatar,2000,1,5,6
Eswatini,Botswana,2000,0,0,0
Algeria,Guinea,2000,4,0,4
Denmark,Belgium,2000,2,2,4
Germany,Czech Republic,2000,3,2,5
Honduras,Haiti,2000,4,0,4
Hungary,Israel,2000,2,1,3
Latvia,Finland,2000,1,0,1
Malta,England,2000,1,2,3
Norway,Italy,2000,1,0,1
Paraguay,Ecuador,2000,3,1,4
Romania,Greece,2000,2,1,3
Slovenia,Saudi Arabia,2000,2,0,2
Sweden,Spain,2000,1,1,2
Uruguay,Chile,2000,2,1,3
United States,South Africa,2000,4,0,4
Argentina,Bolivia,2000,1,0,1
Azerbaijan,Georgia,2000,0,0,0
Benin,Togo,2000,1,2,3
Botswana,Lesotho,2000,1,1,2
Colombia,Venezuela,2000,3,0,3
Cuba,Canada,2000,0,1,1
Estonia,Belarus,2000,2,0,2
France,Japan,2000,2,2,4
Mexico,Republic of Ireland,2000,2,2,4
Moldova,Russia,2000,0,1,1
Morocco,Jamaica,2000,1,0,1
Netherlands,Poland,2000,3,1,4
Nigeria,Malawi,2000,3,2,5
Peru,Brazil,2000,0,1,1
Senegal,Zambia,2000,0,0,0
Eswatini,Mozambique,2000,1,1,2
Jamaica,Japan,2000,0,4,4
Morocco,France,2000,1,5,6
Nigeria,Malawi,2000,4,1,5
Senegal,Zambia,2000,0,0,0
United States,Republic of Ireland,2000,1,1,2
Germany,Liechtenstein,2000,8,2,10
Iran,Egypt,2000,1,1,2
South Korea,North Macedonia,2000,2,1,3
Luxembourg,Spain,2000,0,1,1
Mexico,South Africa,2000,4,2,6
Tonga,Cook Islands,2000,1,2,3
Australia,Paraguay,2000,0,0,0
Egypt,South Korea,2000,0,1,1
Iran,North Macedonia,2000,3,1,4
Belgium,Sweden,2000,2,1,3
Saint Vincent and the Grenadines,Barbados,2000,1,0,1
Thailand,Qatar,2000,2,3,5
Antigua and Barbuda,Guatemala,2000,0,1,1
Canada,Cuba,2000,0,0,0
Estonia,Georgia,2000,1,0,1
France,Denmark,2000,3,0,3
Republic of Ireland,South Africa,2000,2,1,3
Japan,Slovakia,2000,1,1,2
Lesotho,Zambia,2000,0,0,0
Netherlands,Czech Republic,2000,1,0,1
Tunisia,Senegal,2000,4,1,5
Turkey,Italy,2000,1,2,3
United States,Mexico,2000,3,0,3
Australia,Paraguay,2000,0,0,0
Germany,Romania,2000,1,1,2
New Caledonia,Vanuatu,2000,3,1,4
Portugal,England,2000,3,2,5
Serbia,Slovenia,2000,3,3,6
Spain,Norway,2000,0,1,1
American Samoa,Tonga,2000,1,2,3
Belgium,Italy,2000,0,2,2
Bolivia,Slovakia,2000,0,2,2
Kenya,Burkina Faso,2000,0,1,1
Australia,Paraguay,2000,2,1,3
New Caledonia,Vanuatu,2000,1,0,1
Sweden,Turkey,2000,0,0,0
Algeria,Senegal,2000,1,1,2
Czech Republic,France,2000,1,2,3
Netherlands,Denmark,2000,3,0,3
Egypt,Ghana,2000,2,0,2
England,Germany,2000,1,0,1
Haiti,Honduras,2000,1,3,4
Madagascar,DR Congo,2000,3,0,3
Malawi,Burkina Faso,2000,1,1,2
Namibia,Morocco,2000,0,0,0
Nigeria,Sierra Leone,2000,2,0,2
Romania,Portugal,2000,0,1,1
Angola,Zambia,2000,2,1,3
Guatemala,Antigua and Barbuda,2000,8,1,9
Guinea,Zimbabwe,2000,3,0,3
Ivory Coast,Tunisia,2000,2,2,4
Japan,Bolivia,2000,2,0,2
Libya,Cameroon,2000,0,3,3
Norway,Serbia,2000,0,1,1
Slovenia,Spain,2000,1,2,3
South Africa,Eswatini,2000,2,0,2
Sudan,Liberia,2000,2,0,2
Australia,Cook Islands,2000,17,0,17
Belgium,Turkey,2000,0,2,2
Italy,Sweden,2000,2,1,3
Tahiti,New Zealand,2000,0,2,2
England,Romania,2000,2,3,5
Madagascar,Mauritius,2000,1,1,2
Portugal,Germany,2000,3,0,3
Denmark,Czech Republic,2000,0,2,2
Netherlands,France,2000,3,2,5
New Zealand,Vanuatu,2000,3,1,4
Paraguay,Costa Rica,2000,1,0,1
Serbia,Spain,2000,3,4,7
Slovenia,Norway,2000,0,0,0
Solomon Islands,Cook Islands,2000,5,1,6
Tahiti,Vanuatu,2000,2,3,5
Gabon,Congo,2000,0,2,2
Solomon Islands,Australia,2000,0,6,6
Italy,Romania,2000,2,0,2
Madagascar,Mauritius,2000,1,0,1
Turkey,Portugal,2000,0,2,2
Uganda,Rwanda,2000,2,1,3
Australia,Vanuatu,2000,1,0,1
Ecuador,Panama,2000,5,0,5
Gabon,Congo,2000,2,3,5
Lebanon,Kuwait,2000,3,1,4
Netherlands,Serbia,2000,6,1,7
New Zealand,Solomon Islands,2000,2,0,2
Spain,France,2000,1,2,3
Australia,New Zealand,2000,2,0,2
Brazil,Uruguay,2000,1,1,2
France,Portugal,2000,2,1,3
Tunisia,Algeria,2000,2,2,4
Vanuatu,Solomon Islands,2000,1,2,3
Venezuela,Bolivia,2000,4,2,6
Barbados,Trinidad and Tobago,2000,0,0,0
Chile,Paraguay,2000,3,1,4
Colombia,Argentina,2000,1,3,4
Ecuador,Peru,2000,2,1,3
Netherlands,Italy,2000,0,0,0
Djibouti,Burundi,2000,1,3,4
Botswana,Madagascar,2000,1,0,1
Costa Rica,Panama,2000,5,1,6
El Salvador,Mexico,2000,0,3,3
Seychelles,Zimbabwe,2000,0,1,1
Tanzania,Mauritius,2000,0,1,1
Uganda,Malawi,2000,3,1,4
Benin,Namibia,2000,2,0,2
Central African Republic,DR Congo,2000,1,1,2
Equatorial Guinea,Angola,2000,0,1,1
Ethiopia,Zambia,2000,1,0,1
France,Italy,2000,2,1,3
Jamaica,Cuba,2000,1,1,2
Lesotho,Mozambique,2000,1,0,1
Niger,Ivory Coast,2000,0,1,1
Rwanda,Congo,2000,2,1,3
Saint Vincent and the Grenadines,Trinidad and Tobago,2000,2,1,3
Sudan,Eritrea,2000,5,1,6
Eswatini,Kenya,2000,3,2,5
Guatemala,Haiti,2000,4,1,5
Rwanda,Uganda,2000,2,0,2
Trinidad and Tobago,Cuba,2000,4,1,5
Jamaica,Barbados,2000,5,0,5
Mexico,Venezuela,2000,2,1,3
Cape Verde,Angola,2000,1,1,2
Malawi,Namibia,2000,1,2,3
El Salvador,Guatemala,2000,0,1,1
Trinidad and Tobago,Jamaica,2000,2,4,6
Tunisia,Madagascar,2000,1,0,1
Zambia,Togo,2000,2,0,2
Burkina Faso,Guinea,2000,2,3,5
Cameroon,Angola,2000,3,0,3
DR Congo,Congo,2000,2,0,2
Ghana,Sierra Leone,2000,5,0,5
Liberia,Nigeria,2000,2,1,3
Morocco,Algeria,2000,2,1,3
Senegal,Egypt,2000,0,0,0
Zimbabwe,South Africa,2000,0,2,2
Libya,Chad,2000,3,1,4
Burundi,Djibouti,2000,1,0,1
Eritrea,Sudan,2000,2,1,3
Gabon,São Tomé and Príncipe,2000,4,1,5
Kenya,Eswatini,2000,3,0,3
Malawi,Uganda,2000,1,2,3
Namibia,Benin,2000,8,2,10
Zambia,Ethiopia,2000,2,0,2
Angola,Equatorial Guinea,2000,4,1,5
Barbados,Costa Rica,2000,2,1,3
Canada,Trinidad and Tobago,2000,0,2,2
DR Congo,Central African Republic,2000,2,0,2
El Salvador,Honduras,2000,2,5,7
Guatemala,United States,2000,1,1,2
Guinea,Gambia,2000,2,0,2
Ivory Coast,Niger,2000,6,0,6
Mauritius,Tanzania,2000,3,2,5
Mozambique,Lesotho,2000,1,0,1
Panama,Mexico,2000,0,1,1
Paraguay,Brazil,2000,2,1,3
Uruguay,Venezuela,2000,3,1,4
Argentina,Ecuador,2000,2,0,2
Bolivia,Chile,2000,1,0,1
Peru,Colombia,2000,0,1,1
Guatemala,Barbados,2000,2,0,2
Costa Rica,United States,2000,2,1,3
Jamaica,Honduras,2000,3,1,4
Lesotho,Angola,2000,2,1,3
Panama,Canada,2000,0,0,0
Trinidad and Tobago,Mexico,2000,1,0,1
Ecuador,Colombia,2000,0,0,0
Venezuela,Chile,2000,0,2,2
Brazil,Argentina,2000,3,1,4
Bulgaria,Azerbaijan,2000,2,1,3
Uruguay,Peru,2000,0,0,0
Azerbaijan,North Macedonia,2000,1,2,3
Bolivia,Paraguay,2000,0,0,0
Iceland,Malta,2000,5,0,5
China PR,South Korea,2000,0,1,1
Bangladesh,India,2000,0,1,1
South Africa,Zimbabwe,2000,0,1,1
El Salvador,Haiti,2000,1,2,3
Lebanon,Oman,2000,3,1,4
Guyana,Trinidad and Tobago,2000,0,0,0
Malaysia,Myanmar,2000,6,0,6
Lebanon,Oman,2000,1,2,3
Malaysia,Myanmar,2000,1,2,3
Syria,Bahrain,2000,1,0,1
Costa Rica,Venezuela,2000,1,5,6
Bahrain,Jordan,2000,0,2,2
Panama,Ecuador,2000,0,0,0
Lesotho,Zimbabwe,2000,0,3,3
Malaysia,New Zealand,2000,0,0,0
Syria,Jordan,2000,1,0,1
Albania,Cyprus,2000,0,0,0
Chile,Brazil,2000,3,0,3
Colombia,Uruguay,2000,1,0,1
Costa Rica,Guatemala,2000,2,1,3
Malaysia,Oman,2000,2,0,2
Mexico,Canada,2000,2,0,2
Argentina,Paraguay,2000,1,1,2
Bosnia and Herzegovina,Turkey,2000,2,0,2
Bulgaria,Belgium,2000,1,3,4
Czech Republic,Slovenia,2000,0,1,1
Ecuador,Bolivia,2000,2,0,2
Estonia,Andorra,2000,1,0,1
Faroe Islands,Denmark,2000,0,2,2
Finland,Norway,2000,3,1,4
Germany,Spain,2000,4,1,5
Hungary,Austria,2000,1,1,2
Iceland,Sweden,2000,2,1,3
Iran,Georgia,2000,2,1,3
Jamaica,El Salvador,2000,1,0,1
Japan,United Arab Emirates,2000,3,1,4
Latvia,Belarus,2000,0,1,1
Moldova,Malta,2000,1,0,1
Northern Ireland,Serbia,2000,1,2,3
Peru,Venezuela,2000,1,0,1
Portugal,Lithuania,2000,5,1,6
Romania,Poland,2000,1,1,2
Russia,Israel,2000,1,0,1
Slovakia,Croatia,2000,1,1,2
Switzerland,Greece,2000,2,2,4
Trinidad and Tobago,Panama,2000,6,0,6
United States,Barbados,2000,7,0,7
New Zealand,Oman,2000,1,0,1
Malaysia,New Zealand,2000,0,2,2
Haiti,Honduras,2000,0,4,4
Sierra Leone,Togo,2000,2,0,2
Egypt,Kenya,2000,2,1,3
Vietnam,Sri Lanka,2000,2,2,4
Cayman Islands,Jamaica,2000,0,6,6
Zimbabwe,Lesotho,2000,3,0,3
Indonesia,Myanmar,2000,4,1,5
Iraq,Taiwan,2000,3,0,3
Myanmar,Iraq,2000,0,1,1
Indonesia,Taiwan,2000,1,0,1
Austria,Iran,2000,5,1,6
Indonesia,Iraq,2000,0,0,0
Andorra,Cyprus,2000,2,3,5
Azerbaijan,Sweden,2000,0,1,1
Belarus,Wales,2000,2,1,3
Belgium,Croatia,2000,0,0,0
Bosnia and Herzegovina,Spain,2000,1,2,3
Bulgaria,Czech Republic,2000,0,1,1
Chile,Colombia,2000,0,1,1
China PR,Thailand,2000,3,1,4
Egypt,Ivory Coast,2000,1,0,1
Finland,Albania,2000,2,1,3
France,England,2000,1,1,2
Gabon,Morocco,2000,2,0,2
Germany,Greece,2000,2,0,2
Honduras,El Salvador,2000,5,0,5
Iceland,Denmark,2000,1,2,3
Iraq,Uzbekistan,2000,2,0,2
Latvia,Scotland,2000,0,1,1
Netherlands,Republic of Ireland,2000,2,2,4
Nigeria,Namibia,2000,4,0,4
Northern Ireland,Malta,2000,1,0,1
Norway,Armenia,2000,0,0,0
Paraguay,Venezuela,2000,3,0,3
Switzerland,Russia,2000,0,1,1
Turkey,Moldova,2000,2,0,2
Uganda,Guinea,2000,3,1,4
Ukraine,Poland,2000,1,3,4
Zambia,Madagascar,2000,1,2,3
Algeria,Burkina Faso,2000,1,1,2
Brazil,Bolivia,2000,5,0,5
Burundi,Angola,2000,0,0,0
China PR,Iraq,2000,4,1,5
Congo,South Africa,2000,1,2,3
Costa Rica,Barbados,2000,3,0,3
Estonia,Portugal,2000,1,3,4
Faroe Islands,Slovenia,2000,2,2,4
Hungary,Italy,2000,2,2,4
Indonesia,Iraq,2000,3,0,3
Israel,Liechtenstein,2000,2,0,2
Kenya,Tunisia,2000,0,0,0
Lesotho,Ghana,2000,3,3,6
Liberia,Mauritius,2000,4,0,4
Luxembourg,Serbia,2000,0,2,2
Mexico,Panama,2000,7,1,8
Peru,Argentina,2000,1,2,3
Romania,Lithuania,2000,1,0,1
Slovakia,North Macedonia,2000,2,0,2
Thailand,Uzbekistan,2000,4,2,6
Togo,Sierra Leone,2000,2,0,2
Trinidad and Tobago,Canada,2000,4,0,4
Uruguay,Ecuador,2000,4,0,4
United States,Guatemala,2000,1,0,1
Zimbabwe,DR Congo,2000,3,2,5
Lebanon,United Arab Emirates,2000,0,1,1
Lebanon,United Arab Emirates,2000,2,2,4
Libya,Sudan,2000,1,0,1
Mexico,Ecuador,2000,2,0,2
Qatar,Kuwait,2000,0,0,0
Saudi Arabia,Syria,2000,2,1,3
Senegal,Togo,2000,0,0,0
Zanzibar,Tanzania,2000,0,1,1
Saudi Arabia,Syria,2000,3,0,3
Cayman Islands,Turks and Caicos Islands,2000,3,0,3
Mexico,Bolivia,2000,1,0,1
Qatar,Iran,2000,1,2,3
Saudi Arabia,United Arab Emirates,2000,6,1,7
Kenya,Burundi,2000,1,0,1
Kuwait,Thailand,2000,3,2,5
Kenya,Lesotho,2000,1,1,2
Jordan,Saudi Arabia,2000,1,0,1
Qatar,Egypt,2000,0,1,1
Kenya,Burundi,2000,2,3,5
Australia,Kuwait,2000,1,0,1
France,Cameroon,2000,1,1,2
United Arab Emirates,South Korea,2000,1,1,2
China PR,Saudi Arabia,2000,0,2,2
North Macedonia,Azerbaijan,2000,3,0,3
Qatar,Thailand,2000,1,1,2
Andorra,Estonia,2000,1,2,3
Armenia,Ukraine,2000,2,3,5
Australia,South Korea,2000,2,4,6
Bulgaria,Malta,2000,3,0,3
Burkina Faso,Burundi,2000,1,0,1
Colombia,Paraguay,2000,0,2,2
Cyprus,Netherlands,2000,0,4,4
Czech Republic,Iceland,2000,4,0,4
England,Germany,2000,0,1,1
Greece,Finland,2000,1,0,1
Italy,Romania,2000,3,0,3
Jordan,China PR,2000,1,1,2
Latvia,Belgium,2000,0,4,4
Liechtenstein,Austria,2000,0,1,1
Lithuania,Georgia,2000,0,4,4
Luxembourg,Slovenia,2000,1,2,3
Madagascar,Nigeria,2000,0,0,0
Moldova,Slovakia,2000,0,1,1
Northern Ireland,Denmark,2000,1,1,2
Poland,Belarus,2000,3,1,4
Portugal,Republic of Ireland,2000,1,1,2
San Marino,Scotland,2000,0,2,2
Saudi Arabia,Kazakhstan,2000,1,0,1
South Africa,France,2000,0,0,0
Spain,Israel,2000,2,0,2
Sweden,Turkey,2000,1,1,2
Switzerland,Faroe Islands,2000,5,1,6
Tunisia,Gabon,2000,4,2,6
United Arab Emirates,Kuwait,2000,1,0,1
Wales,Norway,2000,1,1,2
Angola,Algeria,2000,2,2,4
Argentina,Uruguay,2000,2,1,3
Barbados,Guatemala,2000,1,3,4
Bolivia,Peru,2000,1,0,1
Ecuador,Chile,2000,1,0,1
Guinea,Senegal,2000,1,0,1
Honduras,Jamaica,2000,1,0,1
Hong Kong,Singapore,2000,1,0,1
Mauritius,Congo,2000,1,2,3
Mexico,Trinidad and Tobago,2000,7,0,7
Morocco,Kenya,2000,1,0,1
Qatar,Thailand,2000,3,1,4
Sudan,Egypt,2000,0,1,1
Togo,Uganda,2000,3,0,3
Uzbekistan,Turkmenistan,2000,3,0,3
Venezuela,Brazil,2000,0,6,6
Canada,Panama,2000,1,0,1
DR Congo,Lesotho,2000,1,1,2
Albania,Greece,2000,2,0,2
Austria,Spain,2000,1,1,2
Azerbaijan,Turkey,2000,0,1,1
Belarus,Armenia,2000,2,1,3
Croatia,Scotland,2000,1,1,2
Denmark,Bulgaria,2000,1,1,2
Finland,England,2000,0,0,0
Iceland,Northern Ireland,2000,1,0,1
Republic of Ireland,Estonia,2000,2,0,2
Israel,Bosnia and Herzegovina,2000,3,1,4
Italy,Georgia,2000,2,0,2
Lithuania,Hungary,2000,1,6,7
Malta,Czech Republic,2000,0,0,0
Moldova,North Macedonia,2000,0,0,0
Netherlands,Portugal,2000,0,2,2
Norway,Ukraine,2000,0,1,1
Poland,Wales,2000,0,0,0
Russia,Luxembourg,2000,3,0,3
Slovakia,Sweden,2000,0,0,0
Slovenia,Switzerland,2000,2,2,4
United States,Costa Rica,2000,0,0,0
Iraq,Thailand,2000,2,0,2
Lebanon,Iran,2000,0,4,4
South Korea,China PR,2000,2,2,4
Kuwait,Indonesia,2000,0,0,0
Malaysia,Cambodia,2000,2,0,2
Qatar,Uzbekistan,2000,1,1,2
Saudi Arabia,Japan,2000,1,4,5
Iran,Thailand,2000,1,1,2
Kenya,Tanzania,2000,3,0,3
Lebanon,Iraq,2000,2,2,4
China PR,Indonesia,2000,4,0,4
South Korea,Kuwait,2000,0,1,1
Japan,Uzbekistan,2000,8,1,9
Malaysia,Cambodia,2000,1,1,2
Saudi Arabia,Qatar,2000,0,0,0
Iran,Iraq,2000,1,0,1
Lebanon,Thailand,2000,1,1,2
China PR,Kuwait,2000,0,0,0
South Korea,Indonesia,2000,3,0,3
Japan,Qatar,2000,1,1,2
Saudi Arabia,Uzbekistan,2000,5,0,5
China PR,Qatar,2000,3,1,4
Iran,South Korea,2000,1,2,3
Malaysia,Sri Lanka,2000,2,0,2
Japan,Iraq,2000,4,1,5
Kuwait,Saudi Arabia,2000,2,3,5
Ghana,Uganda,2000,1,2,3
Malaysia,Sri Lanka,2000,3,1,4
United States,Mexico,2000,2,0,2
China PR,Japan,2000,2,3,5
South Korea,Saudi Arabia,2000,1,2,3
Eritrea,Rwanda,2000,0,1,1
Kenya,Uganda,2000,1,1,2
Singapore,Sri Lanka,2000,4,0,4
China PR,South Korea,2000,0,1,1
Japan,Saudi Arabia,2000,1,0,1
Oman,Yemen,2000,4,0,4
Zambia,Rwanda,2000,0,2,2
Rwanda,Zimbabwe,2000,1,0,1
Oman,Yemen,2000,4,0,4
Singapore,Indonesia,2000,1,0,1
Singapore,Cambodia,2000,1,0,1
Vietnam,Malaysia,2000,0,0,0
Indonesia,Philippines,2000,3,0,3
Thailand,Myanmar,2000,3,1,4
Cambodia,Vietnam,2000,0,6,6
Laos,Malaysia,2000,0,5,5
Myanmar,Philippines,2000,3,0,3
Malaysia,Cambodia,2000,3,2,5
Singapore,Laos,2000,3,0,3
Thailand,Indonesia,2000,4,1,5
Cambodia,Laos,2000,3,0,3
Vietnam,Singapore,2000,1,0,1
Myanmar,Indonesia,2000,0,5,5
Thailand,Philippines,2000,2,0,2
United Arab Emirates,Hong Kong,2000,1,1,2
Laos,Vietnam,2000,0,5,5
Malaysia,Singapore,2000,1,0,1
Algeria,Bulgaria,2000,1,2,3
Albania,Malta,2000,3,0,3
Barbados,United States,2000,0,4,4
Bolivia,Uruguay,2000,0,0,0
Brazil,Colombia,2000,1,0,1
Canada,Mexico,2000,0,0,0
Chile,Argentina,2000,0,2,2
Cyprus,Andorra,2000,5,0,5
Denmark,Germany,2000,2,1,3
El Salvador,Jamaica,2000,2,0,2
Estonia,Kyrgyzstan,2000,1,0,1
Greece,Slovakia,2000,0,2,2
Guatemala,Costa Rica,2000,2,1,3
Republic of Ireland,Finland,2000,3,0,3
Italy,England,2000,1,0,1
North Macedonia,Hungary,2000,0,1,1
Paraguay,Peru,2000,5,1,6
Poland,Iceland,2000,1,0,1
Portugal,Israel,2000,2,1,3
Romania,Serbia,2000,2,1,3
San Marino,Latvia,2000,0,1,1
Scotland,Australia,2000,0,2,2
Spain,Netherlands,2000,1,2,3
Trinidad and Tobago,Panama,2000,1,0,1
Tunisia,Switzerland,2000,1,1,2
Turkey,France,2000,0,4,4
Venezuela,Ecuador,2000,1,2,3
Thailand,Malaysia,2000,2,0,2
Vietnam,Indonesia,2000,2,3,5
Thailand,Indonesia,2000,4,1,5
Uganda,Ethiopia,2000,2,2,4
Vietnam,Malaysia,2000,0,3,3
Djibouti,Somalia,2000,0,0,0
Ivory Coast,Libya,2000,2,1,3
Uganda,Burundi,2000,2,1,3
Oman,Bahrain,2000,2,1,3
Somalia,Ethiopia,2000,1,2,3
Kenya,Rwanda,2000,1,2,3
Morocco,Libya,2000,0,0,0
Djibouti,Burundi,2000,2,4,6
Uganda,Somalia,2000,6,0,6
Iran,Guam,2000,19,0,19
Eritrea,Rwanda,2000,1,1,2
Ethiopia,Djibouti,2000,4,2,6
Tajikistan,Guam,2000,16,0,16
Ethiopia,Burundi,2000,1,0,1
Uganda,Djibouti,2000,7,0,7
Iran,Tajikistan,2000,2,0,2
Uganda,Rwanda,2000,3,1,4
Ethiopia,Rwanda,2000,1,1,2
Algeria,Romania,2000,3,2,5
Algeria,Romania,2000,2,3,5
Hong Kong,Estonia,2000,1,2,3
Greece,Serbia,2000,1,1,2
South Africa,Liberia,2000,2,1,3
Japan,South Korea,2000,1,1,2
Mexico,Argentina,2000,0,2,2
Catalonia,Lithuania,2000,5,0,5
Andalusia,Morocco,2000,2,0,2
Basque Country,Morocco,2000,3,2,5
Kenya,Zambia,2001,2,1,3
Costa Rica,Guatemala,2001,5,2,7
Egypt,United Arab Emirates,2001,2,1,3
Eswatini,Angola,2001,1,0,1
Angola,Lesotho,2001,2,0,2
Eswatini,Namibia,2001,2,1,3
Togo,Burkina Faso,2001,1,1,2
Egypt,Zambia,2001,3,1,4
Eswatini,Lesotho,2001,2,2,4
Romania,Jordan,2001,0,1,1
Algeria,Burundi,2001,2,1,3
Bosnia and Herzegovina,Bangladesh,2001,2,0,2
Qatar,Kuwait,2001,1,0,1
Uzbekistan,Bahrain,2001,5,0,5
Burkina Faso,Angola,2001,1,0,1
India,Iceland,2001,0,3,3
Kenya,Gabon,2001,2,1,3
Namibia,Madagascar,2001,2,2,4
Nigeria,Zambia,2001,1,0,1
Tunisia,Morocco,2001,0,1,1
Uganda,Senegal,2001,1,1,2
DR Congo,Ghana,2001,2,1,3
Egypt,Libya,2001,4,0,4
Guinea,Togo,2001,0,0,0
Liberia,Congo,2001,5,1,6
Romania,Hong Kong,2001,4,2,6
Serbia,Bosnia and Herzegovina,2001,1,1,2
Zimbabwe,Lesotho,2001,1,2,3
Chile,Bahrain,2001,2,0,2
Bangladesh,Serbia,2001,1,4,5
Hong Kong,Jordan,2001,0,2,2
Chile,Uzbekistan,2001,2,0,2
China PR,Egypt,2001,0,0,0
Israel,Uzbekistan,2001,2,0,2
Kuwait,Syria,2001,2,0,2
Iran,China PR,2001,4,0,4
Chile,Iceland,2001,2,0,2
Ivory Coast,Sudan,2001,2,0,2
Mali,Guinea,2001,0,1,1
Serbia,Romania,2001,2,0,2
Bosnia and Herzegovina,Chile,2001,1,0,1
Burkina Faso,Mali,2001,0,2,2
Egypt,North Korea,2001,1,0,1
Serbia,Japan,2001,1,0,1
Thailand,Kuwait,2001,5,4,9
South Korea,Norway,2001,2,3,5
Mexico,Bulgaria,2001,0,2,2
Benin,Cameroon,2001,1,3,4
Bosnia and Herzegovina,Serbia,2001,0,2,2
Algeria,Namibia,2001,1,0,1
Botswana,Eswatini,2001,1,2,3
Grenada,Trinidad and Tobago,2001,1,2,3
South Korea,Paraguay,2001,1,1,2
Nigeria,Sudan,2001,3,0,3
Singapore,Thailand,2001,1,1,2
South Africa,Burkina Faso,2001,1,0,1
United States,China PR,2001,2,1,3
Angola,Libya,2001,3,1,4
Antigua and Barbuda,British Virgin Islands,2001,1,1,2
Botswana,Lesotho,2001,2,1,3
Congo,Tunisia,2001,1,2,3
Egypt,Morocco,2001,0,0,0
Ghana,Liberia,2001,1,3,4
Guinea,Malawi,2001,1,1,2
Jamaica,Bulgaria,2001,0,0,0
Jordan,North Korea,2001,1,0,1
Madagascar,Ivory Coast,2001,1,3,4
Togo,Cameroon,2001,0,2,2
Grenada,Trinidad and Tobago,2001,0,2,2
Jordan,North Korea,2001,0,2,2
Saudi Arabia,Syria,2001,1,0,1
Thailand,Kyrgyzstan,2001,3,1,4
Lebanon,Iraq,2001,0,0,0
Mexico,Colombia,2001,2,3,5
Sweden,Faroe Islands,2001,0,0,0
Sweden,Finland,2001,0,1,1
Bahrain,Kuwait,2001,1,2,3
Puerto Rico,British Virgin Islands,2001,1,2,3
Saudi Arabia,Uganda,2001,3,1,4
Singapore,Kyrgyzstan,2001,0,1,1
United States,Colombia,2001,0,1,1
Senegal,Mali,2001,1,0,1
Fiji,Malaysia,2001,4,1,5
Bahrain,Kyrgyzstan,2001,1,0,1
Singapore,Kuwait,2001,1,1,2
Saint Martin,Montserrat,2001,3,1,4
Fiji,Malaysia,2001,2,0,2
Anguilla,Montserrat,2001,4,1,5
Morocco,South Korea,2001,1,1,2
Saudi Arabia,Mongolia,2001,6,0,6
Vietnam,Bangladesh,2001,0,0,0
Fiji,Malaysia,2001,1,2,3
Kyrgyzstan,Kuwait,2001,0,3,3
Singapore,Bahrain,2001,1,2,3
China PR,Qatar,2001,1,1,2
Mongolia,Vietnam,2001,0,1,1
Saudi Arabia,Bangladesh,2001,3,0,3
Saint Martin,Anguilla,2001,3,1,4
Thailand,Sweden,2001,1,4,5
British Virgin Islands,Puerto Rico,2001,0,0,0
Eswatini,Zambia,2001,0,0,0
United Arab Emirates,South Korea,2001,1,4,5
Armenia,Uzbekistan,2001,2,0,2
China PR,Sweden,2001,2,2,4
Mongolia,Bangladesh,2001,0,3,3
Saudi Arabia,Vietnam,2001,5,0,5
Thailand,Qatar,2001,1,3,4
Georgia,Ukraine,2001,0,0,0
Israel,Moldova,2001,1,0,1
Sweden,Qatar,2001,0,0,0
Thailand,China PR,2001,1,5,6
United Arab Emirates,Morocco,2001,1,1,2
Azerbaijan,Uzbekistan,2001,1,2,3
Bangladesh,Vietnam,2001,0,4,4
Kuwait,Finland,2001,4,3,7
Saudi Arabia,Mongolia,2001,6,0,6
China PR,Sweden,2001,0,3,3
Saudi Arabia,Bangladesh,2001,6,0,6
Thailand,Qatar,2001,2,0,2
Vietnam,Mongolia,2001,4,0,4
Oman,Finland,2001,1,2,3
Bangladesh,Mongolia,2001,2,2,4
Saudi Arabia,Vietnam,2001,4,0,4
Saint Kitts and Nevis,Saint Lucia,2001,2,0,2
Oman,Finland,2001,0,2,2
Kuwait,Singapore,2001,1,0,1
Kyrgyzstan,Bahrain,2001,1,2,3
Martinique,Saint Lucia,2001,4,2,6
Panama,Guatemala,2001,2,2,4
Libya,Togo,2001,3,3,6
Bahrain,Singapore,2001,2,0,2
Burkina Faso,Zimbabwe,2001,1,2,3
Kuwait,Kyrgyzstan,2001,2,0,2
Morocco,Senegal,2001,0,0,0
Namibia,Egypt,2001,1,1,2
Antigua and Barbuda,Saint Lucia,2001,0,1,1
Cameroon,Zambia,2001,1,0,1
Cayman Islands,Trinidad and Tobago,2001,0,3,3
Liberia,Sierra Leone,2001,1,0,1
Malawi,South Africa,2001,1,2,3
Oman,Maldives,2001,5,0,5
Sudan,Ghana,2001,1,0,1
Tunisia,DR Congo,2001,6,0,6
Cyprus,Lithuania,2001,1,2,3
Romania,Ukraine,2001,1,0,1
Algeria,Slovakia,2001,1,1,2
France,Germany,2001,1,0,1
Kuwait,Bahrain,2001,0,1,1
Kyrgyzstan,Singapore,2001,1,1,2
Oman,Maldives,2001,2,0,2
Belgium,San Marino,2001,10,1,11
Bosnia and Herzegovina,Hungary,2001,1,1,2
Colombia,Australia,2001,3,2,5
Costa Rica,Honduras,2001,2,2,4
Croatia,Austria,2001,1,0,1
Cyprus,Ukraine,2001,4,3,7
England,Spain,2001,3,0,3
Greece,Russia,2001,3,3,6
Italy,Argentina,2001,1,2,3
Jamaica,Trinidad and Tobago,2001,1,0,1
Jordan,Bulgaria,2001,0,2,2
Liechtenstein,Latvia,2001,0,2,2
Lithuania,Romania,2001,0,3,3
Luxembourg,Finland,2001,0,1,1
North Macedonia,Czech Republic,2001,1,1,2
Malta,Sweden,2001,0,3,3
Netherlands,Turkey,2001,0,0,0
Northern Ireland,Norway,2001,0,4,4
Portugal,Andorra,2001,3,0,3
Slovenia,Uruguay,2001,0,2,2
Switzerland,Poland,2001,0,4,4
United States,Mexico,2001,2,0,2
Saint Kitts and Nevis,Dominican Republic,2001,2,1,3
Antigua and Barbuda,Dominican Republic,2001,2,3,5
United States,Brazil,2001,1,2,3
Antigua and Barbuda,Saint Kitts and Nevis,2001,2,2,4
Hong Kong,Palestine,2001,1,1,2
Qatar,Malaysia,2001,5,1,6
Guatemala,El Salvador,2001,1,1,2
Honduras,Peru,2001,0,0,0
Jordan,Hungary,2001,1,1,2
Lebanon,Syria,2001,2,2,4
Mexico,Brazil,2001,3,3,6
Hong Kong,Malaysia,2001,0,2,2
Palestine,Qatar,2001,1,2,3
Botswana,Eswatini,2001,1,0,1
DR Congo,Ivory Coast,2001,1,2,3
Kenya,Uganda,2001,1,0,1
Lesotho,Mozambique,2001,0,0,0
Senegal,Namibia,2001,4,0,4
Sierra Leone,Sudan,2001,0,2,2
Zambia,Libya,2001,2,0,2
Botswana,Mozambique,2001,1,3,4
Egypt,Algeria,2001,5,2,7
Ghana,Nigeria,2001,0,0,0
Hong Kong,Qatar,2001,0,2,2
Lesotho,Eswatini,2001,2,1,3
Palestine,Malaysia,2001,1,0,1
Togo,Angola,2001,1,1,2
Zimbabwe,Malawi,2001,2,0,2
Grenada,Dominica,2001,8,3,11
Saint Lucia,Saint Vincent and the Grenadines,2001,0,2,2
Dominica,Saint Vincent and the Grenadines,2001,0,2,2
Grenada,Saint Lucia,2001,4,3,7
Panama,El Salvador,2001,1,0,1
Dominica,Saint Lucia,2001,1,1,2
Botswana,Malawi,2001,0,1,1
Dominica,Saint Lucia,2001,0,1,1
Gabon,Mali,2001,2,0,2
Egypt,Estonia,2001,3,3,6
Palestine,Hong Kong,2001,1,0,1
Qatar,Malaysia,2001,0,0,0
Honduras,Chile,2001,3,1,4
Saint Lucia,Martinique,2001,1,1,2
Hong Kong,Malaysia,2001,2,1,3
Libya,Egypt,2001,2,0,2
Qatar,Palestine,2001,2,1,3
Andorra,Netherlands,2001,0,5,5
Armenia,Wales,2001,2,2,4
Azerbaijan,Moldova,2001,0,0,0
Bosnia and Herzegovina,Austria,2001,1,1,2
British Virgin Islands,United States Virgin Islands,2001,2,0,2
Bulgaria,Iceland,2001,2,1,3
Croatia,Latvia,2001,4,1,5
Cyprus,Republic of Ireland,2001,0,4,4
England,Finland,2001,2,1,3
France,Japan,2001,5,0,5
Gabon,Kenya,2001,1,1,2
Germany,Albania,2001,2,1,3
Hungary,Lithuania,2001,1,1,2
Lesotho,Zimbabwe,2001,0,1,1
Luxembourg,Faroe Islands,2001,0,2,2
Madagascar,Namibia,2001,1,2,3
Malta,Denmark,2001,0,5,5
Morocco,Tunisia,2001,2,0,2
Northern Ireland,Czech Republic,2001,0,1,1
Norway,Poland,2001,2,3,5
Romania,Italy,2001,0,2,2
Russia,Slovenia,2001,1,1,2
Scotland,Belgium,2001,2,2,4
Senegal,Uganda,2001,3,0,3
Serbia,Switzerland,2001,1,1,2
South Africa,Mauritius,2001,3,0,3
Spain,Liechtenstein,2001,5,0,5
Sweden,North Macedonia,2001,1,0,1
Trinidad and Tobago,Guatemala,2001,3,1,4
Turkey,Slovakia,2001,1,1,2
Ukraine,Belarus,2001,0,0,0
Zambia,Nigeria,2001,1,1,2
Angola,Burkina Faso,2001,2,0,2
Burundi,Algeria,2001,0,1,1
Congo,Liberia,2001,0,1,1
Ghana,DR Congo,2001,3,0,3
Malaysia,Palestine,2001,4,3,7
Mexico,Jamaica,2001,4,0,4
Qatar,Hong Kong,2001,3,0,3
Sudan,Ivory Coast,2001,0,0,0
Colombia,Bolivia,2001,2,0,2
Oman,United Arab Emirates,2001,2,1,3
Peru,Chile,2001,3,1,4
Albania,England,2001,1,3,4
Andorra,Republic of Ireland,2001,0,3,3
Argentina,Venezuela,2001,5,0,5
Austria,Israel,2001,2,1,3
Belarus,Norway,2001,2,1,3
Bulgaria,Northern Ireland,2001,4,3,7
Costa Rica,Trinidad and Tobago,2001,3,0,3
Cyprus,Estonia,2001,2,2,4
Czech Republic,Denmark,2001,0,0,0
Ecuador,Brazil,2001,1,0,1
Georgia,Romania,2001,0,2,2
Greece,Germany,2001,2,4,6
Honduras,United States,2001,1,2,3
Italy,Lithuania,2001,4,0,4
Liechtenstein,Bosnia and Herzegovina,2001,0,3,3
North Macedonia,Turkey,2001,1,2,3
Martinique,Guadeloupe,2001,4,1,5
Moldova,Sweden,2001,0,2,2
Poland,Armenia,2001,4,0,4
Portugal,Netherlands,2001,2,2,4
Russia,Faroe Islands,2001,1,0,1
Scotland,San Marino,2001,4,0,4
Slovakia,Azerbaijan,2001,3,1,4
Slovenia,Serbia,2001,1,1,2
Spain,France,2001,2,1,3
Sri Lanka,Cambodia,2001,1,0,1
Switzerland,Luxembourg,2001,5,0,5
Uruguay,Paraguay,2001,0,1,1
Wales,Ukraine,2001,1,1,2
Maldives,Cambodia,2001,6,0,6
Barbados,Grenada,2001,2,1,3
Cayman Islands,British Virgin Islands,2001,2,2,4
Cuba,Dominica,2001,3,1,4
Guyana,Saint Martin,2001,2,0,2
Lebanon,Bahrain,2001,1,1,2
Suriname,Aruba,2001,5,0,5
Haiti,Panama,2001,1,1,2
Oman,Sudan,2001,0,1,1
Cuba,Saint Martin,2001,1,0,1
Grenada,Aruba,2001,4,2,6
Guyana,Dominica,2001,2,0,2
Martinique,British Virgin Islands,2001,6,0,6
Suriname,Barbados,2001,2,2,4
Brunei,Yemen,2001,0,5,5
Fiji,American Samoa,2001,13,0,13
Haiti,Panama,2001,0,0,0
Mauritania,Cape Verde,2001,0,1,1
Oman,Sudan,2001,1,1,2
Samoa,Tonga,2001,0,1,1
Barbados,Aruba,2001,5,2,7
Dominica,Saint Martin,2001,2,3,5
Guyana,Cuba,2001,0,3,3
India,United Arab Emirates,2001,1,0,1
Indonesia,Maldives,2001,5,0,5
Mali,Liberia,2001,3,0,3
Martinique,Cayman Islands,2001,1,1,2
Mauritius,Namibia,2001,1,0,1
Suriname,Grenada,2001,3,1,4
American Samoa,Samoa,2001,0,8,8
Australia,Tonga,2001,22,0,22
Guadeloupe,Saint Lucia,2001,2,3,5
Haiti,United States Virgin Islands,2001,12,1,13
Australia,American Samoa,2001,31,0,31
Mexico,Chile,2001,1,0,1
Samoa,Fiji,2001,1,6,7
Guadeloupe,United States Virgin Islands,2001,11,0,11
Haiti,Saint Lucia,2001,3,2,5
Iraq,Macau,2001,8,0,8
Nepal,Kazakhstan,2001,0,6,6
American Samoa,Tonga,2001,0,5,5
Australia,Fiji,2001,2,0,2
Brunei,United Arab Emirates,2001,0,12,12
Haiti,Guadeloupe,2001,2,0,2
Iraq,Nepal,2001,9,1,10
Kazakhstan,Macau,2001,3,0,3
Saint Lucia,United States Virgin Islands,2001,14,1,15
Cambodia,Maldives,2001,1,1,2
India,Yemen,2001,1,1,2
Australia,Samoa,2001,11,0,11
Bahrain,Oman,2001,0,1,1
Iraq,Kazakhstan,2001,1,1,2
Nepal,Macau,2001,4,1,5
Tonga,Fiji,2001,1,8,9
Burkina Faso,Malawi,2001,4,2,6
Kazakhstan,Nepal,2001,4,0,4
Macau,Iraq,2001,0,5,5
Morocco,Namibia,2001,3,0,3
Senegal,Algeria,2001,3,0,3
Sierra Leone,Nigeria,2001,1,0,1
Zambia,Angola,2001,1,1,2
Cameroon,Libya,2001,1,0,1
China PR,Maldives,2001,10,1,11
DR Congo,Madagascar,2001,1,0,1
Indonesia,Cambodia,2001,6,0,6
Ivory Coast,Congo,2001,2,0,2
Liberia,Sudan,2001,2,0,2
Mozambique,Lesotho,2001,1,0,1
Iraq,Nepal,2001,4,2,6
Kazakhstan,Macau,2001,5,0,5
Turkmenistan,Jordan,2001,2,0,2
Uzbekistan,Taiwan,2001,7,0,7
Belize,Nicaragua,2001,2,0,2
Chile,Uruguay,2001,0,1,1
Ecuador,Paraguay,2001,2,1,3
Egypt,Canada,2001,3,0,3
Georgia,Israel,2001,3,2,5
Iran,South Korea,2001,0,1,1
Panama,Haiti,2001,2,0,2
Venezuela,Colombia,2001,2,2,4
Austria,Liechtenstein,2001,2,0,2
Bolivia,Argentina,2001,3,3,6
Brazil,Peru,2001,1,1,2
Croatia,Greece,2001,2,2,4
Czech Republic,Belgium,2001,1,1,2
Denmark,Slovenia,2001,3,0,3
France,Portugal,2001,4,0,4
Hungary,Finland,2001,0,0,0
Republic of Ireland,Andorra,2001,3,1,4
Italy,South Africa,2001,1,0,1
Jamaica,Honduras,2001,1,1,2
Kazakhstan,Iraq,2001,1,1,2
Latvia,San Marino,2001,1,1,2
Lebanon,Philippines,2001,3,0,3
Macau,Nepal,2001,1,6,7
Malta,Iceland,2001,1,4,5
Moldova,Estonia,2001,0,0,0
Netherlands,Cyprus,2001,4,0,4
Norway,Bulgaria,2001,2,1,3
Poland,Scotland,2001,1,1,2
Romania,Slovakia,2001,0,0,0
Serbia,Russia,2001,0,1,1
Spain,Japan,2001,1,0,1
Switzerland,Sweden,2001,0,2,2
Trinidad and Tobago,Mexico,2001,1,1,2
Turkey,Albania,2001,0,2,2
United States,Costa Rica,2001,1,0,1
Uzbekistan,Turkmenistan,2001,1,0,1
Belize,Nicaragua,2001,2,1,3
Canada,Iran,2001,1,0,1
Egypt,South Korea,2001,1,2,3
United Arab Emirates,India,2001,1,0,1
Uzbekistan,Jordan,2001,2,2,4
Yemen,Brunei,2001,1,0,1
Bangladesh,Bhutan,2001,3,1,4
Congo,Madagascar,2001,2,0,2
Maldives,China PR,2001,0,1,1
Cambodia,Indonesia,2001,0,2,2
Mozambique,South Africa,2001,0,3,3
Oman,Laos,2001,12,0,12
Syria,Philippines,2001,12,0,12
Jordan,Taiwan,2001,6,0,6
Turkmenistan,Uzbekistan,2001,2,5,7
Algeria,Morocco,2001,1,2,3
Oman,Laos,2001,7,0,7
Syria,Philippines,2001,5,1,6
United Arab Emirates,Brunei,2001,4,0,4
Yemen,India,2001,3,3,6
Jordan,Turkmenistan,2001,1,2,3
Madagascar,Tunisia,2001,0,2,2
Nigeria,Liberia,2001,2,0,2
Sierra Leone,Ghana,2001,1,1,2
South Africa,Zimbabwe,2001,2,1,3
Saint Kitts and Nevis,Puerto Rico,2001,2,0,2
Angola,Cameroon,2001,2,0,2
Cambodia,China PR,2001,0,4,4
Congo,DR Congo,2001,1,1,2
Egypt,Senegal,2001,1,0,1
Maldives,Indonesia,2001,0,2,2
Togo,Zambia,2001,3,2,5
Guernsey,Jersey,2001,4,1,5
Jordan,Uzbekistan,2001,1,1,2
Oman,Philippines,2001,7,0,7
Syria,Laos,2001,11,0,11
Turkmenistan,Taiwan,2001,1,0,1
Estonia,Finland,2001,1,1,2
Georgia,Azerbaijan,2001,1,0,1
Trinidad and Tobago,Grenada,2001,5,3,8
Oman,Philippines,2001,2,0,2
Syria,Laos,2001,9,0,9
Yemen,United Arab Emirates,2001,2,1,3
Brunei,India,2001,0,1,1
China PR,Indonesia,2001,5,1,6
Lebanon,Pakistan,2001,6,0,6
Thailand,Sri Lanka,2001,4,2,6
Lebanon,Sri Lanka,2001,4,0,4
Martinique,Jamaica,2001,0,1,1
Thailand,Pakistan,2001,3,0,3
Trinidad and Tobago,Barbados,2001,5,0,5
Cuba,Suriname,2001,4,3,7
Haiti,Saint Kitts and Nevis,2001,7,2,9
Lebanon,Thailand,2001,1,2,3
Martinique,Barbados,2001,3,1,4
Pakistan,Sri Lanka,2001,3,3,6
Trinidad and Tobago,Jamaica,2001,2,1,3
Andalusia,Iraq,2001,3,1,4
Haiti,Suriname,2001,1,1,2
Saint Kitts and Nevis,Cuba,2001,1,1,2
Syria,Oman,2001,3,3,6
United Arab Emirates,Yemen,2001,3,2,5
Barbados,Jamaica,2001,1,2,3
Laos,Philippines,2001,2,0,2
Trinidad and Tobago,Martinique,2001,1,2,3
China PR,Cambodia,2001,3,1,4
Haiti,Cuba,2001,0,0,0
India,Brunei,2001,5,0,5
Lesotho,Eswatini,2001,1,0,1
Suriname,Saint Kitts and Nevis,2001,0,4,4
Tunisia,Ivory Coast,2001,1,1,2
Haiti,Martinique,2001,5,0,5
Singapore,New Zealand,2001,3,0,3
Trinidad and Tobago,Cuba,2001,2,0,2
Costa Rica,Belize,2001,4,0,4
El Salvador,Nicaragua,2001,3,0,3
Honduras,Panama,2001,1,2,3
Martinique,Cuba,2001,1,0,1
El Salvador,Panama,2001,2,1,3
England,Mexico,2001,4,0,4
Guatemala,Belize,2001,3,3,6
Honduras,Nicaragua,2001,10,2,12
South Korea,Cameroon,2001,0,0,0
Oman,Syria,2001,2,0,2
Trinidad and Tobago,Haiti,2001,3,0,3
Pakistan,Lebanon,2001,1,8,9
Philippines,Laos,2001,1,1,2
Thailand,Sri Lanka,2001,3,0,3
Costa Rica,Guatemala,2001,1,1,2
Honduras,El Salvador,2001,1,1,2
Indonesia,China PR,2001,0,2,2
Panama,Nicaragua,2001,6,0,6
Sri Lanka,Lebanon,2001,0,5,5
Thailand,Pakistan,2001,6,0,6
Germany,Slovakia,2001,2,0,2
El Salvador,Guatemala,2001,0,0,0
South Korea,France,2001,0,5,5
Mexico,Australia,2001,0,2,2
Panama,Costa Rica,2001,1,2,3
Sri Lanka,Pakistan,2001,3,1,4
Thailand,Lebanon,2001,2,2,4
Brazil,Cameroon,2001,2,0,2
Japan,Canada,2001,3,0,3
Algeria,Angola,2001,3,2,5
Australia,France,2001,1,0,1
El Salvador,Panama,2001,1,1,2
Guatemala,Costa Rica,2001,2,0,2
South Korea,Mexico,2001,2,1,3
Armenia,Belarus,2001,0,0,0
Belgium,Latvia,2001,3,1,4
Canada,Brazil,2001,0,0,0
Croatia,San Marino,2001,4,0,4
Denmark,Czech Republic,2001,2,1,3
Estonia,Netherlands,2001,2,4,6
Faroe Islands,Switzerland,2001,0,1,1
Finland,Germany,2001,2,2,4
Gabon,Tunisia,2001,1,1,2
Georgia,Italy,2001,1,2,3
Greece,Albania,2001,1,0,1
Iceland,Malta,2001,3,0,3
Republic of Ireland,Portugal,2001,1,1,2
Japan,Cameroon,2001,2,0,2
Kenya,Morocco,2001,1,1,2
Liechtenstein,Israel,2001,0,3,3
North Macedonia,Moldova,2001,2,2,4
Nigeria,Madagascar,2001,1,0,1
Northern Ireland,Bulgaria,2001,0,1,1
Paraguay,Chile,2001,1,0,1
Peru,Ecuador,2001,1,2,3
Romania,Hungary,2001,2,0,2
Russia,Serbia,2001,1,1,2
Slovenia,Luxembourg,2001,2,0,2
Spain,Bosnia and Herzegovina,2001,4,1,5
Sweden,Slovakia,2001,2,0,2
Turkey,Azerbaijan,2001,3,0,3
Uganda,Togo,2001,0,3,3
Ukraine,Norway,2001,0,0,0
Wales,Poland,2001,1,2,3
Zambia,Namibia,2001,0,0,0
Argentina,Colombia,2001,3,0,3
Bolivia,Venezuela,2001,5,0,5
Burundi,Burkina Faso,2001,0,0,0
Congo,Mauritius,2001,0,0,0
Costa Rica,El Salvador,2001,1,1,2
France,Mexico,2001,4,0,4
Gambia,Senegal,2001,0,0,0
Guatemala,Panama,2001,3,1,4
South Korea,Australia,2001,1,0,1
Lesotho,DR Congo,2001,0,0,0
Liberia,South Africa,2001,1,1,2
Libya,Ivory Coast,2001,0,3,3
Zimbabwe,Ghana,2001,1,2,3
Cameroon,Canada,2001,2,0,2
Japan,Brazil,2001,0,0,0
Solomon Islands,Cook Islands,2001,9,1,10
Vanuatu,Tahiti,2001,1,6,7
Albania,Germany,2001,0,2,2
Armenia,Poland,2001,1,1,2
Azerbaijan,Slovakia,2001,2,0,2
Cook Islands,Vanuatu,2001,1,8,9
Czech Republic,Northern Ireland,2001,3,1,4
Denmark,Malta,2001,2,1,3
Estonia,Republic of Ireland,2001,0,2,2
Faroe Islands,Serbia,2001,0,6,6
Greece,England,2001,0,2,2
Hungary,Georgia,2001,4,1,5
Iceland,Bulgaria,2001,1,1,2
Israel,Spain,2001,1,1,2
Latvia,Croatia,2001,0,1,1
Lithuania,Romania,2001,1,2,3
Luxembourg,Russia,2001,1,2,3
New Zealand,Tahiti,2001,5,0,5
Norway,Belarus,2001,1,1,2
Portugal,Cyprus,2001,6,0,6
San Marino,Belgium,2001,1,4,5
Sweden,Moldova,2001,6,0,6
Switzerland,Slovenia,2001,0,1,1
Turkey,North Macedonia,2001,3,3,6
Ukraine,Wales,2001,1,1,2
France,Brazil,2001,2,1,3
Japan,Australia,2001,1,0,1
United States,Ecuador,2001,0,0,0
New Zealand,Cook Islands,2001,2,0,2
Vanuatu,Solomon Islands,2001,2,7,9
Australia,Brazil,2001,1,0,1
Angola,Mauritius,2001,1,0,1
Jamaica,Cuba,2001,4,1,5
Japan,France,2001,0,1,1
Kenya,Egypt,2001,1,1,2
Panama,Trinidad and Tobago,2001,0,0,0
Sierra Leone,Gambia,2001,1,1,2
Cook Islands,Tahiti,2001,0,6,6
New Zealand,Solomon Islands,2001,5,1,6
New Zealand,Vanuatu,2001,7,0,7
Tahiti,Solomon Islands,2001,2,0,2
Jamaica,United States,2001,0,0,0
Madagascar,Zambia,2001,0,1,1
Mexico,Costa Rica,2001,1,2,3
Morocco,Gabon,2001,0,1,1
Namibia,Nigeria,2001,0,2,2
Trinidad and Tobago,Honduras,2001,2,4,6
Angola,Burundi,2001,2,1,3
Burkina Faso,Algeria,2001,1,0,1
DR Congo,Zimbabwe,2001,2,1,3
Ivory Coast,Egypt,2001,2,2,4
Sudan,Libya,2001,1,0,1
Costa Rica,Jamaica,2001,2,1,3
Honduras,Mexico,2001,3,1,4
New Zealand,Australia,2001,0,2,2
United States,Trinidad and Tobago,2001,2,0,2
Slovakia,Bosnia and Herzegovina,2001,0,1,1
Malaysia,Bahrain,2001,2,4,6
Malaysia,Slovakia,2001,0,2,2
Bahrain,Bosnia and Herzegovina,2001,0,1,1
Bermuda,Trinidad and Tobago,2001,0,5,5
Australia,New Zealand,2001,4,1,5
Belize,Cuba,2001,3,2,5
Lesotho,Zambia,2001,1,2,3
Bahrain,Slovakia,2001,2,0,2
Malaysia,Bosnia and Herzegovina,2001,2,2,4
India,Uzbekistan,2001,1,2,3
Bahrain,Uzbekistan,2001,0,2,2
Paraguay,Serbia,2001,2,0,2
Libya,Angola,2001,1,1,2
Bosnia and Herzegovina,Uzbekistan,2001,1,2,3
Greenland,Tibet,2001,4,1,5
Morocco,Egypt,2001,1,0,1
Namibia,Algeria,2001,0,4,4
Trinidad and Tobago,Jamaica,2001,1,2,3
Burkina Faso,South Africa,2001,1,1,2
Cameroon,Togo,2001,2,0,2
Honduras,Costa Rica,2001,2,3,5
Ivory Coast,Madagascar,2001,6,0,6
Japan,Paraguay,2001,2,0,2
Liberia,Ghana,2001,1,2,3
Malawi,Eswatini,2001,2,2,4
Mexico,United States,2001,1,0,1
Sudan,Nigeria,2001,0,4,4
Tunisia,Congo,2001,6,0,6
Uruguay,Brazil,2001,1,0,1
El Salvador,Ecuador,2001,0,1,1
Latvia,Estonia,2001,3,1,4
Estonia,Lithuania,2001,2,5,7
Japan,Serbia,2001,1,0,1
Latvia,Lithuania,2001,4,1,5
Honduras,Ecuador,2001,1,1,2
Zimbabwe,Eswatini,2001,2,1,3
Ynys Môn,Saare County,2001,4,1,5
Jersey,Orkney,2001,12,0,12
Isle of Wight,Greenland,2001,0,0,0
Isle of Man,Falkland Islands,2001,9,0,9
Saare County,Shetland,2001,2,3,5
Orkney,Gibraltar,2001,0,2,2
Greenland,Rhodes,2001,0,2,2
Guernsey,Falkland Islands,2001,3,0,3
Singapore,Saudi Arabia,2001,0,3,3
Ynys Môn,Shetland,2001,1,1,2
Jersey,Gibraltar,2001,2,1,3
Rhodes,Isle of Wight,2001,1,4,5
Isle of Man,Guernsey,2001,2,3,5
Colombia,Venezuela,2001,2,0,2
Ecuador,Chile,2001,1,4,5
Brazil,Mexico,2001,0,1,1
Peru,Paraguay,2001,3,3,6
Saare County,Orkney,2001,2,1,3
Greenland,Falkland Islands,2001,4,0,4
Isle of Man,Rhodes,2001,1,3,4
Gibraltar,Shetland,2001,2,0,2
Isle of Wight,Guernsey,2001,2,3,5
Ynys Môn,Jersey,2001,2,2,4
Bolivia,Uruguay,2001,0,1,1
Egypt,Namibia,2001,8,2,10
Honduras,Costa Rica,2001,0,1,1
Orkney,Falkland Islands,2001,1,4,5
Greenland,Saare County,2001,2,0,2
Isle of Man,Shetland,2001,2,2,4
Gibraltar,Rhodes,2001,2,0,2
Isle of Wight,Jersey,2001,0,2,2
Guernsey,Ynys Môn,2001,0,0,0
Chile,Venezuela,2001,1,0,1
Colombia,Ecuador,2001,1,0,1
Monaco,Tibet,2001,2,1,3
Senegal,Morocco,2001,1,0,1
Sierra Leone,Liberia,2001,0,1,1
South Africa,Malawi,2001,2,0,2
Zambia,Cameroon,2001,2,2,4
Brazil,Peru,2001,2,0,2
Congo,Ivory Coast,2001,1,1,2
DR Congo,Tunisia,2001,0,3,3
Ghana,Sudan,2001,1,0,1
Paraguay,Mexico,2001,0,0,0
Togo,Libya,2001,2,0,2
Zimbabwe,Burkina Faso,2001,1,0,1
Honduras,Bolivia,2001,2,0,2
Uruguay,Costa Rica,2001,1,1,2
Colombia,Chile,2001,2,0,2
Ecuador,Venezuela,2001,4,0,4
Brazil,Paraguay,2001,3,1,4
Peru,Mexico,2001,1,0,1
Bolivia,Costa Rica,2001,0,4,4
Honduras,Uruguay,2001,1,0,1
Malaysia,Saudi Arabia,2001,0,4,4
Cuba,Jamaica,2001,0,0,0
Algeria,Egypt,2001,1,1,2
Malawi,South Africa,2001,1,0,1
Namibia,Senegal,2001,0,5,5
Bosnia and Herzegovina,Iran,2001,2,2,4
Chile,Mexico,2001,0,2,2
Uruguay,Costa Rica,2001,2,1,3
Brazil,Honduras,2001,0,2,2
Colombia,Peru,2001,3,0,3
Saudi Arabia,North Korea,2001,1,0,1
North Macedonia,Qatar,2001,0,1,1
Mexico,Uruguay,2001,2,1,3
Colombia,Honduras,2001,2,0,2
Jamaica,Martinique,2001,0,0,0
Libya,Zambia,2001,2,4,6
Malawi,Zimbabwe,2001,0,1,1
Saint Kitts and Nevis,Martinique,2001,4,2,6
Uruguay,Honduras,2001,2,2,4
Angola,Togo,2001,1,1,2
Colombia,Mexico,2001,1,0,1
Ivory Coast,DR Congo,2001,1,2,3
Madagascar,Congo,2001,1,0,1
Nigeria,Ghana,2001,3,0,3
Oman,Iraq,2001,1,0,1
Panama,Cuba,2001,0,0,0
Sudan,Sierra Leone,2001,3,0,3
Saint Kitts and Nevis,Jamaica,2001,0,0,0
Grenada,Jamaica,2001,2,0,2
Qatar,Iran,2001,2,1,3
Saudi Arabia,North Macedonia,2001,1,1,2
United Arab Emirates,Iraq,2001,2,2,4
China PR,North Korea,2001,2,2,4
Kuwait,Trinidad and Tobago,2001,1,1,2
Colombia,Liberia,2001,2,1,3
China PR,Trinidad and Tobago,2001,3,0,3
Cuba,Panama,2001,1,0,1
Kuwait,North Korea,2001,1,1,2
Saudi Arabia,Qatar,2001,1,2,3
Iran,Oman,2001,5,2,7
United Arab Emirates,Saudi Arabia,2001,0,1,1
Brazil,Panama,2001,5,0,5
Iran,Bosnia and Herzegovina,2001,4,0,4
Qatar,Bahrain,2001,1,1,2
Singapore,Thailand,2001,0,5,5
Chile,Bolivia,2001,2,2,4
Venezuela,Uruguay,2001,2,0,2
Austria,Switzerland,2001,1,2,3
Bosnia and Herzegovina,Malta,2001,2,0,2
Brazil,Paraguay,2001,2,0,2
Bulgaria,North Macedonia,2001,1,0,1
Czech Republic,South Korea,2001,5,0,5
Ecuador,Argentina,2001,0,2,2
England,Netherlands,2001,0,2,2
Estonia,Cyprus,2001,2,2,4
Finland,Belgium,2001,4,1,5
France,Denmark,2001,1,0,1
Hungary,Germany,2001,2,5,7
Iceland,Poland,2001,1,1,2
Republic of Ireland,Croatia,2001,2,2,4
Japan,Australia,2001,3,0,3
Latvia,Ukraine,2001,0,1,1
Lithuania,Israel,2001,2,3,5
Luxembourg,Georgia,2001,0,3,3
Norway,Turkey,2001,1,1,2
Portugal,Moldova,2001,3,0,3
Russia,Greece,2001,0,0,0
Serbia,Faroe Islands,2001,2,0,2
Slovakia,Iran,2001,3,4,7
Slovenia,Romania,2001,2,2,4
Sweden,South Africa,2001,3,0,3
Colombia,Peru,2001,0,1,1
Qatar,Oman,2001,0,0,0
Iraq,Thailand,2001,4,0,4
Saudi Arabia,Bahrain,2001,1,1,2
United Arab Emirates,Uzbekistan,2001,4,1,5
Zambia,Angola,2001,1,1,2
Bahrain,Iraq,2001,2,0,2
Mexico,Liberia,2001,5,4,9
Iran,Saudi Arabia,2001,2,0,2
China PR,United Arab Emirates,2001,3,0,3
Malawi,Zimbabwe,2001,0,2,2
Uzbekistan,Qatar,2001,2,1,3
Oman,China PR,2001,0,2,2
Saudi Arabia,Iraq,2001,1,0,1
United Arab Emirates,Qatar,2001,0,2,2
Albania,Finland,2001,0,2,2
Andorra,Portugal,2001,1,7,8
Belarus,Ukraine,2001,0,2,2
Bosnia and Herzegovina,Israel,2001,0,0,0
Chile,France,2001,2,1,3
Denmark,Northern Ireland,2001,1,1,2
Faroe Islands,Luxembourg,2001,1,0,1
Georgia,Hungary,2001,3,1,4
Germany,England,2001,1,5,6
Iceland,Czech Republic,2001,3,1,4
Republic of Ireland,Netherlands,2001,1,0,1
Lithuania,Italy,2001,0,0,0
North Macedonia,Sweden,2001,1,2,3
Malta,Bulgaria,2001,0,2,2
Moldova,Azerbaijan,2001,2,0,2
Poland,Norway,2001,3,0,3
Scotland,Croatia,2001,0,0,0
Slovakia,Turkey,2001,0,1,1
Slovenia,Russia,2001,2,1,3
Spain,Austria,2001,4,0,4
Switzerland,Serbia,2001,1,2,3
Thailand,Iran,2001,0,0,0
Trinidad and Tobago,Costa Rica,2001,0,2,2
United States,Honduras,2001,2,3,5
Wales,Armenia,2001,0,0,0
Jamaica,Mexico,2001,1,2,3
Chile,Venezuela,2001,0,2,2
Peru,Uruguay,2001,0,2,2
Argentina,Brazil,2001,2,1,3
Austria,Bosnia and Herzegovina,2001,2,0,2
Azerbaijan,North Macedonia,2001,1,1,2
Belarus,Poland,2001,4,1,5
Belgium,Scotland,2001,2,0,2
Bulgaria,Denmark,2001,0,2,2
Colombia,Ecuador,2001,0,0,0
Costa Rica,United States,2001,2,0,2
Cyprus,Portugal,2001,1,3,4
Czech Republic,Malta,2001,3,2,5
England,Albania,2001,2,0,2
Faroe Islands,Russia,2001,0,3,3
Finland,Greece,2001,5,1,6
Georgia,Lithuania,2001,2,0,2
Honduras,Jamaica,2001,1,0,1
Hungary,Romania,2001,0,2,2
Italy,Morocco,2001,1,0,1
Liechtenstein,Spain,2001,0,2,2
Luxembourg,Switzerland,2001,0,3,3
Mexico,Trinidad and Tobago,2001,3,0,3
Netherlands,Estonia,2001,5,0,5
Northern Ireland,Iceland,2001,3,0,3
Norway,Wales,2001,3,2,5
Paraguay,Bolivia,2001,5,1,6
San Marino,Croatia,2001,0,4,4
Serbia,Slovenia,2001,1,1,2
Slovakia,Moldova,2001,4,2,6
Turkey,Sweden,2001,1,2,3
Ukraine,Armenia,2001,3,0,3
Bahrain,Thailand,2001,1,1,2
Iraq,Iran,2001,1,2,3
Qatar,China PR,2001,1,1,2
Saudi Arabia,United Arab Emirates,2001,0,2,2
Uzbekistan,Oman,2001,5,0,5
South Korea,Nigeria,2001,2,2,4
Iran,Bahrain,2001,0,0,0
Oman,United Arab Emirates,2001,1,1,2
Qatar,Iraq,2001,0,0,0
China PR,Uzbekistan,2001,2,0,2
Thailand,Saudi Arabia,2001,1,3,4
Angola,Zimbabwe,2001,0,0,0
South Korea,Nigeria,2001,2,1,3
Bahrain,Saudi Arabia,2001,0,4,4
Oman,Qatar,2001,0,3,3
Thailand,Iraq,2001,1,1,2
Uzbekistan,United Arab Emirates,2001,0,1,1
United Arab Emirates,China PR,2001,0,1,1
Iraq,Bahrain,2001,1,0,1
Qatar,Uzbekistan,2001,2,2,4
Saudi Arabia,Iran,2001,2,2,4
Thailand,Oman,2001,2,0,2
Zimbabwe,Angola,2001,0,1,1
Japan,Senegal,2001,0,2,2
Qatar,United Arab Emirates,2001,1,2,3
Bahrain,Qatar,2001,1,0,1
Iran,Thailand,2001,1,0,1
Iraq,Saudi Arabia,2001,1,2,3
Armenia,Norway,2001,1,4,5
Bolivia,Ecuador,2001,1,5,6
Croatia,Belgium,2001,1,0,1
Czech Republic,Bulgaria,2001,6,0,6
Denmark,Iceland,2001,6,0,6
England,Greece,2001,2,2,4
France,Algeria,2001,4,1,5
Germany,Finland,2001,0,0,0
Republic of Ireland,Cyprus,2001,4,0,4
Italy,Hungary,2001,1,0,1
Malta,Northern Ireland,2001,0,1,1
Moldova,Turkey,2001,0,3,3
Netherlands,Andorra,2001,4,0,4
Poland,Ukraine,2001,1,1,2
Portugal,Estonia,2001,5,0,5
Romania,Georgia,2001,1,1,2
Russia,Switzerland,2001,4,0,4
Scotland,Latvia,2001,2,1,3
Serbia,Luxembourg,2001,6,2,8
Slovenia,Faroe Islands,2001,3,0,3
Venezuela,Peru,2001,3,0,3
Wales,Belarus,2001,1,0,1
Bosnia and Herzegovina,Liechtenstein,2001,5,0,5
Brazil,Chile,2001,2,0,2
China PR,Oman,2001,1,0,1
Costa Rica,Mexico,2001,0,0,0
Honduras,Trinidad and Tobago,2001,0,1,1
Japan,Nigeria,2001,2,2,4
North Macedonia,Slovakia,2001,0,5,5
Paraguay,Argentina,2001,2,2,4
Sweden,Azerbaijan,2001,3,0,3
Uruguay,Colombia,2001,1,1,2
United States,Jamaica,2001,2,1,3
Gambia,Morocco,2001,0,2,2
Iran,Iraq,2001,2,1,3
China PR,Qatar,2001,3,0,3
Oman,Uzbekistan,2001,4,2,6
Mali,Morocco,2001,2,1,3
Algeria,Burkina Faso,2001,2,0,2
Thailand,Bahrain,2001,1,1,2
Kuwait,Qatar,2001,0,1,1
United Arab Emirates,Oman,2001,2,2,4
Uzbekistan,China PR,2001,1,0,1
Bahamas,Haiti,2001,0,2,2
Bahrain,Iran,2001,3,1,4
Saudi Arabia,Thailand,2001,4,1,5
Kenya,Uganda,2001,0,0,0
Tanzania,DR Congo,2001,2,2,4
Iran,United Arab Emirates,2001,1,0,1
DR Congo,Uganda,2001,0,1,1
Israel,Austria,2001,1,1,2
Tanzania,Kenya,2001,3,1,4
Mexico,El Salvador,2001,4,1,5
United Arab Emirates,Iran,2001,0,3,3
Benin,Guinea-Bissau,2001,2,7,9
Mali,Mauritania,2001,3,2,5
Benin,Mauritania,2001,2,0,2
Mali,Guinea-Bissau,2001,2,0,2
Bolivia,Brazil,2001,3,1,4
Cape Verde,Gambia,2001,1,1,2
Colombia,Chile,2001,3,1,4
Ecuador,Uruguay,2001,1,1,2
Guinea-Bissau,Mauritania,2001,1,0,1
Japan,Italy,2001,1,1,2
Mali,Benin,2001,0,0,0
Argentina,Peru,2001,2,0,2
South Korea,Senegal,2001,0,1,1
Venezuela,Paraguay,2001,3,1,4
Mali,Gambia,2001,0,1,1
Austria,Turkey,2001,0,1,1
Belgium,Czech Republic,2001,1,0,1
Denmark,Netherlands,2001,1,1,2
England,Sweden,2001,1,1,2
Greece,Estonia,2001,4,2,6
Republic of Ireland,Iran,2001,2,0,2
South Korea,Croatia,2001,2,0,2
Slovenia,Romania,2001,2,1,3
South Africa,Egypt,2001,1,0,1
Ukraine,Germany,2001,1,1,2
Australia,France,2001,1,1,2
Jamaica,Costa Rica,2001,0,1,1
Mali,Guinea-Bissau,2001,2,1,3
Mexico,Honduras,2001,3,0,3
Trinidad and Tobago,United States,2001,0,0,0
South Korea,Croatia,2001,1,1,2
Brazil,Venezuela,2001,3,0,3
Chile,Ecuador,2001,0,0,0
Czech Republic,Belgium,2001,0,1,1
Estonia,Kazakhstan,2001,0,0,0
Germany,Ukraine,2001,4,1,5
Greece,Cyprus,2001,1,2,3
Hungary,North Macedonia,2001,5,0,5
Latvia,Russia,2001,1,3,4
Malta,Canada,2001,2,1,3
Morocco,Zambia,2001,1,0,1
Paraguay,Colombia,2001,0,4,4
Peru,Bolivia,2001,1,1,2
Poland,Cameroon,2001,0,0,0
Portugal,Angola,2001,5,1,6
Romania,Slovenia,2001,1,1,2
Spain,Mexico,2001,1,0,1
Turkey,Austria,2001,5,0,5
Uruguay,Argentina,2001,1,1,2
Iran,Republic of Ireland,2001,1,0,1
Australia,Uruguay,2001,1,0,1
Madagascar,Mayotte,2001,1,0,1
Ethiopia,Zambia,2001,1,2,3
Uruguay,Australia,2001,3,0,3
Tunisia,Togo,2001,1,0,1
Oman,Kuwait,2001,1,1,2
Algeria,Ghana,2001,1,1,2
Mali,Ivory Coast,2001,0,3,3
Rwanda,Somalia,2001,3,0,3
Burundi,Tanzania,2001,1,2,3
South Korea,United States,2001,1,0,1
Uganda,Djibouti,2001,10,1,11
Kenya,Eritrea,2001,2,1,3
Burundi,Djibouti,2001,3,1,4
Uganda,Tanzania,2001,0,1,1
Kenya,Somalia,2001,3,0,3
Rwanda,Eritrea,2001,1,0,1
Bahrain,Oman,2001,2,2,4
Ethiopia,Zanzibar,2001,5,0,5
Tanzania,Djibouti,2001,4,1,5
Eritrea,Somalia,2001,0,0,0
Uganda,Burundi,2001,0,2,2
Botswana,Namibia,2001,3,2,5
El Salvador,Haiti,2001,0,0,0
Rwanda,Kenya,2001,0,0,0
Botswana,Lesotho,2001,1,0,1
Burkina Faso,Togo,2001,1,2,3
Kenya,Eritrea,2001,1,0,1
Ethiopia,Burundi,2001,2,2,4
Rwanda,Uganda,2001,3,2,5
Rwanda,Ethiopia,2001,0,1,1
Kenya,Ethiopia,2001,1,2,3
Togo,Burkina Faso,2001,1,0,1
Oman,Syria,2001,2,0,2
Mali,Ghana,2001,1,1,2
Oman,Syria,2001,1,0,1
Senegal,Burkina Faso,2001,2,4,6
Andalusia,Tunisia,2001,3,3,6
Mali,Burkina Faso,2001,2,1,3
Catalonia,Chile,2001,1,0,1
Kuwait,Syria,2001,0,0,0
Basque Country,Ghana,2001,3,2,5
Benin,Togo,2001,1,1,2
Oman,North Macedonia,2001,2,0,2
Qatar,Egypt,2001,2,2,4
Saudi Arabia,Zimbabwe,2001,0,2,2
Senegal,Algeria,2001,1,0,1
Tunisia,Liberia,2001,7,2,9
Kuwait,Syria,2001,2,2,4
Bahrain,Finland,2002,0,2,2
Egypt,Ghana,2002,2,0,2
Martinique,Guadeloupe,2002,1,3,4
Albania,North Macedonia,2002,0,0,0
Kuwait,Zimbabwe,2002,3,0,3
Cuba,Guatemala,2002,0,1,1
Egypt,Mali,2002,1,2,3
Martinique,Haiti,2002,3,3,6
Albania,Finland,2002,1,1,2
Bahrain,North Macedonia,2002,1,1,2
Burkina Faso,Cameroon,2002,1,3,4
Kuwait,Iceland,2002,0,0,0
Qatar,Zimbabwe,2002,0,2,2
Cuba,Guatemala,2002,0,0,0
Bahrain,Albania,2002,3,0,3
Finland,North Macedonia,2002,3,0,3
Mali,Zambia,2002,1,1,2
Saudi Arabia,Iceland,2002,1,0,1
Egypt,Burkina Faso,2002,2,2,4
Grenada,Trinidad and Tobago,2002,2,3,5
Iraq,Oman,2002,2,0,2
Tunisia,Cameroon,2002,0,1,1
Ecuador,Guatemala,2002,1,0,1
Ivory Coast,Nigeria,2002,1,1,2
Morocco,Guinea,2002,2,1,3
Qatar,Iraq,2002,1,3,4
Algeria,Benin,2002,4,0,4
South Africa,Angola,2002,1,0,1
Gambia,Morocco,2002,0,2,2
Saudi Arabia,Kuwait,2002,1,1,2
Qatar,Bahrain,2002,1,0,1
United Arab Emirates,Oman,2002,1,0,1
Haiti,Canada,2002,0,2,2
Martinique,Costa Rica,2002,0,2,2
El Salvador,Mexico,2002,0,1,1
Kuwait,Oman,2002,1,3,4
Mali,Liberia,2002,1,1,2
Saint Kitts and Nevis,Grenada,2002,1,1,2
United States,South Korea,2002,2,1,3
Antigua and Barbuda,Dominica,2002,4,0,4
Cameroon,DR Congo,2002,1,0,1
Costa Rica,Trinidad and Tobago,2002,1,1,2
Ecuador,Haiti,2002,0,2,2
Egypt,Senegal,2002,0,1,1
Saudi Arabia,Bahrain,2002,3,1,4
South Africa,Burkina Faso,2002,0,0,0
United Arab Emirates,Qatar,2002,0,2,2
Algeria,Nigeria,2002,0,1,1
Mexico,Guatemala,2002,3,1,4
Morocco,Ghana,2002,0,0,0
Togo,Ivory Coast,2002,0,0,0
United States,Cuba,2002,1,0,1
Zambia,Tunisia,2002,0,0,0
Canada,Ecuador,2002,0,2,2
Kuwait,Bahrain,2002,0,0,0
Trinidad and Tobago,Martinique,2002,0,1,1
Guatemala,El Salvador,2002,0,1,1
South Korea,Cuba,2002,0,0,0
Mali,Nigeria,2002,0,0,0
South Africa,Ghana,2002,0,0,0
Oman,Qatar,2002,1,2,3
Saudi Arabia,United Arab Emirates,2002,1,0,1
Cameroon,Ivory Coast,2002,1,0,1
Egypt,Tunisia,2002,1,0,1
Liberia,Algeria,2002,2,2,4
Burkina Faso,Morocco,2002,1,2,3
Canada,Martinique,2002,1,1,2
DR Congo,Togo,2002,0,0,0
Costa Rica,Haiti,2002,2,1,3
Senegal,Zambia,2002,1,0,1
Kuwait,Qatar,2002,0,1,1
Mexico,South Korea,2002,0,0,0
United States,El Salvador,2002,4,0,4
United Arab Emirates,Bahrain,2002,1,2,3
Saudi Arabia,Oman,2002,2,0,2
Liberia,Nigeria,2002,0,1,1
Mali,Algeria,2002,2,0,2
Cameroon,Togo,2002,3,0,3
DR Congo,Ivory Coast,2002,3,1,4
Kuwait,United Arab Emirates,2002,2,1,3
Burkina Faso,Ghana,2002,1,2,3
Costa Rica,South Korea,2002,3,1,4
South Africa,Morocco,2002,3,1,4
United States,Canada,2002,0,0,0
Bahrain,Oman,2002,1,1,2
Saudi Arabia,Qatar,2002,3,1,4
Brazil,Bolivia,2002,6,0,6
Egypt,Zambia,2002,2,1,3
Senegal,Tunisia,2002,0,0,0
Canada,South Korea,2002,2,1,3
United States,Costa Rica,2002,2,0,2
Mali,South Africa,2002,2,0,2
Nigeria,Ghana,2002,1,0,1
Cameroon,Egypt,2002,1,0,1
Senegal,DR Congo,2002,2,0,2
Iran,Slovakia,2002,2,3,5
Saudi Arabia,Brazil,2002,0,1,1
Mali,Cameroon,2002,0,3,3
Nigeria,Senegal,2002,1,2,3
Singapore,North Korea,2002,2,1,3
Lithuania,Moldova,2002,1,0,1
Mali,Nigeria,2002,0,1,1
Malta,Jordan,2002,2,1,3
Faroe Islands,Poland,2002,1,2,3
North Korea,Qatar,2002,1,1,2
Senegal,Cameroon,2002,0,0,0
Thailand,Singapore,2002,4,0,4
Malta,Lithuania,2002,1,1,2
Moldova,Jordan,2002,2,0,2
Cyprus,Switzerland,2002,1,1,2
Czech Republic,Hungary,2002,2,0,2
North Korea,Singapore,2002,4,2,6
Slovenia,Honduras,2002,1,5,6
Thailand,Qatar,2002,1,0,1
Turkey,Ecuador,2002,0,1,1
Belgium,Norway,2002,1,0,1
Croatia,Bulgaria,2002,0,0,0
Cyprus,Czech Republic,2002,3,4,7
Faroe Islands,Liechtenstein,2002,1,0,1
France,Romania,2002,2,1,3
Germany,Israel,2002,7,1,8
Greece,Sweden,2002,2,2,4
Republic of Ireland,Russia,2002,2,0,2
Italy,United States,2002,1,0,1
Lithuania,Jordan,2002,0,3,3
Luxembourg,Albania,2002,0,0,0
Malta,Moldova,2002,3,0,3
Mexico,Serbia,2002,1,2,3
Netherlands,England,2002,1,1,2
Northern Ireland,Poland,2002,1,4,5
Paraguay,Bolivia,2002,2,2,4
Saudi Arabia,Denmark,2002,0,1,1
Spain,Portugal,2002,1,1,2
Switzerland,Hungary,2002,2,1,3
Uruguay,South Korea,2002,2,1,3
Wales,Argentina,2002,1,1,2
Qatar,Singapore,2002,3,0,3
Thailand,North Korea,2002,0,1,1
China PR,Slovenia,2002,0,0,0
Qatar,Singapore,2002,2,0,2
Thailand,North Korea,2002,0,0,0
Gibraltar,Monaco,2002,2,2,4
Iran,Venezuela,2002,1,0,1
Botswana,Eswatini,2002,6,2,8
United States,Honduras,2002,4,0,4
Brazil,Iceland,2002,6,1,7
American Samoa,New Caledonia,2002,0,10,10
Samoa,Tonga,2002,2,0,2
Eswatini,Lesotho,2002,1,0,1
United States,Ecuador,2002,1,0,1
American Samoa,Tonga,2002,2,7,9
New Caledonia,Papua New Guinea,2002,1,4,5
Mexico,Albania,2002,4,0,4
Tunisia,South Korea,2002,0,0,0
Estonia,Saudi Arabia,2002,2,0,2
Papua New Guinea,Tonga,2002,5,0,5
Samoa,American Samoa,2002,5,0,5
Botswana,Namibia,2002,3,1,4
Mauritius,Madagascar,2002,2,3,5
New Caledonia,Tonga,2002,9,0,9
Samoa,Papua New Guinea,2002,1,4,5
Sri Lanka,Pakistan,2002,1,1,2
American Samoa,Papua New Guinea,2002,0,7,7
Samoa,New Caledonia,2002,0,5,5
Sri Lanka,Pakistan,2002,0,0,0
Finland,South Korea,2002,0,2,2
Saudi Arabia,South Africa,2002,1,0,1
Japan,Ukraine,2002,1,0,1
Sri Lanka,Pakistan,2002,1,0,1
Sri Lanka,Pakistan,2002,2,1,3
South Korea,Turkey,2002,0,0,0
Nigeria,Paraguay,2002,1,1,2
Albania,Azerbaijan,2002,1,0,1
Argentina,Cameroon,2002,2,2,4
Austria,Slovakia,2002,2,0,2
Belize,Guyana,2002,3,1,4
Bosnia and Herzegovina,North Macedonia,2002,4,4,8
Brazil,Serbia,2002,1,0,1
Bulgaria,Ecuador,2002,0,3,3
Croatia,Slovenia,2002,0,0,0
England,Italy,2002,1,2,3
Estonia,Russia,2002,2,1,3
France,Scotland,2002,5,0,5
Georgia,South Africa,2002,4,1,5
Germany,United States,2002,4,2,6
Republic of Ireland,Denmark,2002,3,0,3
Liechtenstein,Northern Ireland,2002,0,0,0
Luxembourg,Latvia,2002,0,3,3
Malta,Andorra,2002,1,1,2
Moldova,Hungary,2002,0,2,2
Netherlands,Spain,2002,1,0,1
Poland,Japan,2002,0,2,2
Portugal,Finland,2002,1,4,5
Romania,Ukraine,2002,4,1,5
Saudi Arabia,Uruguay,2002,3,2,5
Senegal,Bolivia,2002,2,1,3
Sweden,Switzerland,2002,1,1,2
Tunisia,Norway,2002,0,0,0
Wales,Czech Republic,2002,0,0,0
Botswana,South Africa,2002,0,0,0
Eswatini,Mozambique,2002,1,2,3
Eswatini,Mozambique,2002,1,1,2
Sri Lanka,Maldives,2002,1,0,1
Sri Lanka,Maldives,2002,1,1,2
Lesotho,Mozambique,2002,0,2,2
Singapore,Maldives,2002,2,0,2
Yemen,Ethiopia,2002,1,1,2
Andorra,Albania,2002,2,0,2
Austria,Cameroon,2002,0,0,0
Belgium,Slovakia,2002,1,1,2
Belize,Nicaragua,2002,7,1,8
Croatia,Bosnia and Herzegovina,2002,2,0,2
Denmark,Israel,2002,3,1,4
Ecuador,South Africa,2002,0,0,0
England,Paraguay,2002,4,0,4
France,Russia,2002,0,0,0
Germany,Argentina,2002,0,1,1
Greece,Czech Republic,2002,0,0,0
Hungary,Belarus,2002,2,5,7
Republic of Ireland,United States,2002,2,1,3
Italy,Uruguay,2002,1,1,2
Japan,Costa Rica,2002,1,1,2
Latvia,Kazakhstan,2002,2,1,3
Luxembourg,Liechtenstein,2002,3,3,6
North Macedonia,Finland,2002,1,0,1
Malta,Azerbaijan,2002,1,0,1
Mexico,Bulgaria,2002,1,0,1
Northern Ireland,Spain,2002,0,5,5
Norway,Sweden,2002,0,0,0
Poland,Romania,2002,1,2,3
Portugal,Brazil,2002,1,1,2
Scotland,Nigeria,2002,1,2,3
Serbia,Lithuania,2002,4,1,5
Slovenia,Tunisia,2002,1,0,1
Turkey,Chile,2002,2,0,2
Ukraine,Georgia,2002,2,1,3
South Korea,Costa Rica,2002,2,0,2
Eswatini,Namibia,2002,2,1,3
South Korea,China PR,2002,0,0,0
Japan,Slovakia,2002,1,0,1
Japan,Honduras,2002,3,3,6
Malawi,Tanzania,2002,1,0,1
Nigeria,Kenya,2002,3,0,3
Zimbabwe,Eswatini,2002,0,2,2
Jersey,Guernsey,2002,2,1,3
Venezuela,Colombia,2002,0,0,0
Ecuador,Serbia,2002,1,0,1
Hungary,Croatia,2002,0,2,2
Costa Rica,Colombia,2002,1,2,3
Germany,Kuwait,2002,7,0,7
Kenya,Tanzania,2002,1,0,1
Mexico,Colombia,2002,2,1,3
South Africa,Madagascar,2002,1,0,1
United States,Uruguay,2002,2,1,3
Belgium,Algeria,2002,0,0,0
Norway,Japan,2002,3,0,3
Saudi Arabia,Senegal,2002,3,2,5
Slovakia,Uzbekistan,2002,4,1,5
Wales,Germany,2002,1,0,1
Greece,Cyprus,2002,3,1,4
Switzerland,Canada,2002,1,3,4
China PR,Uruguay,2002,0,2,2
Republic of Ireland,Nigeria,2002,1,2,3
South Korea,Scotland,2002,4,1,5
Mexico,Bolivia,2002,1,0,1
United States,Jamaica,2002,5,0,5
Myanmar,Malaysia,2002,1,1,2
Denmark,Cameroon,2002,2,1,3
Russia,Belarus,2002,1,1,2
Slovenia,Ghana,2002,2,0,2
Sweden,Paraguay,2002,1,2,3
Ukraine,Serbia,2002,2,0,2
Canary Islands,Venezuela,2002,0,2,2
Czech Republic,Italy,2002,1,0,1
France,Belgium,2002,1,2,3
Germany,Austria,2002,6,2,8
Jamaica,Nigeria,2002,0,1,1
Malawi,Angola,2002,2,1,3
Poland,Estonia,2002,1,0,1
Tanzania,Kenya,2002,0,5,5
Catalonia,Brazil,2002,1,3,4
Belarus,Ukraine,2002,2,0,2
Myanmar,Malaysia,2002,0,0,0
Russia,Serbia,2002,1,1,2
United States,Netherlands,2002,0,2,2
Scotland,South Africa,2002,0,2,2
South Korea,England,2002,1,1,2
San Marino,Estonia,2002,0,1,1
Singapore,Uruguay,2002,1,2,3
Finland,Latvia,2002,2,1,3
Norway,Iceland,2002,1,1,2
Ecuador,Senegal,2002,0,1,1
South Africa,Turkey,2002,2,0,2
China PR,Portugal,2002,0,2,2
Japan,Sweden,2002,1,1,2
Malaysia,Brazil,2002,0,4,4
Belgium,Costa Rica,2002,1,0,1
Cameroon,England,2002,2,2,4
Denmark,Tunisia,2002,2,1,3
South Korea,France,2002,2,3,5
Kuwait,Iran,2002,1,3,4
France,Senegal,2002,0,1,1
Germany,Saudi Arabia,2002,8,0,8
Republic of Ireland,Cameroon,2002,1,1,2
Uruguay,Denmark,2002,1,2,3
Argentina,Nigeria,2002,1,0,1
England,Sweden,2002,1,1,2
Paraguay,South Africa,2002,2,2,4
Spain,Slovenia,2002,3,1,4
Brazil,Turkey,2002,2,1,3
Croatia,Mexico,2002,0,1,1
Italy,Ecuador,2002,2,0,2
China PR,Costa Rica,2002,0,2,2
Japan,Belgium,2002,2,2,4
South Korea,Poland,2002,2,0,2
Germany,Republic of Ireland,2002,1,1,2
Russia,Tunisia,2002,2,0,2
United States,Portugal,2002,3,2,5
Cameroon,Saudi Arabia,2002,1,0,1
Denmark,Senegal,2002,1,1,2
France,Uruguay,2002,0,0,0
Saint Martin,Anguilla,2002,2,1,3
Andorra,Armenia,2002,0,2,2
Argentina,England,2002,0,1,1
Spain,Paraguay,2002,3,1,4
Sweden,Nigeria,2002,2,1,3
Brazil,China PR,2002,4,0,4
Italy,Croatia,2002,1,2,3
Malawi,Botswana,2002,2,0,2
South Africa,Slovenia,2002,1,0,1
Costa Rica,Turkey,2002,1,1,2
Japan,Russia,2002,1,0,1
Malawi,Botswana,2002,1,0,1
Mexico,Ecuador,2002,2,1,3
South Korea,United States,2002,1,1,2
Portugal,Poland,2002,4,0,4
Tunisia,Belgium,2002,1,1,2
Cameroon,Germany,2002,0,2,2
Denmark,France,2002,2,0,2
Saudi Arabia,Republic of Ireland,2002,0,3,3
Senegal,Uruguay,2002,3,3,6
Nigeria,England,2002,0,0,0
Slovenia,Paraguay,2002,1,3,4
South Africa,Spain,2002,2,3,5
Sweden,Argentina,2002,1,1,2
Costa Rica,Brazil,2002,2,5,7
Ecuador,Croatia,2002,1,0,1
Mexico,Italy,2002,1,1,2
Turkey,China PR,2002,3,0,3
Belgium,Russia,2002,3,2,5
Japan,Tunisia,2002,2,0,2
South Korea,Portugal,2002,1,0,1
Poland,United States,2002,3,1,4
Denmark,England,2002,0,3,3
Germany,Paraguay,2002,1,0,1
Spain,Republic of Ireland,2002,1,1,2
Sweden,Senegal,2002,1,2,3
Brazil,Belgium,2002,2,0,2
Mexico,United States,2002,0,2,2
Japan,Turkey,2002,0,1,1
South Korea,Italy,2002,2,1,3
England,Brazil,2002,1,2,3
Germany,United States,2002,1,0,1
Grenada,British Virgin Islands,2002,5,0,5
South Korea,Spain,2002,0,0,0
Senegal,Turkey,2002,0,1,1
Saint Martin,Anguilla,2002,1,0,1
South Korea,Germany,2002,0,1,1
Mozambique,Angola,2002,1,1,2
Brazil,Turkey,2002,1,0,1
South Korea,Turkey,2002,2,3,5
Bhutan,Montserrat,2002,4,0,4
Germany,Brazil,2002,0,2,2
Estonia,Azerbaijan,2002,0,0,0
New Zealand,Tahiti,2002,4,0,4
Papua New Guinea,Solomon Islands,2002,0,0,0
Australia,Vanuatu,2002,2,0,2
British Virgin Islands,Anguilla,2002,2,1,3
Fiji,New Caledonia,2002,2,1,3
Grenada,Saint Martin,2002,8,3,11
Latvia,Azerbaijan,2002,0,0,0
Zambia,Mozambique,2002,3,0,3
Guadeloupe,Puerto Rico,2002,4,0,4
Kazakhstan,Estonia,2002,1,1,2
Malawi,Zimbabwe,2002,3,2,5
New Zealand,Papua New Guinea,2002,9,1,10
Solomon Islands,Tahiti,2002,2,3,5
Australia,New Caledonia,2002,11,0,11
Fiji,Vanuatu,2002,0,1,1
Malawi,Zimbabwe,2002,2,2,4
New Zealand,Solomon Islands,2002,6,1,7
Papua New Guinea,Tahiti,2002,1,3,4
Australia,Fiji,2002,8,0,8
New Caledonia,Vanuatu,2002,0,1,1
Australia,Tahiti,2002,2,1,3
New Zealand,Vanuatu,2002,3,0,3
British Virgin Islands,Saint Lucia,2002,1,3,4
New Zealand,Australia,2002,1,0,1
Tahiti,Vanuatu,2002,1,0,1
Malaysia,Singapore,2002,1,2,3
Iraq,Syria,2002,2,0,2
Puerto Rico,Guadeloupe,2002,0,2,2
South Africa,Madagascar,2002,0,0,0
Iraq,Syria,2002,2,1,3
Barbados,Trinidad and Tobago,2002,0,0,0
Saint Kitts and Nevis,Taiwan,2002,3,0,3
Ethiopia,Uganda,2002,0,0,0
Sudan,Chad,2002,2,0,2
Saint Kitts and Nevis,Barbados,2002,3,0,3
Aruba,Suriname,2002,0,2,2
Chad,Ethiopia,2002,3,2,5
Guyana,Curaçao,2002,2,1,3
Saint Kitts and Nevis,Trinidad and Tobago,2002,2,1,3
Saint Lucia,British Virgin Islands,2002,8,1,9
Sudan,Uganda,2002,2,1,3
Chad,Uganda,2002,0,2,2
Grenada,Taiwan,2002,5,2,7
Sudan,Ethiopia,2002,3,0,3
Eswatini,Mauritius,2002,0,1,1
Grenada,Jamaica,2002,0,1,1
Kenya,Uganda,2002,0,0,0
Eswatini,Mauritius,2002,0,0,0
Saint Martin,Grenada,2002,1,7,8
Egypt,Ethiopia,2002,4,1,5
Malawi,Zambia,2002,1,0,1
Curaçao,Guyana,2002,1,0,1
Saint Lucia,Jamaica,2002,1,3,4
Suriname,Aruba,2002,6,0,6
Dominican Republic,United States Virgin Islands,2002,6,1,7
Jordan,Kenya,2002,1,1,2
Dominican Republic,United States Virgin Islands,2002,5,1,6
Jordan,Sudan,2002,0,0,0
Algeria,DR Congo,2002,1,1,2
Egypt,Uganda,2002,2,0,2
Azerbaijan,Uzbekistan,2002,2,0,2
Bosnia and Herzegovina,Serbia,2002,0,2,2
Brazil,Paraguay,2002,0,1,1
Bulgaria,Germany,2002,2,2,4
Croatia,Wales,2002,1,1,2
Czech Republic,Slovakia,2002,4,1,5
Estonia,Moldova,2002,1,0,1
Faroe Islands,Liechtenstein,2002,3,1,4
Finland,Republic of Ireland,2002,0,3,3
Hungary,Spain,2002,1,1,2
Iceland,Andorra,2002,3,0,3
Italy,Slovenia,2002,0,1,1
Latvia,Belarus,2002,2,4,6
Lithuania,Israel,2002,2,4,6
Luxembourg,Morocco,2002,0,2,2
North Macedonia,Malta,2002,5,0,5
Mauritius,Réunion,2002,1,1,2
Northern Ireland,Cyprus,2002,0,0,0
Norway,Netherlands,2002,0,1,1
Poland,Belgium,2002,1,1,2
Romania,Greece,2002,0,1,1
Russia,Sweden,2002,1,1,2
Scotland,Denmark,2002,0,1,1
Switzerland,Austria,2002,3,2,5
Tunisia,France,2002,1,1,2
Turkey,Georgia,2002,3,0,3
Ukraine,Iran,2002,0,1,1
Venezuela,Bolivia,2002,2,0,2
Egypt,Sudan,2002,3,0,3
Rwanda,Kenya,2002,0,0,0
South Africa,Eswatini,2002,4,1,5
Angola,Gabon,2002,1,0,1
Gambia,Sierra Leone,2002,1,0,1
Botswana,Lesotho,2002,0,1,1
Congo,DR Congo,2002,1,3,4
Egypt,Libya,2002,0,1,1
India,Jamaica,2002,0,3,3
Jordan,Iran,2002,1,0,1
Syria,Palestine,2002,2,1,3
Zimbabwe,Lesotho,2002,2,0,2
Uganda,Zambia,2002,2,2,4
Congo,Gabon,2002,0,0,0
Gambia,Guinea,2002,1,0,1
India,Jamaica,2002,0,0,0
Lebanon,Jordan,2002,0,1,1
Palestine,Iraq,2002,0,2,2
Libya,Togo,2002,4,0,4
Tanzania,Zanzibar,2002,1,1,2
Iran,Lebanon,2002,2,0,2
Syria,Iraq,2002,0,1,1
Iraq,Iran,2002,0,0,0
Luxembourg,Israel,2002,0,5,5
Syria,Jordan,2002,1,2,3
Czech Republic,Serbia,2002,5,0,5
Mauritania,Cape Verde,2002,0,2,2
Armenia,Ukraine,2002,2,2,4
Austria,Moldova,2002,2,0,2
Azerbaijan,Italy,2002,0,2,2
Belgium,Bulgaria,2002,0,2,2
Bosnia and Herzegovina,Romania,2002,0,3,3
Botswana,Eswatini,2002,0,0,0
Croatia,Estonia,2002,0,0,0
Cyprus,France,2002,1,2,3
England,Portugal,2002,1,1,2
Faroe Islands,Scotland,2002,2,2,4
Finland,Wales,2002,0,2,2
Gabon,Morocco,2002,0,1,1
Greece,Spain,2002,0,2,2
Iceland,Hungary,2002,0,2,2
Jordan,Iraq,2002,2,3,5
Kenya,Togo,2002,3,0,3
South Korea,North Korea,2002,0,0,0
Latvia,Sweden,2002,0,0,0
Lithuania,Germany,2002,0,2,2
Namibia,Algeria,2002,0,1,1
Netherlands,Belarus,2002,3,0,3
Niger,Ethiopia,2002,3,1,4
Norway,Denmark,2002,2,2,4
Russia,Republic of Ireland,2002,4,2,6
San Marino,Poland,2002,0,2,2
Slovenia,Malta,2002,3,0,3
Syria,Iran,2002,2,2,4
Turkey,Slovakia,2002,3,0,3
Uganda,Ghana,2002,1,0,1
Angola,Nigeria,2002,0,0,0
Benin,Tanzania,2002,4,0,4
Congo,Burkina Faso,2002,0,0,0
Equatorial Guinea,Sierra Leone,2002,1,3,4
Guinea,Liberia,2002,3,0,3
Ivory Coast,South Africa,2002,0,0,0
Lesotho,Senegal,2002,0,1,1
Libya,DR Congo,2002,3,2,5
Liechtenstein,North Macedonia,2002,1,1,2
Seychelles,Eritrea,2002,1,0,1
Sudan,Zambia,2002,0,1,1
Switzerland,Georgia,2002,4,1,5
Zimbabwe,Mali,2002,1,0,1
Central African Republic,Mozambique,2002,1,1,2
Iran,Morocco,2002,1,1,2
Ivory Coast,Gambia,2002,5,0,5
Iran,Paraguay,2002,1,1,2
Malawi,South Africa,2002,1,3,4
Algeria,Uganda,2002,1,1,2
Oman,United Arab Emirates,2002,2,1,3
Mauritius,Seychelles,2002,1,0,1
South Africa,Malawi,2002,1,0,1
Zimbabwe,Zambia,2002,0,0,0
Mali,Mauritania,2002,2,1,3
Morocco,Niger,2002,6,1,7
Mali,Mauritania,2002,2,0,2
Barbados,Saint Lucia,2002,3,2,5
Eswatini,Lesotho,2002,0,0,0
Ghana,Lesotho,2002,2,1,3
Martinique,Saint Lucia,2002,4,0,4
Algeria,Chad,2002,4,1,5
Bosnia and Herzegovina,Germany,2002,1,1,2
Albania,Switzerland,2002,1,1,2
Andorra,Belgium,2002,0,1,1
Belarus,Austria,2002,0,2,2
Bulgaria,Croatia,2002,2,0,2
Denmark,Luxembourg,2002,2,0,2
Eritrea,Zimbabwe,2002,0,1,1
Finland,Azerbaijan,2002,3,0,3
France,Slovenia,2002,5,0,5
Iceland,Scotland,2002,0,2,2
Italy,Serbia,2002,1,1,2
Lithuania,Faroe Islands,2002,2,0,2
North Macedonia,Turkey,2002,1,2,3
Malawi,Angola,2002,1,0,1
Malta,Israel,2002,0,2,2
Mauritius,Madagascar,2002,0,1,1
Moldova,Czech Republic,2002,0,2,2
Poland,Latvia,2002,0,1,1
Portugal,Tunisia,2002,1,1,2
Romania,Norway,2002,0,1,1
Senegal,Nigeria,2002,2,2,4
Sierra Leone,Gabon,2002,2,0,2
Slovakia,England,2002,1,2,3
Spain,Northern Ireland,2002,3,0,3
Sweden,Hungary,2002,1,1,2
Tanzania,Sudan,2002,1,2,3
Ukraine,Greece,2002,2,0,2
Zambia,Benin,2002,1,1,2
DR Congo,Botswana,2002,2,0,2
Estonia,New Zealand,2002,3,2,5
Ethiopia,Guinea,2002,1,0,1
Ghana,Rwanda,2002,4,2,6
Mali,Seychelles,2002,3,0,3
Morocco,Equatorial Guinea,2002,5,0,5
Mozambique,Congo,2002,0,3,3
Eswatini,Libya,2002,2,1,3
Scotland,Canada,2002,3,1,4
Austria,Netherlands,2002,0,3,3
Bulgaria,Andorra,2002,2,1,3
Costa Rica,Ecuador,2002,1,1,2
Czech Republic,Belarus,2002,2,0,2
England,North Macedonia,2002,2,2,4
Estonia,Belgium,2002,0,1,1
Germany,Faroe Islands,2002,2,1,3
Greece,Armenia,2002,2,0,2
Hungary,San Marino,2002,3,0,3
Iceland,Lithuania,2002,3,0,3
Republic of Ireland,Switzerland,2002,1,2,3
Japan,Jamaica,2002,1,1,2
Luxembourg,Romania,2002,0,7,7
Malta,France,2002,0,4,4
Northern Ireland,Ukraine,2002,0,0,0
Norway,Bosnia and Herzegovina,2002,2,0,2
Poland,New Zealand,2002,2,0,2
Russia,Albania,2002,4,1,5
Serbia,Finland,2002,2,0,2
Spain,Paraguay,2002,0,0,0
Sweden,Portugal,2002,2,3,5
Turkey,Liechtenstein,2002,5,0,5
Wales,Italy,2002,2,1,3
French Guiana,Suriname,2002,1,1,2
French Guiana,Suriname,2002,0,1,1
Sierra Leone,Ghana,2002,2,1,3
Venezuela,Ecuador,2002,2,0,2
Kenya,South Africa,2002,1,1,2
Tanzania,Uganda,2002,0,2,2
Kenya,Uganda,2002,1,1,2
Tanzania,South Africa,2002,1,1,2
Jersey,Kernow,2002,0,3,3
Martinique,Saint Kitts and Nevis,2002,2,1,3
Saint Lucia,Martinique,2002,0,2,2
Saint Lucia,Antigua and Barbuda,2002,2,1,3
Barbados,Jamaica,2002,1,1,2
Grenada,Guadeloupe,2002,4,5,9
Singapore,Indonesia,2002,1,1,2
Grenada,Barbados,2002,0,2,2
Jamaica,Guadeloupe,2002,2,0,2
Barbados,Guadeloupe,2002,0,1,1
Grenada,Jamaica,2002,1,4,5
Saint Kitts and Nevis,Saint Lucia,2002,2,1,3
Trinidad and Tobago,Saint Kitts and Nevis,2002,2,0,2
Cayman Islands,Nicaragua,2002,0,1,1
Trinidad and Tobago,Saint Lucia,2002,0,1,1
United States,El Salvador,2002,2,0,2
Haiti,Antigua and Barbuda,2002,1,0,1
South Africa,Senegal,2002,1,1,2
Antigua and Barbuda,Curaçao,2002,1,1,2
Austria,Norway,2002,0,1,1
Azerbaijan,Wales,2002,0,2,2
Cyprus,Malta,2002,2,1,3
Czech Republic,Sweden,2002,3,3,6
Denmark,Poland,2002,2,0,2
Ecuador,Costa Rica,2002,2,2,4
Estonia,Iceland,2002,2,0,2
France,Serbia,2002,3,0,3
Germany,Netherlands,2002,1,3,4
Greece,Republic of Ireland,2002,0,0,0
Honduras,Colombia,2002,1,0,1
Hungary,Moldova,2002,1,1,2
Italy,Turkey,2002,1,1,2
Japan,Argentina,2002,0,2,2
South Korea,Brazil,2002,2,3,5
Luxembourg,Cape Verde,2002,0,0,0
North Macedonia,Israel,2002,2,3,5
Morocco,Mali,2002,1,3,4
Nigeria,Jamaica,2002,0,0,0
Portugal,Scotland,2002,2,0,2
Qatar,Iraq,2002,2,1,3
Romania,Croatia,2002,0,1,1
San Marino,Latvia,2002,0,1,1
Slovakia,Ukraine,2002,1,1,2
Spain,Bulgaria,2002,1,0,1
Tunisia,Egypt,2002,0,0,0
Venezuela,Uruguay,2002,1,0,1
Haiti,Curaçao,2002,3,0,3
Bahrain,Iraq,2002,2,2,4
Monaco,Vatican City,2002,0,0,0
Nigeria,Egypt,2002,1,1,2
Cayman Islands,Cuba,2002,0,5,5
Martinique,Dominican Republic,2002,4,0,4
Sri Lanka,Vietnam,2002,1,2,3
Cayman Islands,Dominican Republic,2002,1,0,1
Jordan,Malaysia,2002,1,0,1
Martinique,Cuba,2002,1,2,3
Sri Lanka,Vietnam,2002,1,1,2
Jordan,Singapore,2002,3,1,4
Rwanda,Zanzibar,2002,1,0,1
Tanzania,Kenya,2002,1,0,1
Burundi,Eritrea,2002,1,1,2
Cayman Islands,Martinique,2002,0,3,3
Dominican Republic,Cuba,2002,1,2,3
Somalia,Uganda,2002,0,2,2
Sri Lanka,Vietnam,2002,2,2,4
Ethiopia,Zanzibar,2002,0,0,0
Tanzania,Sudan,2002,1,1,2
Kenya,Burundi,2002,1,1,2
Somalia,Rwanda,2002,0,1,1
Eritrea,Sudan,2002,2,1,3
Uganda,Ethiopia,2002,3,0,3
Tanzania,Burundi,2002,2,0,2
Zanzibar,Somalia,2002,1,0,1
Kenya,Eritrea,2002,4,1,5
Uganda,Rwanda,2002,2,1,3
Bahrain,Jordan,2002,0,3,3
China PR,Syria,2002,3,1,4
Ethiopia,Somalia,2002,0,1,1
Sudan,Burundi,2002,2,1,3
Tanzania,Eritrea,2002,1,1,2
Thailand,Vietnam,2002,2,1,3
Zanzibar,Uganda,2002,0,2,2
Bahrain,Syria,2002,2,3,5
China PR,Jordan,2002,0,0,0
Rwanda,Ethiopia,2002,1,0,1
Sudan,Kenya,2002,0,1,1
Chile,Palestine,2002,3,1,4
Malaysia,Cambodia,2002,5,0,5
Singapore,Philippines,2002,2,0,2
Tanzania,Rwanda,2002,3,0,3
Bahrain,China PR,2002,2,2,4
Jordan,Syria,2002,3,0,3
Uganda,Kenya,2002,1,3,4
Saudi Arabia,Lebanon,2002,1,1,2
Botswana,Zambia,2002,1,0,1
Rwanda,Uganda,2002,2,1,3
Tanzania,Kenya,2002,2,3,5
Ghana,Nigeria,2002,0,1,1
Indonesia,Myanmar,2002,0,0,0
Vietnam,Cambodia,2002,9,2,11
Palestine,Jordan,2002,1,1,2
United Arab Emirates,Egypt,2002,1,2,3
Indonesia,Cambodia,2002,4,2,6
Philippines,Myanmar,2002,1,6,7
Saudi Arabia,Bahrain,2002,2,1,3
Yemen,Syria,2002,0,4,4
Kuwait,Sudan,2002,1,0,1
Singapore,Malaysia,2002,0,4,4
Thailand,Laos,2002,5,1,6
Bahrain,Syria,2002,2,0,2
Myanmar,Cambodia,2002,5,0,5
Saudi Arabia,Lebanon,2002,1,0,1
Vietnam,Philippines,2002,4,1,5
Jordan,Sudan,2002,2,1,3
Singapore,Laos,2002,2,1,3
Thailand,Malaysia,2002,1,3,4
Bahrain,Yemen,2002,3,1,4
Cambodia,Philippines,2002,1,0,1
Indonesia,Vietnam,2002,2,2,4
Syria,Lebanon,2002,4,1,5
Egypt,Ghana,2002,0,0,0
Malaysia,Laos,2002,1,1,2
Singapore,Thailand,2002,1,1,2
Myanmar,Vietnam,2002,2,4,6
Indonesia,Philippines,2002,13,1,14
Kuwait,Jordan,2002,1,2,3
Sudan,Palestine,2002,2,2,4
Lebanon,Yemen,2002,4,2,6
Syria,Saudi Arabia,2002,0,3,3
Kuwait,Palestine,2002,3,3,6
Lebanon,Bahrain,2002,0,0,0
Yemen,Saudi Arabia,2002,2,2,4
Indonesia,Malaysia,2002,1,0,1
Niger,Burkina Faso,2002,1,1,2
Vietnam,Thailand,2002,0,4,4
Andalusia,Chile,2002,3,2,5
Jordan,Bahrain,2002,1,2,3
Basque Country,North Macedonia,2002,1,1,2
Catalonia,China PR,2002,2,0,2
Indonesia,Thailand,2002,2,2,4
Niger,Mali,2002,2,2,4
Vietnam,Malaysia,2002,2,1,3
Saudi Arabia,Bahrain,2002,1,0,1
India,Pakistan,2003,0,1,1
Sri Lanka,Afghanistan,2003,1,0,1
Bangladesh,Nepal,2003,1,0,1
Maldives,Bhutan,2003,6,0,6
Afghanistan,India,2003,0,4,4
Barbados,Jamaica,2003,1,0,1
Pakistan,Sri Lanka,2003,2,1,3
Bangladesh,Maldives,2003,1,0,1
Nepal,Bhutan,2003,2,0,2
Afghanistan,Pakistan,2003,0,1,1
India,Sri Lanka,2003,1,1,2
Bangladesh,Bhutan,2003,3,0,3
Nepal,Maldives,2003,2,3,5
El Salvador,Guatemala,2003,0,0,0
Bangladesh,India,2003,2,1,3
Pakistan,Maldives,2003,0,1,1
United States,Canada,2003,4,0,4
El Salvador,Guatemala,2003,0,0,0
Bangladesh,Maldives,2003,1,1,2
Pakistan,India,2003,1,2,3
Uganda,Algeria,2003,0,1,1
Barbados,Finland,2003,0,0,0
Ghana,Benin,2003,3,0,3
United Arab Emirates,Norway,2003,1,1,2
Oman,Norway,2003,1,2,3
Cyprus,Greece,2003,1,2,3
Trinidad and Tobago,Finland,2003,1,2,3
Honduras,Argentina,2003,1,3,4
Mexico,Argentina,2003,0,1,1
Uruguay,Iran,2003,1,1,2
United States,Argentina,2003,0,1,1
Croatia,North Macedonia,2003,2,2,4
Ecuador,Estonia,2003,1,0,1
Panama,El Salvador,2003,1,2,3
Cameroon,Ivory Coast,2003,0,3,3
Costa Rica,El Salvador,2003,1,0,1
Honduras,Nicaragua,2003,2,0,2
Albania,Vietnam,2003,5,0,5
Algeria,Belgium,2003,1,3,4
Barbados,Martinique,2003,3,3,6
Bulgaria,Hungary,2003,1,0,1
China PR,Brazil,2003,0,0,0
Croatia,Poland,2003,0,0,0
Cyprus,Russia,2003,0,1,1
Ecuador,Estonia,2003,2,1,3
Egypt,Denmark,2003,1,4,5
England,Australia,2003,1,3,4
France,Czech Republic,2003,0,2,2
Georgia,Moldova,2003,2,2,4
Greece,Norway,2003,1,0,1
Guinea,Mali,2003,0,1,1
Israel,Armenia,2003,2,0,2
Italy,Portugal,2003,1,0,1
Jamaica,United States,2003,1,2,3
Latvia,Lithuania,2003,2,1,3
Libya,Canada,2003,2,4,6
Malta,Kazakhstan,2003,2,2,4
Mexico,Colombia,2003,0,0,0
Morocco,Senegal,2003,1,0,1
Netherlands,Argentina,2003,1,0,1
Northern Ireland,Finland,2003,0,1,1
Romania,Slovakia,2003,2,1,3
Scotland,Republic of Ireland,2003,0,2,2
Serbia,Azerbaijan,2003,2,2,4
Slovenia,Switzerland,2003,1,5,6
Spain,Germany,2003,3,1,4
Tunisia,Sweden,2003,1,0,1
Turkey,Ukraine,2003,0,0,0
Wales,Bosnia and Herzegovina,2003,2,2,4
Costa Rica,Guatemala,2003,1,1,2
Cyprus,Slovakia,2003,1,3,4
El Salvador,Nicaragua,2003,3,0,3
North Macedonia,Poland,2003,0,3,3
Benin,Ghana,2003,1,0,1
Costa Rica,Nicaragua,2003,1,0,1
Honduras,El Salvador,2003,0,1,1
China PR,Estonia,2003,1,0,1
Gambia,Nigeria,2003,0,1,1
Panama,Guatemala,2003,2,0,2
Qatar,Sweden,2003,2,3,5
Thailand,North Korea,2003,2,2,4
Guatemala,Nicaragua,2003,5,0,5
North Korea,Sweden,2003,1,1,2
Panama,Honduras,2003,1,1,2
Thailand,Qatar,2003,1,1,2
Costa Rica,Honduras,2003,1,0,1
El Salvador,Guatemala,2003,0,2,2
North Korea,Qatar,2003,2,2,4
Thailand,Sweden,2003,1,4,5
Panama,Nicaragua,2003,0,1,1
Hong Kong,Taiwan,2003,2,0,2
North Korea,Sweden,2003,0,4,4
Macau,Mongolia,2003,2,0,2
Madagascar,Mauritius,2003,2,1,3
Malawi,DR Congo,2003,1,1,2
Thailand,Qatar,2003,3,1,4
Guatemala,Honduras,2003,2,1,3
Malawi,DR Congo,2003,2,3,5
Panama,Costa Rica,2003,0,1,1
Peru,Haiti,2003,5,1,6
Hong Kong,Macau,2003,3,0,3
Mongolia,Guam,2003,2,0,2
Guam,Macau,2003,0,2,2
Guam,Taiwan,2003,0,7,7
Hong Kong,Mongolia,2003,10,0,10
Hong Kong,Guam,2003,11,0,11
Macau,Taiwan,2003,1,2,3
Singapore,Maldives,2003,4,1,5
Sudan,DR Congo,2003,1,3,4
Israel,Moldova,2003,0,0,0
Benin,Niger,2003,1,1,2
Botswana,Lesotho,2003,0,1,1
DR Congo,Congo,2003,3,0,3
Cuba,Jamaica,2003,0,0,0
Tanzania,Uganda,2003,0,0,0
Cuba,Jamaica,2003,1,0,1
Martinique,French Guiana,2003,2,1,3
Namibia,Botswana,2003,0,1,1
Guadeloupe,French Guiana,2003,2,2,4
Kenya,Uganda,2003,2,2,4
Rwanda,Burundi,2003,4,2,6
Kyrgyzstan,Afghanistan,2003,1,2,3
Lesotho,DR Congo,2003,2,2,4
Zimbabwe,Malawi,2003,0,0,0
Nepal,Afghanistan,2003,4,0,4
Egypt,Qatar,2003,6,0,6
Mexico,Bolivia,2003,2,0,2
Eswatini,Lesotho,2003,1,0,1
Nepal,Kyrgyzstan,2003,0,2,2
Macau,Pakistan,2003,0,3,3
Maldives,Brunei,2003,1,1,2
Sri Lanka,Timor-Leste,2003,3,2,5
Mozambique,Lesotho,2003,0,0,0
Rwanda,Zambia,2003,1,1,2
Benin,Equatorial Guinea,2003,2,1,3
Myanmar,Brunei,2003,5,0,5
Jamaica,Barbados,2003,2,1,3
Kenya,Tanzania,2003,4,0,4
Singapore,Macau,2003,2,0,2
North Korea,India,2003,2,0,2
Rwanda,Zambia,2003,0,3,3
Hong Kong,Laos,2003,5,1,6
Maldives,Myanmar,2003,0,2,2
Singapore,Pakistan,2003,3,0,3
Sri Lanka,Taiwan,2003,2,1,3
Austria,Greece,2003,2,2,4
Burundi,Burkina Faso,2003,0,0,0
Guadeloupe,Cuba,2003,2,3,5
Haiti,Martinique,2003,2,1,3
Jamaica,Saint Lucia,2003,5,0,5
Mexico,Paraguay,2003,1,1,2
Trinidad and Tobago,Antigua and Barbuda,2003,2,0,2
Cameroon,Madagascar,2003,2,0,2
Laos,Bangladesh,2003,2,1,3
Serbia,Bulgaria,2003,1,2,3
Tunisia,Ghana,2003,2,2,4
Cuba,Antigua and Barbuda,2003,2,0,2
Jamaica,Martinique,2003,2,2,4
Japan,Uruguay,2003,2,2,4
Saint Lucia,Haiti,2003,2,1,3
Trinidad and Tobago,Guadeloupe,2003,1,0,1
Albania,Russia,2003,3,1,4
Angola,Algeria,2003,1,1,2
Armenia,Northern Ireland,2003,1,0,1
Belarus,Moldova,2003,2,1,3
Bosnia and Herzegovina,Luxembourg,2003,2,0,2
Cape Verde,Togo,2003,2,1,3
Costa Rica,Paraguay,2003,2,1,3
Croatia,Belgium,2003,4,0,4
Cyprus,Israel,2003,1,1,2
Estonia,Canada,2003,2,1,3
France,Malta,2003,6,0,6
Gabon,Equatorial Guinea,2003,4,0,4
Georgia,Republic of Ireland,2003,1,2,3
Germany,Lithuania,2003,1,1,2
Italy,Finland,2003,2,0,2
Kenya,Mauritania,2003,4,0,4
South Korea,Colombia,2003,0,0,0
Liechtenstein,England,2003,0,2,2
North Macedonia,Slovakia,2003,0,2,2
Malawi,Nigeria,2003,0,1,1
Mauritius,Egypt,2003,0,1,1
Netherlands,Czech Republic,2003,1,1,2
Poland,Hungary,2003,0,0,0
Portugal,Brazil,2003,2,1,3
Romania,Denmark,2003,2,5,7
Rwanda,Uganda,2003,0,0,0
Scotland,Iceland,2003,2,1,3
Sierra Leone,Morocco,2003,0,0,0
South Africa,Madagascar,2003,2,0,2
Sudan,Benin,2003,3,0,3
Tanzania,Zambia,2003,0,1,1
Ukraine,Spain,2003,2,2,4
United States,Venezuela,2003,2,0,2
Wales,Azerbaijan,2003,4,0,4
Burundi,Ivory Coast,2003,0,1,1
Chad,Namibia,2003,2,0,2
Chile,Peru,2003,2,0,2
Eritrea,Mali,2003,0,2,2
Ethiopia,Liberia,2003,1,0,1
Gambia,Senegal,2003,0,0,0
Ghana,Madagascar,2003,3,3,6
Guadeloupe,Antigua and Barbuda,2003,2,0,2
Guinea,Niger,2003,2,0,2
Hong Kong,Bangladesh,2003,2,2,4
India,North Korea,2003,1,1,2
Jamaica,Haiti,2003,3,0,3
Libya,Botswana,2003,0,0,0
Mozambique,Burkina Faso,2003,1,0,1
Saint Lucia,Martinique,2003,4,5,9
Eswatini,DR Congo,2003,1,1,2
Trinidad and Tobago,Cuba,2003,1,3,4
Tunisia,Cameroon,2003,1,0,1
Zimbabwe,Seychelles,2003,3,1,4
Albania,Republic of Ireland,2003,0,0,0
Belarus,Uzbekistan,2003,2,2,4
Croatia,Andorra,2003,2,0,2
Czech Republic,Austria,2003,4,0,4
Denmark,Bosnia and Herzegovina,2003,0,2,2
England,Turkey,2003,2,0,2
Estonia,Bulgaria,2003,0,0,0
Georgia,Switzerland,2003,0,0,0
Honduras,Paraguay,2003,1,1,2
Hungary,Sweden,2003,1,2,3
Israel,France,2003,1,2,3
Lithuania,Scotland,2003,1,0,1
Luxembourg,Norway,2003,0,2,2
North Macedonia,Portugal,2003,0,1,1
Moldova,Netherlands,2003,1,2,3
Northern Ireland,Greece,2003,0,2,2
Peru,Chile,2003,3,0,3
Poland,San Marino,2003,5,0,5
Slovakia,Liechtenstein,2003,4,0,4
Slovenia,Cyprus,2003,4,1,5
Spain,Armenia,2003,3,0,3
Ukraine,Latvia,2003,1,0,1
Venezuela,Jamaica,2003,2,0,2
South Korea,Japan,2003,0,1,1
Zimbabwe,Angola,2003,1,0,1
Bhutan,Guam,2003,6,0,6
Martinique,Trinidad and Tobago,2003,3,2,5
Algeria,Madagascar,2003,3,1,4
Guam,Mongolia,2003,0,5,5
Trinidad and Tobago,Honduras,2003,0,2,2
Bhutan,Mongolia,2003,0,0,0
Faroe Islands,Kazakhstan,2003,3,2,5
Madagascar,Mali,2003,0,2,2
Martinique,Honduras,2003,2,4,6
Faroe Islands,Kazakhstan,2003,2,1,3
Andorra,Estonia,2003,0,2,2
Belgium,Poland,2003,3,1,4
Bulgaria,Albania,2003,2,0,2
Chile,Costa Rica,2003,1,0,1
Czech Republic,Turkey,2003,4,0,4
Denmark,Ukraine,2003,1,0,1
Finland,Iceland,2003,3,0,3
France,Egypt,2003,5,0,5
Georgia,Russia,2003,1,0,1
Germany,Serbia,2003,1,0,1
Honduras,Colombia,2003,0,0,0
Hungary,Luxembourg,2003,5,1,6
Republic of Ireland,Norway,2003,1,0,1
Israel,Cyprus,2003,2,0,2
Latvia,San Marino,2003,3,0,3
Libya,Argentina,2003,1,3,4
Liechtenstein,Saudi Arabia,2003,1,0,1
Lithuania,Romania,2003,0,1,1
Malta,Slovenia,2003,1,3,4
Mexico,Brazil,2003,0,0,0
Morocco,Ivory Coast,2003,0,1,1
Netherlands,Portugal,2003,1,1,2
Peru,Paraguay,2003,0,1,1
Scotland,Austria,2003,0,2,2
Slovakia,Greece,2003,2,2,4
South Africa,Jamaica,2003,0,0,0
Spain,Ecuador,2003,4,0,4
Sweden,Croatia,2003,1,2,3
Switzerland,Italy,2003,1,2,3
Tunisia,Senegal,2003,1,0,1
Uzbekistan,Belarus,2003,1,2,3
Venezuela,Trinidad and Tobago,2003,3,0,3
Fiji,Tuvalu,2003,9,0,9
Congo,Central African Republic,2003,2,1,3
Guernsey,Jersey,2003,3,3,6
United States,Mexico,2003,0,0,0
Lesotho,Botswana,2003,1,2,3
Malawi,Zambia,2003,0,1,1
Jersey,Guernsey,2003,1,0,1
Lesotho,Malawi,2003,0,0,0
Uganda,Sudan,2003,0,0,0
Norway,Finland,2003,2,0,2
South Africa,England,2003,1,2,3
Botswana,Malawi,2003,1,1,2
Sudan,Kenya,2003,1,1,2
Jamaica,Nigeria,2003,3,2,5
Lesotho,Eswatini,2003,2,1,3
Togo,Benin,2003,3,1,4
United States,Wales,2003,2,0,2
Scotland,New Zealand,2003,1,1,2
Algeria,Burkina Faso,2003,0,1,1
Nigeria,Ghana,2003,3,1,4
Gabon,Angola,2003,1,1,2
Gambia,Mauritania,2003,4,1,5
Japan,South Korea,2003,0,1,1
Kenya,Trinidad and Tobago,2003,1,1,2
Senegal,Cape Verde,2003,2,1,3
Uganda,Tanzania,2003,1,0,1
Germany,Canada,2003,4,1,5
England,Serbia,2003,2,1,3
Guadeloupe,French Guiana,2003,1,0,1
Italy,Northern Ireland,2003,2,0,2
Uganda,Libya,2003,3,2,5
Mauritania,Kenya,2003,0,0,0
Poland,Kazakhstan,2003,3,0,3
Portugal,Paraguay,2003,0,0,0
Belarus,Netherlands,2003,0,2,2
Botswana,Libya,2003,0,1,1
Bulgaria,Belgium,2003,2,2,4
Burkina Faso,Mozambique,2003,4,0,4
Denmark,Norway,2003,1,0,1
Estonia,Andorra,2003,2,0,2
Finland,Serbia,2003,3,0,3
Hungary,Latvia,2003,3,1,4
Iceland,Faroe Islands,2003,2,1,3
Republic of Ireland,Albania,2003,2,1,3
Israel,Slovenia,2003,0,0,0
North Macedonia,Liechtenstein,2003,3,1,4
Mali,Eritrea,2003,1,0,1
Malta,Cyprus,2003,1,2,3
Moldova,Austria,2003,1,0,1
Namibia,Chad,2003,2,1,3
Niger,Guinea,2003,1,0,1
Nigeria,Malawi,2003,4,1,5
Romania,Bosnia and Herzegovina,2003,2,0,2
San Marino,Sweden,2003,0,6,6
Scotland,Germany,2003,1,1,2
Senegal,Gambia,2003,3,1,4
Seychelles,Zimbabwe,2003,2,1,3
Slovakia,Turkey,2003,0,1,1
Spain,Greece,2003,0,1,1
Switzerland,Russia,2003,2,2,4
Uganda,Rwanda,2003,0,1,1
Ukraine,Armenia,2003,4,3,7
Venezuela,Honduras,2003,2,1,3
Zambia,Tanzania,2003,2,0,2
Benin,Sudan,2003,3,0,3
Central African Republic,Congo,2003,0,0,0
Colombia,Ecuador,2003,0,0,0
DR Congo,Eswatini,2003,2,0,2
Costa Rica,Chile,2003,1,0,1
Egypt,Mauritius,2003,7,0,7
Equatorial Guinea,Gabon,2003,2,1,3
Ivory Coast,Burundi,2003,6,1,7
Japan,Argentina,2003,1,4,5
South Korea,Uruguay,2003,0,2,2
Liberia,Ethiopia,2003,1,0,1
Morocco,Sierra Leone,2003,1,0,1
Togo,Cape Verde,2003,5,2,7
United States,New Zealand,2003,2,1,3
Botswana,Trinidad and Tobago,2003,0,0,0
Portugal,Bolivia,2003,4,0,4
Austria,Belarus,2003,5,0,5
Azerbaijan,Serbia,2003,2,1,3
Belgium,Andorra,2003,3,0,3
Czech Republic,Moldova,2003,5,0,5
Ecuador,Peru,2003,2,2,4
England,Slovakia,2003,2,1,3
Estonia,Croatia,2003,0,1,1
Faroe Islands,Germany,2003,0,2,2
Finland,Italy,2003,0,2,2
Greece,Ukraine,2003,1,0,1
Honduras,Chile,2003,1,2,3
Republic of Ireland,Georgia,2003,2,0,2
Japan,Paraguay,2003,0,0,0
South Korea,Argentina,2003,0,1,1
Lithuania,Iceland,2003,0,3,3
Luxembourg,Denmark,2003,0,2,2
Nigeria,Brazil,2003,0,3,3
Northern Ireland,Spain,2003,0,0,0
Norway,Romania,2003,1,1,2
San Marino,Hungary,2003,0,5,5
Sweden,Poland,2003,3,0,3
Switzerland,Albania,2003,3,2,5
Turkey,North Macedonia,2003,3,2,5
Andorra,Gabon,2003,0,2,2
Ghana,Kenya,2003,1,3,4
Papua New Guinea,Solomon Islands,2003,3,5,8
Senegal,Lesotho,2003,3,0,3
South Africa,Trinidad and Tobago,2003,2,1,3
France,Colombia,2003,1,0,1
New Zealand,Japan,2003,0,3,3
Brazil,Cameroon,2003,0,1,1
Turkey,United States,2003,2,1,3
Algeria,Namibia,2003,1,0,1
Colombia,New Zealand,2003,3,1,4
Egypt,Madagascar,2003,6,0,6
France,Japan,2003,2,1,3
Morocco,Gabon,2003,2,0,2
Brazil,United States,2003,1,0,1
Burkina Faso,Congo,2003,3,0,3
Cameroon,Turkey,2003,1,0,1
Cape Verde,Mauritania,2003,3,0,3
Eritrea,Seychelles,2003,1,0,1
Liberia,Guinea,2003,1,2,3
Nigeria,Angola,2003,2,2,4
Zambia,Sudan,2003,1,1,2
DR Congo,Libya,2003,2,1,3
Ethiopia,Niger,2003,2,0,2
France,New Zealand,2003,5,0,5
Ghana,Uganda,2003,1,1,2
Guatemala,Honduras,2003,1,2,3
Japan,Colombia,2003,0,1,1
Mali,Zimbabwe,2003,0,0,0
Mozambique,Central African Republic,2003,1,0,1
Sierra Leone,Equatorial Guinea,2003,2,0,2
South Africa,Ivory Coast,2003,2,1,3
Eswatini,Botswana,2003,3,2,5
Tanzania,Benin,2003,0,1,1
Togo,Kenya,2003,2,0,2
Brazil,Turkey,2003,2,2,4
United States,Cameroon,2003,0,0,0
Cameroon,Colombia,2003,1,0,1
France,Turkey,2003,3,2,5
Peru,Venezuela,2003,1,0,1
Panama,Cuba,2003,2,0,2
Colombia,Turkey,2003,1,2,3
France,Cameroon,2003,1,0,1
Honduras,El Salvador,2003,1,1,2
Panama,Cuba,2003,1,0,1
Saare County,Ynys Môn,2003,0,2,2
Frøya,Jersey,2003,1,5,6
Shetland,Gotland,2003,0,0,0
Guernsey,Alderney,2003,7,1,8
Gibraltar,Sark,2003,19,0,19
Isle of Wight,Greenland,2003,1,2,3
Fiji,Vanuatu,2003,0,0,0
Papua New Guinea,New Caledonia,2003,0,2,2
Tahiti,Micronesia,2003,17,0,17
Tuvalu,Kiribati,2003,3,2,5
Isle of Man,Saare County,2003,4,0,4
Gotland,Frøya,2003,2,2,4
Jersey,Shetland,2003,5,0,5
Guernsey,Orkney,2003,10,0,10
Sark,Isle of Wight,2003,0,20,20
Gibraltar,Greenland,2003,2,0,2
Fiji,Tuvalu,2003,4,0,4
Micronesia,New Caledonia,2003,0,18,18
Papua New Guinea,Tonga,2003,2,2,4
Solomon Islands,Vanuatu,2003,2,2,4
Ynys Môn,Isle of Man,2003,1,2,3
Shetland,Frøya,2003,3,1,4
Jersey,Gotland,2003,0,0,0
Orkney,Alderney,2003,3,1,4
Isle of Wight,Gibraltar,2003,2,1,3
Greenland,Sark,2003,16,0,16
El Salvador,Paraguay,2003,0,1,1
Guatemala,Peru,2003,1,2,3
Estonia,Lithuania,2003,1,5,6
Solomon Islands,Kiribati,2003,7,0,7
Tahiti,Papua New Guinea,2003,3,0,3
Tonga,New Caledonia,2003,0,4,4
Trinidad and Tobago,Venezuela,2003,2,2,4
Tuvalu,Vanuatu,2003,0,1,1
Frøya,Sark,2003,15,0,15
Alderney,Greenland,2003,0,3,3
Gotland,Saare County,2003,3,0,3
Orkney,Gibraltar,2003,1,7,8
Isle of Man,Jersey,2003,2,1,3
Guernsey,Isle of Wight,2003,3,1,4
Latvia,Lithuania,2003,2,1,3
Saare County,Alderney,2003,0,1,1
Gotland,Greenland,2003,2,1,3
Orkney,Shetland,2003,0,6,6
Gibraltar,Ynys Môn,2003,0,2,2
Jersey,Isle of Wight,2003,3,0,3
Guernsey,Isle of Man,2003,3,1,4
Botswana,DR Congo,2003,0,0,0
Estonia,Latvia,2003,0,0,0
Fiji,Kiribati,2003,12,0,12
Kenya,Cape Verde,2003,1,0,1
Libya,Eswatini,2003,6,2,8
Mauritania,Togo,2003,0,0,0
Niger,Liberia,2003,1,0,1
Seychelles,Mali,2003,0,2,2
Tahiti,New Caledonia,2003,0,4,4
Tonga,Micronesia,2003,7,0,7
Tuvalu,Solomon Islands,2003,0,4,4
Zimbabwe,Eritrea,2003,2,0,2
Angola,Malawi,2003,5,1,6
Benin,Zambia,2003,3,0,3
Burundi,South Africa,2003,0,2,2
Central African Republic,Burkina Faso,2003,0,3,3
Chad,Algeria,2003,0,0,0
Congo,Mozambique,2003,0,0,0
El Salvador,Mexico,2003,2,1,3
Equatorial Guinea,Morocco,2003,0,1,1
Gabon,Sierra Leone,2003,2,0,2
Guinea,Ethiopia,2003,3,0,3
Jamaica,Cuba,2003,1,2,3
Lesotho,Gambia,2003,1,0,1
Madagascar,Mauritius,2003,0,2,2
Rwanda,Ghana,2003,1,0,1
United States,Paraguay,2003,2,0,2
Fiji,Solomon Islands,2003,2,1,3
Kiribati,Vanuatu,2003,0,18,18
Papua New Guinea,Micronesia,2003,10,0,10
Tahiti,Tonga,2003,4,0,4
El Salvador,Guatemala,2003,1,2,3
Fiji,Tahiti,2003,2,1,3
Jamaica,Paraguay,2003,2,0,2
New Caledonia,Vanuatu,2003,1,1,2
Fiji,New Caledonia,2003,2,0,2
Tahiti,Vanuatu,2003,0,1,1
Costa Rica,Canada,2003,0,1,1
United States,El Salvador,2003,2,0,2
Jamaica,Colombia,2003,0,1,1
Mexico,Brazil,2003,1,0,1
Eswatini,Madagascar,2003,2,0,2
Canada,Cuba,2003,0,2,2
United States,Martinique,2003,2,0,2
Brazil,Honduras,2003,2,1,3
Guatemala,Jamaica,2003,0,2,2
Argentina,Uruguay,2003,2,2,4
Cuba,Costa Rica,2003,0,3,3
El Salvador,Martinique,2003,1,0,1
Colombia,Guatemala,2003,1,1,2
Mexico,Honduras,2003,0,0,0
Colombia,Brazil,2003,0,2,2
Costa Rica,El Salvador,2003,5,2,7
South Africa,Zimbabwe,2003,0,1,1
United States,Cuba,2003,5,0,5
Mexico,Jamaica,2003,5,0,5
United States,Brazil,2003,1,2,3
Mexico,Costa Rica,2003,2,0,2
Peru,Uruguay,2003,3,4,7
Nigeria,Venezuela,2003,1,0,1
United States,Costa Rica,2003,3,2,5
Zambia,Mozambique,2003,4,2,6
Mexico,Brazil,2003,1,0,1
Saint Kitts and Nevis,Haiti,2003,1,0,1
Uruguay,Peru,2003,1,0,1
Haiti,Trinidad and Tobago,2003,2,0,2
Saint Kitts and Nevis,Trinidad and Tobago,2003,1,2,3
Singapore,Hong Kong,2003,4,1,5
Iran,Iraq,2003,0,1,1
Iraq,Uruguay,2003,2,5,7
Malawi,Zambia,2003,1,1,2
Mayotte,Réunion,2003,1,1,2
Republic of Ireland,Australia,2003,2,1,3
Luxembourg,Malta,2003,1,1,2
Angola,DR Congo,2003,0,2,2
Argentina,Uruguay,2003,3,2,5
Austria,Costa Rica,2003,2,0,2
Belarus,Iran,2003,2,1,3
Belgium,Netherlands,2003,1,1,2
Bulgaria,Lithuania,2003,3,0,3
China PR,Chile,2003,0,0,0
Colombia,Slovakia,2003,0,0,0
Denmark,Finland,2003,1,1,2
Ecuador,Guatemala,2003,2,0,2
England,Croatia,2003,3,1,4
Estonia,Poland,2003,1,2,3
Faroe Islands,Iceland,2003,1,2,3
Germany,Italy,2003,0,1,1
Japan,Nigeria,2003,3,0,3
Latvia,Uzbekistan,2003,0,3,3
Liechtenstein,San Marino,2003,2,2,4
North Macedonia,Albania,2003,3,1,4
Mexico,Peru,2003,1,3,4
Norway,Scotland,2003,0,0,0
Panama,Paraguay,2003,1,2,3
Portugal,Kazakhstan,2003,1,0,1
Russia,Israel,2003,1,2,3
Serbia,Wales,2003,1,0,1
Slovenia,Hungary,2003,2,1,3
Sweden,Greece,2003,1,2,3
Switzerland,France,2003,0,2,2
Tunisia,Guinea,2003,0,0,0
Turkey,Moldova,2003,2,0,2
Ukraine,Romania,2003,0,2,2
Venezuela,Haiti,2003,3,2,5
Lebanon,Syria,2003,1,0,1
Jordan,Iraq,2003,2,1,3
Peru,Guatemala,2003,0,0,0
Bolivia,Panama,2003,3,0,3
Haiti,China PR,2003,4,3,7
Zimbabwe,Eswatini,2003,2,0,2
Algeria,Qatar,2003,1,0,1
North Korea,Lebanon,2003,0,1,1
Singapore,Kuwait,2003,1,3,4
Iran,Jordan,2003,4,1,5
Andorra,Croatia,2003,0,3,3
Argentina,Chile,2003,2,2,4
Armenia,Greece,2003,0,1,1
Azerbaijan,Finland,2003,1,2,3
Belarus,Czech Republic,2003,1,3,4
Bosnia and Herzegovina,Norway,2003,1,0,1
Bulgaria,Estonia,2003,2,0,2
Ecuador,Venezuela,2003,2,0,2
France,Cyprus,2003,5,0,5
Georgia,Albania,2003,3,0,3
Iceland,Germany,2003,0,0,0
Republic of Ireland,Russia,2003,1,1,2
Italy,Wales,2003,4,0,4
Latvia,Poland,2003,0,2,2
Liechtenstein,Turkey,2003,0,3,3
North Macedonia,England,2003,1,2,3
Netherlands,Austria,2003,3,1,4
Peru,Paraguay,2003,4,1,5
Portugal,Spain,2003,0,3,3
Romania,Luxembourg,2003,4,0,4
Scotland,Faroe Islands,2003,3,1,4
Slovenia,Israel,2003,3,1,4
Eswatini,Botswana,2003,0,3,3
Sweden,San Marino,2003,5,0,5
Ukraine,Northern Ireland,2003,0,0,0
Angola,Namibia,2003,2,0,2
Australia,Jamaica,2003,2,1,3
Colombia,Brazil,2003,1,2,3
Costa Rica,China PR,2003,2,0,2
Uruguay,Bolivia,2003,5,0,5
Chile,Peru,2003,2,1,3
Republic of Ireland,Turkey,2003,2,2,4
Venezuela,Argentina,2003,0,3,3
Albania,Georgia,2003,3,1,4
Andorra,Bulgaria,2003,0,3,3
Belgium,Croatia,2003,2,1,3
Bolivia,Colombia,2003,4,0,4
Brazil,Ecuador,2003,1,0,1
Czech Republic,Netherlands,2003,3,1,4
Denmark,Romania,2003,2,2,4
England,Liechtenstein,2003,2,0,2
Faroe Islands,Lithuania,2003,1,3,4
Germany,Scotland,2003,2,1,3
Israel,Malta,2003,2,2,4
Japan,Senegal,2003,0,1,1
Latvia,Hungary,2003,3,1,4
Luxembourg,Bosnia and Herzegovina,2003,0,1,1
Moldova,Belarus,2003,2,1,3
Morocco,Trinidad and Tobago,2003,2,0,2
Northern Ireland,Armenia,2003,0,1,1
Norway,Portugal,2003,0,1,1
Oman,Bahrain,2003,1,0,1
Paraguay,Uruguay,2003,4,1,5
Poland,Sweden,2003,0,2,2
Russia,Switzerland,2003,4,1,5
Serbia,Italy,2003,1,1,2
Slovakia,North Macedonia,2003,1,1,2
Slovenia,France,2003,0,2,2
Spain,Ukraine,2003,2,1,3
Tunisia,Ivory Coast,2003,3,2,5
Wales,Finland,2003,1,1,2
Kuwait,Qatar,2003,2,1,3
Rwanda,Kenya,2003,0,1,1
Singapore,Oman,2003,1,3,4
Yemen,Sudan,2003,3,2,5
Bahrain,Lebanon,2003,4,3,7
Jordan,Syria,2003,0,0,0
Yemen,Sudan,2003,1,2,3
Namibia,Angola,2003,1,3,4
Qatar,Kuwait,2003,2,2,4
Algeria,Gabon,2003,2,2,4
Benin,Burkina Faso,2003,0,1,1
Qatar,Palestine,2003,1,1,2
South Korea,Vietnam,2003,5,0,5
Nepal,Oman,2003,0,7,7
Algeria,Burkina Faso,2003,0,0,0
Benin,Gabon,2003,0,4,4
Jordan,Iran,2003,3,2,5
Malaysia,Indonesia,2003,1,1,2
South Korea,Oman,2003,1,0,1
Kuwait,Singapore,2003,4,0,4
Malawi,Zimbabwe,2003,1,2,3
Qatar,Palestine,2003,2,1,3
Syria,Yemen,2003,8,2,10
Vietnam,Nepal,2003,5,0,5
South Korea,Nepal,2003,16,0,16
Vietnam,Oman,2003,0,6,6
Saudi Arabia,Syria,2003,1,1,2
Lesotho,Eswatini,2003,5,2,7
Kuwait,Palestine,2003,2,1,3
Zimbabwe,Malawi,2003,2,0,2
Indonesia,Bhutan,2003,2,0,2
Saudi Arabia,Yemen,2003,7,0,7
Iraq,Bahrain,2003,5,1,6
Kuwait,Palestine,2003,4,0,4
Lesotho,South Africa,2003,0,3,3
Malaysia,Myanmar,2003,4,0,4
Oman,Jordan,2003,2,1,3
Saudi Arabia,Bhutan,2003,6,0,6
Tunisia,Japan,2003,0,1,1
Yemen,Indonesia,2003,0,3,3
Bhutan,Yemen,2003,0,8,8
Myanmar,Bahrain,2003,1,3,4
Egypt,Senegal,2003,1,0,1
Guinea-Bissau,Mali,2003,1,2,3
Malaysia,Iraq,2003,0,0,0
Saudi Arabia,Indonesia,2003,5,0,5
Armenia,Spain,2003,0,4,4
Austria,Czech Republic,2003,2,3,5
Belgium,Estonia,2003,2,0,2
Bolivia,Honduras,2003,1,0,1
Bosnia and Herzegovina,Denmark,2003,1,1,2
Botswana,Lesotho,2003,4,1,5
Croatia,Bulgaria,2003,1,0,1
Cyprus,Slovenia,2003,2,2,4
Equatorial Guinea,Togo,2003,1,0,1
Finland,Canada,2003,3,2,5
France,Israel,2003,3,0,3
Germany,Iceland,2003,3,0,3
Greece,Northern Ireland,2003,1,0,1
Hungary,Poland,2003,1,2,3
Italy,Azerbaijan,2003,4,0,4
Liechtenstein,Slovakia,2003,0,2,2
Madagascar,Benin,2003,1,1,2
Netherlands,Moldova,2003,5,0,5
Niger,Algeria,2003,0,1,1
Norway,Luxembourg,2003,1,0,1
Portugal,Albania,2003,5,3,8
Romania,Japan,2003,1,1,2
Russia,Georgia,2003,3,1,4
São Tomé and Príncipe,Libya,2003,0,1,1
Scotland,Lithuania,2003,1,0,1
Seychelles,Zambia,2003,0,4,4
South Africa,Costa Rica,2003,2,1,3
Sweden,Latvia,2003,0,1,1
Switzerland,Republic of Ireland,2003,2,0,2
Tanzania,Kenya,2003,0,0,0
Tunisia,Morocco,2003,0,0,0
Turkey,England,2003,0,0,0
Uganda,Mauritius,2003,3,0,3
Ukraine,North Macedonia,2003,0,0,0
United Arab Emirates,Uzbekistan,2003,2,2,4
Wales,Serbia,2003,2,3,5
Kernow,Jersey,2003,1,0,1
Brazil,Jamaica,2003,1,0,1
Burundi,Gabon,2003,0,0,0
Chad,Angola,2003,3,1,4
Congo,Sierra Leone,2003,1,0,1
Ethiopia,Malawi,2003,1,3,4
Gambia,Liberia,2003,2,0,2
Guinea,Mozambique,2003,1,0,1
Iran,New Zealand,2003,3,0,3
Iraq,Myanmar,2003,3,0,3
Malaysia,Bahrain,2003,2,2,4
Rwanda,Namibia,2003,3,0,3
Sudan,Eritrea,2003,3,0,3
Eswatini,Cape Verde,2003,1,1,2
Zimbabwe,Mauritania,2003,3,0,3
Bhutan,Indonesia,2003,0,2,2
Saudi Arabia,Yemen,2003,3,1,4
Indonesia,Yemen,2003,2,2,4
Mexico,Uruguay,2003,0,2,2
Saudi Arabia,Bhutan,2003,4,0,4
Syria,Sri Lanka,2003,5,0,5
Thailand,India,2003,2,0,2
Jordan,Lebanon,2003,1,0,1
Saudi Arabia,Indonesia,2003,6,0,6
Yemen,Bhutan,2003,4,0,4
Syria,Sri Lanka,2003,8,0,8
Oman,Nepal,2003,6,0,6
Singapore,Palestine,2003,2,0,2
Turkmenistan,United Arab Emirates,2003,1,0,1
Vietnam,South Korea,2003,1,0,1
Bahrain,Myanmar,2003,4,0,4
Iraq,Malaysia,2003,5,1,6
Nepal,Vietnam,2003,0,2,2
Oman,South Korea,2003,3,1,4
Bahrain,Malaysia,2003,3,1,4
Myanmar,Iraq,2003,1,3,4
India,Rwanda,2003,3,1,4
Singapore,Palestine,2003,0,0,0
Burkina Faso,Zimbabwe,2003,1,4,5
Bahrain,Iraq,2003,1,0,1
Myanmar,Malaysia,2003,2,1,3
Nepal,South Korea,2003,0,7,7
Oman,Vietnam,2003,2,0,2
North Korea,Iran,2003,1,3,4
India,Zimbabwe,2003,5,3,8
United Arab Emirates,Turkmenistan,2003,1,1,2
Rwanda,Zimbabwe,2003,2,2,4
Lebanon,North Korea,2003,1,1,2
Thailand,Tajikistan,2003,0,1,1
Uzbekistan,Hong Kong,2003,4,1,5
Syria,United Arab Emirates,2003,1,3,4
Gabon,Burkina Faso,2003,0,0,0
Hong Kong,Tajikistan,2003,0,0,0
Uzbekistan,Thailand,2003,3,0,3
Mozambique,Eswatini,2003,2,0,2
Turkmenistan,Sri Lanka,2003,1,0,1
Hong Kong,Thailand,2003,2,1,3
Uzbekistan,Tajikistan,2003,0,0,0
Uganda,Tanzania,2003,2,1,3
Equatorial Guinea,São Tomé and Príncipe,2003,3,1,4
Iran,North Korea,2003,3,0,3
Lebanon,Jordan,2003,0,2,2
Poland,Italy,2003,3,1,4
Turkmenistan,Sri Lanka,2003,3,0,3
Algeria,Niger,2003,6,0,6
Mali,Guinea-Bissau,2003,2,0,2
Mauritania,Zimbabwe,2003,2,1,3
United Arab Emirates,Syria,2003,3,1,4
Albania,Estonia,2003,2,0,2
Argentina,Bolivia,2003,3,0,3
Colombia,Venezuela,2003,0,1,1
Croatia,Slovenia,2003,1,1,2
Czech Republic,Canada,2003,5,1,6
Egypt,South Africa,2003,2,1,3
Gabon,Burundi,2003,4,1,5
Germany,France,2003,0,3,3
Kenya,Tanzania,2003,3,0,3
Latvia,Turkey,2003,1,0,1
Malawi,Ethiopia,2003,0,0,0
Morocco,Burkina Faso,2003,1,0,1
Namibia,Rwanda,2003,1,1,2
Paraguay,Ecuador,2003,2,1,3
Portugal,Greece,2003,1,1,2
Russia,Wales,2003,0,0,0
Scotland,Netherlands,2003,1,0,1
Senegal,Ivory Coast,2003,1,0,1
Spain,Norway,2003,2,1,3
Uruguay,Chile,2003,2,1,3
Zambia,Seychelles,2003,1,1,2
Angola,Chad,2003,2,0,2
Benin,Madagascar,2003,3,2,5
Cape Verde,Eswatini,2003,3,0,3
England,Denmark,2003,2,3,5
Eritrea,Sudan,2003,0,0,0
Ghana,Somalia,2003,5,0,5
Honduras,Finland,2003,1,2,3
Italy,Romania,2003,1,0,1
Jamaica,El Salvador,2003,3,0,3
Lesotho,Botswana,2003,0,0,0
Liberia,Gambia,2003,3,0,3
Libya,São Tomé and Príncipe,2003,8,0,8
Mauritius,Uganda,2003,3,1,4
Mozambique,Guinea,2003,3,4,7
Peru,Brazil,2003,1,1,2
Poland,Serbia,2003,4,3,7
Sierra Leone,Congo,2003,1,1,2
Togo,Equatorial Guinea,2003,2,0,2
Tajikistan,Uzbekistan,2003,1,4,5
Thailand,Hong Kong,2003,4,0,4
Chile,Paraguay,2003,0,1,1
Egypt,Sweden,2003,1,0,1
Republic of Ireland,Canada,2003,3,0,3
Jordan,North Korea,2003,3,0,3
South Korea,Bulgaria,2003,0,1,1
United Arab Emirates,Sri Lanka,2003,3,1,4
Venezuela,Bolivia,2003,2,1,3
Brazil,Uruguay,2003,3,3,6
Colombia,Argentina,2003,1,1,2
Costa Rica,Finland,2003,2,1,3
Ecuador,Peru,2003,0,0,0
Ghana,Somalia,2003,2,0,2
Hong Kong,Uzbekistan,2003,0,1,1
Hungary,Estonia,2003,0,1,1
Japan,Cameroon,2003,0,0,0
Lebanon,Iran,2003,0,3,3
Mexico,Iceland,2003,0,0,0
Morocco,Mali,2003,0,1,1
Netherlands,Scotland,2003,6,0,6
Norway,Spain,2003,0,3,3
Portugal,Kuwait,2003,8,0,8
Qatar,Singapore,2003,2,0,2
Slovenia,Croatia,2003,0,1,1
Thailand,Tajikistan,2003,1,0,1
Trinidad and Tobago,Cuba,2003,2,1,3
Tunisia,South Africa,2003,2,0,2
Turkey,Latvia,2003,2,2,4
Turkmenistan,Afghanistan,2003,11,0,11
Wales,Russia,2003,0,1,1
Luxembourg,Moldova,2003,1,2,3
Tajikistan,Hong Kong,2003,1,0,1
Thailand,Uzbekistan,2003,4,1,5
United Arab Emirates,Sri Lanka,2003,3,0,3
Afghanistan,Turkmenistan,2003,0,2,2
Bangladesh,Tajikistan,2003,0,2,2
Iran,Lebanon,2003,1,0,1
Syria,Turkmenistan,2003,1,1,2
Laos,Sri Lanka,2003,0,0,0
Macau,Taiwan,2003,1,3,4
Mongolia,Maldives,2003,0,1,1
Pakistan,Kyrgyzstan,2003,0,2,2
Singapore,Qatar,2003,0,2,2
Sudan,Zanzibar,2003,4,0,4
Tajikistan,Bangladesh,2003,2,0,2
Uganda,Eritrea,2003,2,1,3
Kenya,Eritrea,2003,3,2,5
Rwanda,Zanzibar,2003,2,2,4
Kyrgyzstan,Pakistan,2003,4,0,4
Maldives,Mongolia,2003,12,0,12
Sri Lanka,Laos,2003,3,0,3
Hong Kong,South Korea,2003,1,3,4
Japan,China PR,2003,2,0,2
Sudan,Rwanda,2003,3,0,3
Uganda,Kenya,2003,1,1,2
South Korea,China PR,2003,1,0,1
Kenya,Rwanda,2003,1,1,2
Sudan,Uganda,2003,0,0,0
China PR,Hong Kong,2003,3,1,4
Japan,South Korea,2003,0,0,0
Sudan,Kenya,2003,1,2,3
Uganda,Rwanda,2003,2,0,2
Malta,Poland,2003,0,4,4
Bahrain,Iraq,2003,2,2,4
Kenya,Egypt,2003,0,1,1
Botswana,Zimbabwe,2003,0,2,2
Lithuania,Poland,2003,1,3,4
United Arab Emirates,Azerbaijan,2003,3,3,6
Bahrain,Egypt,2003,0,1,1
Iraq,Kenya,2003,2,0,2
Kuwait,Lebanon,2003,2,0,2
Saudi Arabia,Estonia,2003,1,1,2
Bahrain,Kenya,2003,2,1,3
Egypt,Iraq,2003,2,0,2
Kuwait,Lebanon,2003,0,0,0
Latvia,Kuwait,2003,0,2,2
Oman,Estonia,2003,3,1,4
Saudi Arabia,Azerbaijan,2003,1,0,1
Qatar,Iraq,2003,0,0,0
United Arab Emirates,Kenya,2003,2,2,4
Bermuda,Barbados,2003,1,2,3
Kuwait,Oman,2003,0,0,0
United Arab Emirates,Saudi Arabia,2003,0,2,2
Bahamas,Haiti,2003,0,6,6
Bahrain,Qatar,2003,0,0,0
Basque Country,Uruguay,2003,2,1,3
Andalusia,Latvia,2003,1,0,1
Yemen,Oman,2003,1,1,2
Catalonia,Ecuador,2003,4,2,6
Kuwait,United Arab Emirates,2003,0,2,2
Saudi Arabia,Qatar,2003,0,0,0
Bahrain,Yemen,2003,5,1,6
Oman,United Arab Emirates,2003,2,0,2
Bahrain,Saudi Arabia,2004,0,1,1
Bermuda,Barbados,2004,0,4,4
Kuwait,Yemen,2004,4,0,4
Oman,Bahrain,2004,0,1,1
United Arab Emirates,Qatar,2004,0,0,0
Kuwait,Saudi Arabia,2004,1,1,2
Qatar,Yemen,2004,3,0,3
Oman,Saudi Arabia,2004,1,2,3
United Arab Emirates,Bahrain,2004,1,3,4
Cuba,Martinique,2004,0,0,0
Egypt,Rwanda,2004,5,1,6
Kuwait,Qatar,2004,1,2,3
Yemen,Saudi Arabia,2004,0,2,2
Kuwait,Bahrain,2004,0,4,4
Mauritius,South Africa,2004,2,0,2
Suriname,Curaçao,2004,1,1,2
Barbados,Grenada,2004,2,0,2
Oman,Qatar,2004,2,0,2
Yemen,United Arab Emirates,2004,0,3,3
Egypt,DR Congo,2004,2,2,4
Tunisia,Benin,2004,2,0,2
Algeria,Mali,2004,0,2,2
Libya,Kenya,2004,2,0,2
Curaçao,Suriname,2004,2,0,2
Egypt,Burkina Faso,2004,1,1,2
Tunisia,Benin,2004,2,1,3
Barbados,Canada,2004,0,1,1
Guadeloupe,Saint Lucia,2004,2,0,2
Senegal,South Africa,2004,2,1,3
Libya,Kenya,2004,2,0,2
Guinea,Burkina Faso,2004,1,0,1
Sweden,Norway,2004,0,3,3
Tunisia,Rwanda,2004,2,1,3
Cameroon,Algeria,2004,1,1,2
DR Congo,Guinea,2004,1,2,3
Norway,Honduras,2004,3,1,4
Zimbabwe,Egypt,2004,1,2,3
Kenya,Mali,2004,1,3,4
Senegal,Burkina Faso,2004,0,0,0
China PR,North Macedonia,2004,0,0,0
Nigeria,Morocco,2004,0,1,1
South Africa,Benin,2004,2,0,2
British Virgin Islands,Dominica,2004,0,1,1
Curaçao,Aruba,2004,6,1,7
El Salvador,Panama,2004,1,1,2
Rwanda,Guinea,2004,1,1,2
Singapore,Norway,2004,2,5,7
Tunisia,DR Congo,2004,3,0,3
Algeria,Egypt,2004,2,1,3
Cameroon,Zimbabwe,2004,5,3,8
China PR,North Macedonia,2004,1,0,1
British Virgin Islands,United States Virgin Islands,2004,5,0,5
Burkina Faso,Mali,2004,1,3,4
Senegal,Kenya,2004,3,0,3
Dominica,United States Virgin Islands,2004,5,0,5
Grenada,Barbados,2004,0,1,1
Haiti,Nicaragua,2004,1,1,2
Morocco,Benin,2004,4,0,4
Nigeria,South Africa,2004,4,0,4
British Virgin Islands,Dominica,2004,1,2,3
Rwanda,DR Congo,2004,1,0,1
Tunisia,Guinea,2004,1,1,2
Burkina Faso,Kenya,2004,0,3,3
Senegal,Mali,2004,1,1,2
Algeria,Zimbabwe,2004,1,2,3
Cameroon,Egypt,2004,0,0,0
China PR,Finland,2004,2,1,3
Morocco,South Africa,2004,1,1,2
Nigeria,Benin,2004,2,1,3
China PR,Finland,2004,2,1,3
Japan,Malaysia,2004,4,0,4
Mali,Guinea,2004,2,1,3
Tunisia,Senegal,2004,1,0,1
Cameroon,Nigeria,2004,1,2,3
Lebanon,Bahrain,2004,2,1,3
Morocco,Algeria,2004,3,1,4
Saint Lucia,Saint Vincent and the Grenadines,2004,1,2,3
Bermuda,Trinidad and Tobago,2004,0,1,1
Morocco,Mali,2004,4,0,4
Tunisia,Nigeria,2004,1,1,2
Bermuda,Trinidad and Tobago,2004,2,2,4
Japan,Iraq,2004,2,0,2
Jordan,Indonesia,2004,2,1,3
Nigeria,Mali,2004,2,1,3
Qatar,Bahrain,2004,2,0,2
Belarus,Estonia,2004,1,2,3
South Korea,Oman,2004,5,0,5
Malta,Moldova,2004,0,0,0
Tunisia,Morocco,2004,2,1,3
Barbados,Guyana,2004,0,2,2
Malta,Estonia,2004,5,2,7
Albania,Sweden,2004,2,1,3
Antigua and Barbuda,Curaçao,2004,2,0,2
Bahrain,Syria,2004,2,1,3
Belgium,France,2004,0,2,2
China PR,Kuwait,2004,1,0,1
Croatia,Germany,2004,1,2,3
Cyprus,Belarus,2004,0,2,2
Estonia,Moldova,2004,1,0,1
Greece,Bulgaria,2004,2,0,2
Haiti,Turks and Caicos Islands,2004,5,0,5
Honduras,Colombia,2004,1,1,2
Hungary,Armenia,2004,2,0,2
India,Singapore,2004,1,0,1
Iran,Qatar,2004,3,1,4
Republic of Ireland,Brazil,2004,0,0,0
Italy,Czech Republic,2004,2,2,4
Jamaica,Uruguay,2004,2,0,2
Japan,Oman,2004,1,0,1
Jordan,Laos,2004,5,0,5
South Korea,Lebanon,2004,2,0,2
Kyrgyzstan,Tajikistan,2004,1,2,3
Latvia,Kazakhstan,2004,3,1,4
Libya,Ukraine,2004,1,1,2
North Macedonia,Bosnia and Herzegovina,2004,1,0,1
Malaysia,Hong Kong,2004,1,3,4
Mexico,Chile,2004,1,1,2
Morocco,Switzerland,2004,2,1,3
Netherlands,United States,2004,1,0,1
Northern Ireland,Norway,2004,1,4,5
Palestine,Taiwan,2004,8,0,8
Poland,Slovenia,2004,2,0,2
Portugal,England,2004,1,1,2
Romania,Georgia,2004,3,0,3
Saudi Arabia,Indonesia,2004,3,0,3
Spain,Peru,2004,2,1,3
Turkmenistan,Sri Lanka,2004,2,0,2
United Arab Emirates,Thailand,2004,1,0,1
Uzbekistan,Iraq,2004,1,1,2
Venezuela,Australia,2004,1,1,2
Vietnam,Maldives,2004,4,0,4
United States Virgin Islands,Saint Kitts and Nevis,2004,0,4,4
Wales,Scotland,2004,4,0,4
Yemen,North Korea,2004,1,1,2
Cyprus,Georgia,2004,3,1,4
Kazakhstan,Armenia,2004,3,3,6
Latvia,Hungary,2004,1,2,3
Belarus,Latvia,2004,4,1,5
Cyprus,Kazakhstan,2004,2,1,3
Georgia,Armenia,2004,0,2,2
Poland,Faroe Islands,2004,6,0,6
Turks and Caicos Islands,Haiti,2004,0,2,2
British Virgin Islands,Saint Lucia,2004,0,1,1
Cayman Islands,Cuba,2004,1,2,3
Faroe Islands,Luxembourg,2004,4,2,6
Aruba,Suriname,2004,1,2,3
Grenada,Guyana,2004,5,0,5
Lesotho,Botswana,2004,0,0,0
Bermuda,Montserrat,2004,13,0,13
Nicaragua,Haiti,2004,1,1,2
Trinidad and Tobago,Guyana,2004,1,0,1
Mexico,Ecuador,2004,2,1,3
Venezuela,Honduras,2004,2,1,3
Barbados,Dominica,2004,2,1,3
United States,Haiti,2004,1,1,2
Guyana,Grenada,2004,1,3,4
Cuba,Panama,2004,1,1,2
China PR,Myanmar,2004,2,0,2
Malaysia,Indonesia,2004,0,0,0
Yemen,Turkmenistan,2004,1,2,3
Cuba,Panama,2004,3,0,3
Dominican Republic,Anguilla,2004,0,0,0
Saint Kitts and Nevis,British Virgin Islands,2004,4,0,4
Bahrain,Jordan,2004,0,0,0
Dominican Republic,Anguilla,2004,6,0,6
Montserrat,Bermuda,2004,0,7,7
Saint Kitts and Nevis,Antigua and Barbuda,2004,2,3,5
Saint Vincent and the Grenadines,Saint Lucia,2004,1,1,2
Bahrain,Jordan,2004,0,2,2
Lebanon,Syria,2004,0,1,1
Bahamas,Dominica,2004,1,1,2
Libya,Qatar,2004,1,0,1
Syria,Palestine,2004,1,1,2
Cuba,Cayman Islands,2004,3,0,3
Suriname,Aruba,2004,8,1,9
Bahamas,Dominica,2004,1,3,4
Saint Lucia,British Virgin Islands,2004,9,0,9
Argentina,Ecuador,2004,1,0,1
Australia,South Africa,2004,1,0,1
Bolivia,Chile,2004,0,2,2
Israel,Lithuania,2004,2,1,3
Estonia,Northern Ireland,2004,0,1,1
Albania,Iceland,2004,2,1,3
Bermuda,Nicaragua,2004,3,0,3
Bulgaria,Russia,2004,2,2,4
Croatia,Turkey,2004,2,2,4
Curaçao,Antigua and Barbuda,2004,3,0,3
Egypt,Trinidad and Tobago,2004,2,1,3
El Salvador,Guatemala,2004,0,3,3
Germany,Belgium,2004,3,0,3
Greece,Switzerland,2004,1,0,1
Hong Kong,China PR,2004,0,1,1
India,Oman,2004,1,5,6
Republic of Ireland,Czech Republic,2004,2,1,3
Jamaica,Honduras,2004,2,2,4
Jordan,Qatar,2004,1,0,1
North Korea,United Arab Emirates,2004,0,0,0
Kyrgyzstan,Syria,2004,1,1,2
Laos,Iran,2004,0,7,7
Luxembourg,Bosnia and Herzegovina,2004,1,2,3
North Macedonia,Ukraine,2004,1,0,1
Malaysia,Kuwait,2004,0,2,2
Maldives,South Korea,2004,0,0,0
Malta,Finland,2004,1,2,3
Mexico,Costa Rica,2004,2,0,2
Moldova,Azerbaijan,2004,2,1,3
Morocco,Angola,2004,3,1,4
Netherlands,France,2004,0,0,0
Palestine,Iraq,2004,1,1,2
Paraguay,Brazil,2004,0,0,0
Peru,Colombia,2004,0,2,2
Poland,United States,2004,0,1,1
Portugal,Italy,2004,1,2,3
Scotland,Romania,2004,1,2,3
Serbia,Norway,2004,0,1,1
Singapore,Japan,2004,1,2,3
Slovakia,Austria,2004,1,1,2
Slovenia,Latvia,2004,0,1,1
Spain,Denmark,2004,2,0,2
Sri Lanka,Saudi Arabia,2004,0,1,1
Saint Kitts and Nevis,United States Virgin Islands,2004,7,0,7
Sweden,England,2004,1,0,1
Tajikistan,Bahrain,2004,0,0,0
Tunisia,Ivory Coast,2004,0,2,2
Turkmenistan,Indonesia,2004,3,1,4
Uruguay,Venezuela,2004,0,3,3
Vietnam,Lebanon,2004,0,2,2
Yemen,Thailand,2004,0,3,3
Bermuda,Nicaragua,2004,2,1,3
Vanuatu,Solomon Islands,2004,1,2,3
Vanuatu,Solomon Islands,2004,1,2,3
Honduras,Panama,2004,0,0,0
Mozambique,Eswatini,2004,2,0,2
Andorra,China PR,2004,0,0,0
Mozambique,Madagascar,2004,2,0,2
Sudan,Syria,2004,1,2,3
Sudan,Syria,2004,0,0,0
Hungary,Japan,2004,3,2,5
Curaçao,Dominican Republic,2004,3,1,4
Algeria,China PR,2004,0,1,1
Armenia,Turkmenistan,2004,1,0,1
Austria,Luxembourg,2004,4,1,5
Belarus,Lithuania,2004,1,0,1
Belgium,Turkey,2004,2,3,5
Bosnia and Herzegovina,Finland,2004,1,0,1
Bulgaria,Cameroon,2004,3,0,3
Chile,Peru,2004,1,1,2
Czech Republic,Japan,2004,0,1,1
Denmark,Scotland,2004,1,0,1
El Salvador,Colombia,2004,0,2,2
Estonia,Albania,2004,1,1,2
Ghana,Angola,2004,1,1,2
Honduras,Ecuador,2004,1,1,2
Hungary,Brazil,2004,1,4,5
Israel,Moldova,2004,1,1,2
Italy,Spain,2004,1,1,2
Ivory Coast,Guinea,2004,4,2,6
Jamaica,Venezuela,2004,2,1,3
Kazakhstan,Azerbaijan,2004,2,3,5
South Korea,Paraguay,2004,0,0,0
Latvia,Iceland,2004,0,0,0
North Macedonia,Croatia,2004,0,1,1
Morocco,Argentina,2004,0,1,1
Namibia,Botswana,2004,0,0,0
Netherlands,Greece,2004,4,0,4
Northern Ireland,Serbia,2004,1,1,2
Norway,Russia,2004,3,2,5
Panama,Bermuda,2004,4,1,5
Poland,Republic of Ireland,2004,0,0,0
Portugal,Sweden,2004,2,2,4
Romania,Germany,2004,5,1,6
San Marino,Liechtenstein,2004,1,0,1
Switzerland,Slovenia,2004,2,1,3
Tunisia,Mali,2004,1,0,1
Ukraine,Slovakia,2004,1,1,2
United States,Mexico,2004,1,0,1
Libya,Jordan,2004,1,0,1
Nicaragua,Bermuda,2004,2,0,2
Guatemala,Panama,2004,1,2,3
Zambia,Zimbabwe,2004,1,1,2
Nicaragua,Bermuda,2004,2,0,2
Jersey,Guernsey,2004,3,0,3
Cook Islands,Samoa,2004,0,0,0
Guatemala,Haiti,2004,1,0,1
Grenada,Saint Vincent and the Grenadines,2004,1,1,2
Angola,Namibia,2004,2,1,3
Papua New Guinea,Vanuatu,2004,1,1,2
Samoa,American Samoa,2004,4,0,4
Solomon Islands,Tonga,2004,6,0,6
Tahiti,Cook Islands,2004,2,0,2
American Samoa,Vanuatu,2004,1,9,10
El Salvador,Haiti,2004,3,3,6
Fiji,Papua New Guinea,2004,4,2,6
Solomon Islands,Cook Islands,2004,5,0,5
Tahiti,New Caledonia,2004,0,0,0
Fiji,American Samoa,2004,11,0,11
Samoa,Vanuatu,2004,0,3,3
Solomon Islands,New Caledonia,2004,2,0,2
Tonga,Cook Islands,2004,2,1,3
Zimbabwe,Zambia,2004,0,0,0
American Samoa,Papua New Guinea,2004,0,10,10
New Caledonia,Cook Islands,2004,8,0,8
Samoa,Fiji,2004,0,4,4
Tahiti,Tonga,2004,2,0,2
Cyprus,Jordan,2004,0,0,0
Fiji,Vanuatu,2004,0,3,3
New Caledonia,Tonga,2004,8,0,8
Samoa,Papua New Guinea,2004,1,4,5
Solomon Islands,Tahiti,2004,1,1,2
Benin,Togo,2004,0,1,1
Cuba,Grenada,2004,2,2,4
France,Brazil,2004,0,0,0
Australia,Turkey,2004,1,3,4
Sudan,Uganda,2004,2,1,3
Zambia,Malawi,2004,0,2,2
DR Congo,Angola,2004,1,3,4
Saint Kitts and Nevis,Saint Vincent and the Grenadines,2004,3,2,5
Togo,Benin,2004,1,1,2
Trinidad and Tobago,Iraq,2004,2,0,2
Australia,Turkey,2004,0,1,1
Egypt,Zimbabwe,2004,2,0,2
Austria,Russia,2004,0,0,0
Sudan,Zambia,2004,0,2,2
Catalonia,Brazil,2004,2,5,7
Benin,Burkina Faso,2004,1,0,1
Lebanon,Bahrain,2004,2,2,4
Mozambique,Botswana,2004,0,0,0
Estonia,Scotland,2004,0,1,1
Georgia,Israel,2004,0,1,1
Germany,Malta,2004,7,0,7
Republic of Ireland,Romania,2004,1,0,1
Norway,Wales,2004,0,0,0
Azerbaijan,Uzbekistan,2004,3,1,4
Finland,Sweden,2004,1,3,4
France,Andorra,2004,4,0,4
Mali,Morocco,2004,0,0,0
Rwanda,Uganda,2004,1,1,2
Australia,New Zealand,2004,1,0,1
Croatia,Slovakia,2004,1,0,1
Egypt,Gabon,2004,2,0,2
Republic of Ireland,Nigeria,2004,0,3,3
Netherlands,Belgium,2004,0,1,1
Poland,Greece,2004,1,0,1
Portugal,Luxembourg,2004,3,0,3
Senegal,Guinea,2004,1,1,2
Tahiti,Fiji,2004,0,0,0
Vanuatu,Solomon Islands,2004,0,1,1
Algeria,Jordan,2004,1,1,2
Barbados,Northern Ireland,2004,1,1,2
Burkina Faso,Libya,2004,3,2,5
Estonia,Denmark,2004,2,2,4
Iceland,Japan,2004,2,3,5
Scotland,Trinidad and Tobago,2004,4,1,5
Saint Vincent and the Grenadines,Martinique,2004,2,0,2
Tunisia,Italy,2004,0,4,4
Wales,Canada,2004,1,0,1
Australia,Tahiti,2004,9,0,9
Fiji,Vanuatu,2004,1,0,1
Mozambique,Eswatini,2004,1,1,2
New Zealand,Solomon Islands,2004,3,0,3
Nigeria,Jamaica,2004,2,0,2
Oman,Maldives,2004,3,0,3
Qatar,Turkmenistan,2004,5,0,5
United Arab Emirates,Bahrain,2004,2,3,5
Bolivia,Paraguay,2004,2,1,3
China PR,Hungary,2004,2,1,3
England,Japan,2004,1,1,2
Kuwait,Syria,2004,0,1,1
Netherlands,Faroe Islands,2004,3,0,3
Uruguay,Peru,2004,1,3,4
Venezuela,Chile,2004,0,1,1
Australia,Fiji,2004,6,1,7
Brazil,Argentina,2004,3,1,4
Czech Republic,Bulgaria,2004,3,1,4
Ecuador,Colombia,2004,2,1,3
Grenada,Saint Lucia,2004,2,0,2
Republic of Ireland,Jamaica,2004,1,0,1
South Korea,Turkey,2004,0,1,1
New Zealand,Vanuatu,2004,2,4,6
Saint Kitts and Nevis,Northern Ireland,2004,0,2,2
Switzerland,Germany,2004,0,2,2
Tahiti,Solomon Islands,2004,0,4,4
United States,Honduras,2004,4,0,4
Indonesia,India,2004,1,1,2
Kuwait,Syria,2004,1,2,3
Liechtenstein,Greece,2004,0,2,2
Oman,Maldives,2004,4,1,5
Australia,Vanuatu,2004,3,0,3
Costa Rica,Nicaragua,2004,5,1,6
Fiji,Solomon Islands,2004,1,2,3
New Zealand,Tahiti,2004,10,0,10
Algeria,Angola,2004,0,0,0
Burkina Faso,Ghana,2004,1,0,1
Denmark,Croatia,2004,1,2,3
Ecuador,Bolivia,2004,3,2,5
England,Iceland,2004,6,1,7
Gabon,Zimbabwe,2004,1,1,2
South Korea,Turkey,2004,2,1,3
Malawi,Morocco,2004,1,1,2
Netherlands,Republic of Ireland,2004,0,1,1
Nigeria,Rwanda,2004,2,0,2
Portugal,Lithuania,2004,4,1,5
Qatar,Kyrgyzstan,2004,0,0,0
Senegal,Congo,2004,2,0,2
South Africa,Cape Verde,2004,2,1,3
Spain,Andorra,2004,4,0,4
Sweden,Poland,2004,3,1,4
Tunisia,Botswana,2004,4,1,5
Zambia,Togo,2004,1,0,1
Argentina,Paraguay,2004,0,0,0
Australia,Solomon Islands,2004,2,2,4
Cameroon,Benin,2004,2,1,3
Chile,Brazil,2004,1,1,2
Colombia,Uruguay,2004,5,0,5
Czech Republic,Estonia,2004,2,0,2
Fiji,New Zealand,2004,0,2,2
France,Ukraine,2004,1,0,1
Germany,Hungary,2004,0,2,2
Ivory Coast,Libya,2004,2,0,2
Latvia,Azerbaijan,2004,2,2,4
Liberia,Mali,2004,1,0,1
Peru,Venezuela,2004,0,0,0
Sudan,Egypt,2004,0,3,3
Switzerland,Liechtenstein,2004,1,0,1
Tahiti,Vanuatu,2004,2,1,3
Trinidad and Tobago,Northern Ireland,2004,0,3,3
Uganda,DR Congo,2004,1,0,1
Bahrain,Kyrgyzstan,2004,5,0,5
China PR,Malaysia,2004,4,0,4
Indonesia,Sri Lanka,2004,1,0,1
Iran,Jordan,2004,0,1,1
Iraq,Taiwan,2004,6,1,7
Japan,India,2004,7,0,7
South Korea,Vietnam,2004,2,0,2
Kuwait,Hong Kong,2004,4,0,4
Lebanon,Maldives,2004,3,0,3
Oman,Singapore,2004,7,0,7
Qatar,Laos,2004,5,0,5
Saudi Arabia,Turkmenistan,2004,3,0,3
Thailand,North Korea,2004,1,4,5
United Arab Emirates,Yemen,2004,3,0,3
Uzbekistan,Palestine,2004,3,0,3
Syria,Tajikistan,2004,2,1,3
Estonia,North Macedonia,2004,2,4,6
Cuba,Costa Rica,2004,2,2,4
Curaçao,Honduras,2004,1,2,3
Haiti,Jamaica,2004,1,1,2
Portugal,Greece,2004,1,2,3
Spain,Russia,2004,1,0,1
Suriname,Guatemala,2004,1,1,2
Barbados,Saint Kitts and Nevis,2004,0,2,2
Burkina Faso,Benin,2004,4,2,6
Canada,Belize,2004,4,0,4
Cape Verde,Senegal,2004,1,3,4
Dominican Republic,Trinidad and Tobago,2004,0,2,2
El Salvador,Bermuda,2004,2,1,3
France,England,2004,2,1,3
Mozambique,Malawi,2004,2,0,2
Panama,Saint Lucia,2004,4,0,4
Switzerland,Croatia,2004,0,0,0
United States,Grenada,2004,3,0,3
Denmark,Italy,2004,0,0,0
Ghana,Togo,2004,0,0,0
Sweden,Bulgaria,2004,5,0,5
Czech Republic,Latvia,2004,2,1,3
Germany,Netherlands,2004,1,1,2
Canada,Belize,2004,4,0,4
Greece,Spain,2004,1,1,2
Portugal,Russia,2004,2,0,2
Croatia,France,2004,2,2,4
England,Switzerland,2004,3,0,3
Iran,Lebanon,2004,4,0,4
Palestine,Jordan,2004,1,1,2
Bulgaria,Denmark,2004,0,2,2
Italy,Sweden,2004,1,1,2
Libya,Cameroon,2004,0,0,0
Botswana,Malawi,2004,2,0,2
Cape Verde,Uganda,2004,1,0,1
Dominica,Mexico,2004,0,10,10
Honduras,Curaçao,2004,4,0,4
Iraq,Palestine,2004,2,1,3
Latvia,Germany,2004,0,0,0
Mali,Zambia,2004,1,1,2
Netherlands,Czech Republic,2004,2,3,5
Rwanda,Gabon,2004,3,1,4
Saint Kitts and Nevis,Barbados,2004,3,2,5
Syria,Lebanon,2004,3,1,4
Angola,Nigeria,2004,1,0,1
Benin,Sudan,2004,1,1,2
Bermuda,El Salvador,2004,2,2,4
Congo,Liberia,2004,3,0,3
DR Congo,Burkina Faso,2004,3,2,5
Costa Rica,Cuba,2004,1,1,2
Egypt,Ivory Coast,2004,1,2,3
Ghana,South Africa,2004,3,0,3
Grenada,United States,2004,2,3,5
Guatemala,Suriname,2004,3,1,4
Guinea,Tunisia,2004,2,1,3
Jamaica,Haiti,2004,3,0,3
Portugal,Spain,2004,1,0,1
Russia,Greece,2004,2,1,3
Saint Lucia,Panama,2004,0,3,3
Togo,Senegal,2004,3,1,4
Trinidad and Tobago,Dominican Republic,2004,4,0,4
Zimbabwe,Algeria,2004,1,1,2
Croatia,England,2004,2,4,6
Iran,Syria,2004,7,1,8
Jordan,Iraq,2004,2,0,2
Switzerland,France,2004,1,3,4
Denmark,Sweden,2004,2,2,4
Italy,Bulgaria,2004,2,1,3
Germany,Czech Republic,2004,1,2,3
Iran,Iraq,2004,2,1,3
Jordan,Syria,2004,1,1,2
Netherlands,Latvia,2004,3,0,3
Portugal,England,2004,2,2,4
France,Greece,2004,0,1,1
Iran,Syria,2004,4,1,5
Iraq,Jordan,2004,1,3,4
Sweden,Netherlands,2004,0,0,0
Argentina,Colombia,2004,0,2,2
Czech Republic,Denmark,2004,3,0,3
Mexico,Dominica,2004,8,0,8
Eswatini,Zimbabwe,2004,0,5,5
Argentina,Peru,2004,2,1,3
Portugal,Netherlands,2004,2,1,3
Greece,Czech Republic,2004,1,0,1
Botswana,Morocco,2004,0,1,1
Cape Verde,DR Congo,2004,1,1,2
China PR,Lebanon,2004,6,0,6
Gabon,Angola,2004,2,2,4
Malawi,Guinea,2004,1,1,2
Nigeria,Algeria,2004,1,0,1
Rwanda,Zimbabwe,2004,0,2,2
Senegal,Zambia,2004,1,0,1
South Africa,Burkina Faso,2004,2,0,2
Sudan,Libya,2004,0,1,1
Uganda,Ghana,2004,1,1,2
Benin,Egypt,2004,3,3,6
Cameroon,Ivory Coast,2004,2,0,2
Liberia,Togo,2004,0,0,0
Portugal,Greece,2004,0,1,1
Thailand,Bahrain,2004,0,2,2
Malawi,Eswatini,2004,1,2,3
Peru,Bolivia,2004,2,2,4
Venezuela,Colombia,2004,0,1,1
Argentina,Ecuador,2004,6,1,7
Mexico,Uruguay,2004,2,2,4
Brazil,Chile,2004,1,0,1
Costa Rica,Paraguay,2004,0,1,1
Malawi,Eswatini,2004,1,1,2
Thailand,Jordan,2004,0,0,0
Colombia,Bolivia,2004,1,0,1
Japan,Slovakia,2004,3,1,4
Peru,Venezuela,2004,3,1,4
Argentina,Mexico,2004,0,1,1
China PR,United Arab Emirates,2004,2,2,4
South Korea,Bahrain,2004,2,0,2
Thailand,Trinidad and Tobago,2004,3,2,5
Uruguay,Ecuador,2004,2,1,3
Brazil,Costa Rica,2004,4,1,5
Paraguay,Chile,2004,1,1,2
Serbia,Slovakia,2004,2,0,2
United States,Poland,2004,1,1,2
Malaysia,Singapore,2004,2,0,2
Peru,Colombia,2004,2,2,4
Venezuela,Bolivia,2004,1,1,2
Argentina,Uruguay,2004,4,2,6
Japan,Serbia,2004,1,0,1
Mexico,Ecuador,2004,2,1,3
Brazil,Paraguay,2004,1,2,3
Costa Rica,Chile,2004,2,1,3
South Korea,Trinidad and Tobago,2004,1,1,2
China PR,Bahrain,2004,2,2,4
Colombia,Costa Rica,2004,2,0,2
Peru,Argentina,2004,0,1,1
Angola,Botswana,2004,1,1,2
El Salvador,Guatemala,2004,0,1,1
Iraq,Uzbekistan,2004,0,1,1
Mexico,Brazil,2004,0,4,4
Paraguay,Uruguay,2004,1,3,4
Qatar,Indonesia,2004,1,2,3
Saudi Arabia,Turkmenistan,2004,2,2,4
South Korea,Jordan,2004,0,0,0
Kuwait,United Arab Emirates,2004,3,1,4
Argentina,Colombia,2004,3,0,3
Iran,Thailand,2004,3,0,3
Japan,Oman,2004,1,0,1
Bahrain,Qatar,2004,1,1,2
China PR,Indonesia,2004,5,0,5
Uruguay,Brazil,2004,1,1,2
Turkmenistan,Iraq,2004,2,3,5
Uzbekistan,Saudi Arabia,2004,1,0,1
Jordan,Kuwait,2004,2,0,2
Panama,Guatemala,2004,1,1,2
United Arab Emirates,South Korea,2004,0,2,2
Colombia,Uruguay,2004,1,2,3
Oman,Iran,2004,2,2,4
Thailand,Japan,2004,1,4,5
Argentina,Brazil,2004,2,2,4
Bahrain,Indonesia,2004,3,1,4
China PR,Qatar,2004,1,0,1
Saudi Arabia,Iraq,2004,1,2,3
Turkmenistan,Uzbekistan,2004,0,1,1
Jordan,United Arab Emirates,2004,0,0,0
South Korea,Kuwait,2004,4,0,4
Honduras,Panama,2004,0,0,0
Japan,Iran,2004,0,0,0
Oman,Thailand,2004,2,0,2
China PR,Iraq,2004,3,0,3
Uzbekistan,Bahrain,2004,2,2,4
Japan,Jordan,2004,1,1,2
South Korea,Iran,2004,3,4,7
Zambia,Mauritius,2004,3,1,4
Bahrain,Japan,2004,3,4,7
China PR,Iran,2004,1,1,2
El Salvador,Honduras,2004,0,4,4
El Salvador,Guatemala,2004,0,2,2
Iran,Bahrain,2004,4,2,6
China PR,Japan,2004,1,3,4
Uganda,Kenya,2004,1,1,2
Guatemala,Trinidad and Tobago,2004,4,1,5
Uganda,Rwanda,2004,1,2,3
Algeria,Burkina Faso,2004,2,2,4
Austria,Germany,2004,1,3,4
Canada,Guatemala,2004,0,2,2
DR Congo,Mali,2004,0,3,3
Costa Rica,Honduras,2004,2,5,7
Croatia,Israel,2004,1,0,1
Cyprus,Albania,2004,2,1,3
Czech Republic,Greece,2004,0,0,0
El Salvador,Panama,2004,2,1,3
England,Ukraine,2004,3,0,3
Faroe Islands,Malta,2004,3,2,5
France,Bosnia and Herzegovina,2004,1,1,2
Haiti,Brazil,2004,0,6,6
Iceland,Italy,2004,2,0,2
Republic of Ireland,Bulgaria,2004,1,1,2
Jamaica,United States,2004,1,1,2
Japan,Argentina,2004,1,2,3
Jordan,Azerbaijan,2004,1,1,2
Kenya,Uganda,2004,4,1,5
Latvia,Wales,2004,0,2,2
Liechtenstein,Estonia,2004,1,2,3
Moldova,Georgia,2004,1,0,1
Norway,Belgium,2004,2,2,4
Poland,Denmark,2004,1,5,6
Romania,Finland,2004,2,1,3
Russia,Lithuania,2004,4,3,7
Scotland,Hungary,2004,0,3,3
Senegal,Ivory Coast,2004,1,2,3
Slovakia,Luxembourg,2004,3,1,4
Slovenia,Serbia,2004,1,1,2
Spain,Venezuela,2004,3,2,5
Sweden,Netherlands,2004,2,2,4
Switzerland,Northern Ireland,2004,0,0,0
Tunisia,South Africa,2004,0,2,2
Turkey,Belarus,2004,1,2,3
Zimbabwe,Botswana,2004,2,0,2
Thailand,Malaysia,2004,1,2,3
Vietnam,Myanmar,2004,5,0,5
India,Myanmar,2004,2,1,3
Zimbabwe,Uganda,2004,2,0,2
Vietnam,India,2004,2,1,3
Bahrain,Kuwait,2004,0,0,0
Yemen,Syria,2004,1,2,3
Yemen,Syria,2004,2,1,3
Zambia,Rwanda,2004,2,1,3
Jordan,Lebanon,2004,2,2,4
Maldives,Oman,2004,0,1,1
Saudi Arabia,Kuwait,2004,1,1,2
Bahrain,Palestine,2004,1,0,1
Libya,Benin,2004,4,1,5
Maldives,Oman,2004,1,2,3
Netherlands,Liechtenstein,2004,3,0,3
Spain,Scotland,2004,1,1,2
Albania,Greece,2004,2,1,3
Austria,England,2004,2,2,4
Azerbaijan,Wales,2004,1,1,2
Belgium,Lithuania,2004,1,1,2
Burkina Faso,Uganda,2004,2,0,2
Canada,Honduras,2004,1,1,2
Croatia,Hungary,2004,3,0,3
Denmark,Ukraine,2004,1,1,2
Estonia,Luxembourg,2004,4,0,4
Finland,Andorra,2004,3,0,3
France,Israel,2004,0,0,0
Iceland,Bulgaria,2004,1,3,4
Republic of Ireland,Cyprus,2004,3,0,3
Italy,Norway,2004,2,1,3
Jamaica,Panama,2004,1,2,3
Kenya,Malawi,2004,3,2,5
Latvia,Portugal,2004,0,2,2
Malta,Sweden,2004,0,7,7
Morocco,Tunisia,2004,1,1,2
Northern Ireland,Poland,2004,0,3,3
Peru,Argentina,2004,1,3,4
Romania,North Macedonia,2004,2,1,3
Russia,Slovakia,2004,1,1,2
San Marino,Serbia,2004,0,3,3
Singapore,Indonesia,2004,2,0,2
Slovenia,Moldova,2004,3,0,3
Saint Kitts and Nevis,Trinidad and Tobago,2004,1,2,3
Switzerland,Faroe Islands,2004,6,0,6
Turkey,Georgia,2004,1,1,2
United States,El Salvador,2004,2,0,2
Zambia,Liberia,2004,1,0,1
Algeria,Gabon,2004,0,3,3
Angola,Rwanda,2004,1,0,1
Brazil,Bolivia,2004,3,1,4
Chile,Colombia,2004,0,0,0
DR Congo,South Africa,2004,1,0,1
Egypt,Cameroon,2004,3,2,5
Ghana,Cape Verde,2004,2,0,2
Guatemala,Costa Rica,2004,2,1,3
Guinea,Botswana,2004,4,0,4
Ivory Coast,Sudan,2004,5,0,5
Mali,Senegal,2004,2,2,4
Paraguay,Venezuela,2004,1,0,1
Togo,Congo,2004,2,0,2
Uruguay,Ecuador,2004,1,0,1
Zimbabwe,Nigeria,2004,0,3,3
Andorra,Romania,2004,1,5,6
Armenia,Finland,2004,0,2,2
Austria,Azerbaijan,2004,2,0,2
Bosnia and Herzegovina,Spain,2004,1,1,2
Costa Rica,Canada,2004,1,0,1
El Salvador,Jamaica,2004,0,3,3
Faroe Islands,France,2004,0,2,2
Georgia,Albania,2004,2,0,2
Germany,Brazil,2004,1,1,2
Greece,Turkey,2004,0,0,0
Honduras,Guatemala,2004,2,2,4
Hong Kong,Kuwait,2004,0,2,2
Hungary,Iceland,2004,3,2,5
India,Japan,2004,0,4,4
Israel,Cyprus,2004,2,1,3
Jordan,Iran,2004,0,2,2
Kazakhstan,Ukraine,2004,1,2,3
North Korea,Thailand,2004,4,1,5
Kyrgyzstan,Bahrain,2004,1,2,3
Laos,Qatar,2004,1,6,7
Lithuania,San Marino,2004,4,0,4
Luxembourg,Latvia,2004,3,4,7
Malaysia,China PR,2004,0,1,1
Maldives,Lebanon,2004,2,5,7
Moldova,Italy,2004,0,1,1
Netherlands,Czech Republic,2004,2,0,2
Norway,Belarus,2004,1,1,2
Palestine,Uzbekistan,2004,0,3,3
Panama,United States,2004,1,1,2
Poland,England,2004,1,2,3
Portugal,Estonia,2004,4,0,4
Scotland,Slovenia,2004,0,0,0
Singapore,Oman,2004,0,2,2
Slovakia,Liechtenstein,2004,7,0,7
Sri Lanka,Indonesia,2004,2,2,4
Sweden,Croatia,2004,0,1,1
Switzerland,Republic of Ireland,2004,1,1,2
Tajikistan,Syria,2004,0,1,1
Trinidad and Tobago,Mexico,2004,1,3,4
Turkmenistan,Saudi Arabia,2004,0,1,1
Vietnam,South Korea,2004,1,2,3
Wales,Northern Ireland,2004,2,2,4
Yemen,United Arab Emirates,2004,3,1,4
Saint Vincent and the Grenadines,Saint Kitts and Nevis,2004,1,0,1
Mozambique,Angola,2004,0,1,1
British Virgin Islands,United States Virgin Islands,2004,2,1,3
Kuwait,Syria,2004,1,1,2
Botswana,Zambia,2004,1,0,1
Jamaica,Guatemala,2004,2,2,4
Gabon,Benin,2004,2,0,2
Lebanon,Kuwait,2004,1,3,4
Lebanon,Kuwait,2004,1,1,2
Saudi Arabia,Syria,2004,2,2,4
Oman,Iraq,2004,1,0,1
Libya,Egypt,2004,2,1,3
Qatar,Syria,2004,1,2,3
Singapore,United Arab Emirates,2004,1,2,3
Thailand,Jordan,2004,2,3,5
Albania,Denmark,2004,0,2,2
Argentina,Uruguay,2004,4,2,6
Austria,Poland,2004,1,3,4
Azerbaijan,Northern Ireland,2004,0,0,0
Belarus,Moldova,2004,4,0,4
Bolivia,Peru,2004,1,0,1
Bosnia and Herzegovina,Serbia,2004,0,0,0
Botswana,Kenya,2004,2,1,3
Cape Verde,Burkina Faso,2004,1,0,1
Colombia,Paraguay,2004,1,1,2
Costa Rica,Guatemala,2004,5,0,5
Croatia,Bulgaria,2004,2,2,4
Cyprus,Faroe Islands,2004,2,2,4
Czech Republic,Romania,2004,1,0,1
El Salvador,United States,2004,0,2,2
England,Wales,2004,2,0,2
Finland,Armenia,2004,3,1,4
France,Republic of Ireland,2004,0,0,0
Gabon,Nigeria,2004,1,1,2
Honduras,Canada,2004,1,1,2
Iran,Germany,2004,0,2,2
Israel,Switzerland,2004,2,2,4
Liechtenstein,Portugal,2004,2,2,4
Luxembourg,Russia,2004,0,4,4
North Macedonia,Netherlands,2004,2,2,4
Malawi,Tunisia,2004,2,2,4
Malta,Iceland,2004,0,0,0
Panama,Jamaica,2004,1,1,2
Rwanda,Algeria,2004,1,1,2
Scotland,Norway,2004,0,1,1
Slovakia,Latvia,2004,4,1,5
Slovenia,Italy,2004,1,0,1
Solomon Islands,Australia,2004,1,5,6
Spain,Belgium,2004,2,0,2
Sri Lanka,Turkmenistan,2004,2,2,4
Sudan,Cameroon,2004,1,1,2
Sweden,Hungary,2004,3,0,3
Turkey,Kazakhstan,2004,4,0,4
Ukraine,Greece,2004,1,1,2
Venezuela,Brazil,2004,2,5,7
Angola,Zimbabwe,2004,1,0,1
Benin,Ivory Coast,2004,0,1,1
Congo,Zambia,2004,2,3,5
Ecuador,Chile,2004,2,0,2
Ghana,DR Congo,2004,0,0,0
Guinea,Morocco,2004,1,1,2
Liberia,Senegal,2004,0,3,3
Togo,Mali,2004,1,0,1
Trinidad and Tobago,Saint Kitts and Nevis,2004,5,1,6
Uganda,South Africa,2004,0,1,1
Australia,Solomon Islands,2004,6,0,6
Bolivia,Uruguay,2004,0,0,0
Indonesia,Saudi Arabia,2004,1,3,4
Andorra,North Macedonia,2004,1,0,1
Armenia,Czech Republic,2004,0,3,3
Azerbaijan,England,2004,0,1,1
Brazil,Colombia,2004,0,0,0
Bulgaria,Malta,2004,4,1,5
Canada,Costa Rica,2004,1,3,4
Chile,Argentina,2004,0,0,0
Cyprus,France,2004,0,2,2
Denmark,Turkey,2004,1,1,2
Guatemala,Honduras,2004,1,0,1
Hong Kong,Malaysia,2004,2,0,2
Iceland,Sweden,2004,1,4,5
Iraq,Uzbekistan,2004,1,2,3
Republic of Ireland,Faroe Islands,2004,2,0,2
Italy,Belarus,2004,4,3,7
Jamaica,El Salvador,2004,0,0,0
Kazakhstan,Albania,2004,0,1,1
North Korea,Yemen,2004,2,1,3
Kuwait,China PR,2004,1,0,1
Laos,Jordan,2004,2,3,5
Latvia,Estonia,2004,2,2,4
Lebanon,South Korea,2004,1,1,2
Lithuania,Spain,2004,0,0,0
Luxembourg,Liechtenstein,2004,0,4,4
Maldives,Vietnam,2004,3,0,3
Mexico,Trinidad and Tobago,2004,3,0,3
Moldova,Scotland,2004,1,1,2
Netherlands,Finland,2004,3,1,4
Northern Ireland,Austria,2004,3,3,6
Norway,Slovenia,2004,3,0,3
Oman,Japan,2004,0,1,1
Paraguay,Peru,2004,1,1,2
Portugal,Russia,2004,7,1,8
Qatar,Iran,2004,2,3,5
Serbia,San Marino,2004,5,0,5
Singapore,India,2004,2,0,2
Saint Kitts and Nevis,Saint Vincent and the Grenadines,2004,0,3,3
Syria,Bahrain,2004,2,2,4
Tajikistan,Kyrgyzstan,2004,2,1,3
Thailand,United Arab Emirates,2004,3,0,3
Ukraine,Georgia,2004,2,0,2
United States,Panama,2004,6,0,6
Wales,Poland,2004,2,3,5
Venezuela,Ecuador,2004,3,1,4
Jersey,Kernow,2004,1,4,5
Saint Lucia,Grenada,2004,3,1,4
Suriname,French Guiana,2004,1,2,3
Ecuador,Jordan,2004,0,3,3
Libya,Jordan,2004,1,0,1
Nigeria,Ecuador,2004,2,2,4
Zimbabwe,Zambia,2004,0,0,0
Mexico,Ecuador,2004,2,1,3
Saint Kitts and Nevis,Montserrat,2004,6,1,7
Yemen,Zambia,2004,2,2,4
Montserrat,Antigua and Barbuda,2004,4,5,9
Saint Kitts and Nevis,Saint Lucia,2004,1,1,2
Saint Kitts and Nevis,Antigua and Barbuda,2004,2,0,2
Kuwait,India,2004,2,3,5
Antigua and Barbuda,Saint Lucia,2004,1,2,3
Guadeloupe,French Guiana,2004,0,1,1
Kuwait,Kyrgyzstan,2004,3,0,3
Martinique,Dominica,2004,5,1,6
Mexico,Guatemala,2004,2,0,2
United Arab Emirates,Jordan,2004,4,0,4
Guadeloupe,Dominica,2004,7,0,7
Martinique,French Guiana,2004,0,0,0
Guatemala,Bolivia,2004,1,0,1
Saint Kitts and Nevis,Mexico,2004,0,5,5
Dominica,French Guiana,2004,0,4,4
Martinique,Guadeloupe,2004,0,0,0
Australia,Norway,2004,2,2,4
Iraq,Palestine,2004,4,1,5
Republic of Ireland,Croatia,2004,1,0,1
Algeria,Senegal,2004,1,2,3
Andorra,Netherlands,2004,0,3,3
Argentina,Venezuela,2004,3,2,5
Armenia,Romania,2004,1,1,2
Azerbaijan,Bulgaria,2004,0,0,0
Bahrain,Tajikistan,2004,4,0,4
Belgium,Serbia,2004,0,2,2
China PR,Hong Kong,2004,7,0,7
Colombia,Bolivia,2004,1,0,1
Cyprus,Israel,2004,1,2,3
Ecuador,Brazil,2004,1,0,1
France,Poland,2004,0,0,0
Georgia,Denmark,2004,2,2,4
Germany,Cameroon,2004,3,0,3
Greece,Kazakhstan,2004,3,1,4
Guatemala,Canada,2004,0,1,1
Honduras,Costa Rica,2004,0,0,0
Indonesia,Turkmenistan,2004,3,1,4
Iran,Laos,2004,7,0,7
Italy,Finland,2004,1,0,1
Japan,Singapore,2004,1,0,1
Kenya,Guinea,2004,2,1,3
South Korea,Maldives,2004,2,0,2
Kuwait,Malaysia,2004,6,1,7
Lebanon,Vietnam,2004,0,0,0
Liechtenstein,Latvia,2004,1,3,4
Luxembourg,Portugal,2004,0,5,5
North Macedonia,Czech Republic,2004,0,2,2
Malta,Hungary,2004,0,2,2
Mexico,Saint Kitts and Nevis,2004,8,0,8
Morocco,Burkina Faso,2004,4,0,4
Oman,India,2004,0,0,0
Panama,El Salvador,2004,3,0,3
Peru,Chile,2004,2,1,3
Qatar,Jordan,2004,2,0,2
Russia,Estonia,2004,4,0,4
San Marino,Lithuania,2004,0,1,1
Saudi Arabia,Sri Lanka,2004,3,0,3
Scotland,Sweden,2004,1,4,5
Slovakia,Slovenia,2004,0,0,0
South Africa,Nigeria,2004,2,1,3
Spain,England,2004,1,0,1
Syria,Kyrgyzstan,2004,0,1,1
Thailand,Yemen,2004,1,1,2
Turkey,Ukraine,2004,0,3,3
United Arab Emirates,North Korea,2004,1,0,1
Uruguay,Paraguay,2004,1,0,1
United States,Jamaica,2004,1,1,2
Uzbekistan,Taiwan,2004,6,1,7
Zambia,Angola,2004,0,0,0
United Arab Emirates,Belarus,2004,2,3,5
Cayman Islands,Bermuda,2004,1,2,3
Grenada,Suriname,2004,2,2,4
Haiti,United States Virgin Islands,2004,11,0,11
Jamaica,Saint Martin,2004,12,0,12
Trinidad and Tobago,Puerto Rico,2004,5,0,5
British Virgin Islands,Cayman Islands,2004,0,1,1
Jamaica,United States Virgin Islands,2004,11,1,12
Puerto Rico,Suriname,2004,1,1,2
Saint Martin,Haiti,2004,0,2,2
Trinidad and Tobago,Grenada,2004,2,0,2
United Arab Emirates,Kuwait,2004,0,1,1
Bermuda,British Virgin Islands,2004,0,2,2
Grenada,Puerto Rico,2004,5,2,7
Jamaica,Haiti,2004,3,1,4
Singapore,Myanmar,2004,1,0,1
Trinidad and Tobago,Suriname,2004,1,0,1
United States Virgin Islands,Saint Martin,2004,0,0,0
Egypt,Bulgaria,2004,1,1,2
Hungary,Slovakia,2004,0,1,1
Singapore,Hong Kong,2004,0,0,0
Thailand,Estonia,2004,0,0,0
Bahrain,Finland,2004,1,2,3
Latvia,Oman,2004,2,3,5
Qatar,Lebanon,2004,4,1,5
Hong Kong,Myanmar,2004,2,2,4
Hungary,Estonia,2004,5,0,5
Thailand,Slovakia,2004,1,1,2
Bahrain,Latvia,2004,2,2,4
Finland,Oman,2004,0,0,0
Iraq,Yemen,2004,3,1,4
United Arab Emirates,Kuwait,2004,1,1,2
Qatar,Yemen,2004,3,0,3
Kuwait,Tajikistan,2004,3,0,3
Laos,Indonesia,2004,0,6,6
Vietnam,Singapore,2004,1,1,2
Malaysia,Timor-Leste,2004,5,0,5
Philippines,Myanmar,2004,0,1,1
Indonesia,Singapore,2004,0,0,0
Vietnam,Cambodia,2004,9,1,10
Iraq,Oman,2004,1,3,4
Malaysia,Philippines,2004,4,1,5
Qatar,United Arab Emirates,2004,2,2,4
Thailand,Myanmar,2004,1,1,2
Bahrain,Yemen,2004,1,1,2
Ethiopia,Burundi,2004,2,1,3
Laos,Cambodia,2004,2,1,3
Rwanda,Zanzibar,2004,4,2,6
Saudi Arabia,Kuwait,2004,1,2,3
Vietnam,Indonesia,2004,0,3,3
British Virgin Islands,Trinidad and Tobago,2004,0,4,4
Cuba,Martinique,2004,2,0,2
Timor-Leste,Thailand,2004,0,8,8
Haiti,Saint Kitts and Nevis,2004,1,0,1
Kenya,Sudan,2004,2,2,4
Malaysia,Myanmar,2004,0,1,1
Saint Lucia,Jamaica,2004,1,1,2
Uganda,Somalia,2004,2,0,2
Burundi,Rwanda,2004,3,1,4
Indonesia,Cambodia,2004,8,0,8
Oman,United Arab Emirates,2004,2,1,3
Qatar,Iraq,2004,3,3,6
Singapore,Laos,2004,6,2,8
Zanzibar,Tanzania,2004,4,2,6
Kuwait,Bahrain,2004,1,1,2
Malaysia,Thailand,2004,2,1,3
Philippines,Timor-Leste,2004,2,1,3
Saudi Arabia,Yemen,2004,2,0,2
Somalia,Kenya,2004,0,1,1
Sudan,Uganda,2004,2,1,3
Cambodia,Singapore,2004,0,3,3
Ethiopia,Rwanda,2004,0,0,0
Lesotho,Botswana,2004,1,1,2
Saint Kitts and Nevis,Haiti,2004,0,2,2
Tanzania,Burundi,2004,0,2,2
Vietnam,Laos,2004,3,0,3
Myanmar,Timor-Leste,2004,3,1,4
Iraq,United Arab Emirates,2004,1,1,2
Japan,Germany,2004,0,3,3
Qatar,Oman,2004,2,1,3
Thailand,Philippines,2004,3,1,4
Bahrain,Saudi Arabia,2004,3,0,3
Burundi,Zanzibar,2004,2,1,3
Ethiopia,Tanzania,2004,2,0,2
Kuwait,Yemen,2004,3,0,3
Iran,Panama,2004,1,0,1
Kenya,Uganda,2004,1,1,2
Maldives,Sri Lanka,2004,0,0,0
Sudan,Somalia,2004,4,0,4
Ethiopia,Zanzibar,2004,3,0,3
Jamaica,Saint Lucia,2004,2,1,3
South Korea,Germany,2004,3,1,4
Tanzania,Rwanda,2004,1,5,6
Trinidad and Tobago,British Virgin Islands,2004,2,0,2
Oman,Bahrain,2004,3,2,5
Qatar,Kuwait,2004,2,0,2
Martinique,Cuba,2004,0,2,2
Thailand,Germany,2004,1,5,6
Venezuela,Guatemala,2004,0,1,1
Ethiopia,Kenya,2004,2,2,4
Sudan,Burundi,2004,1,2,3
Bahrain,Kuwait,2004,3,1,4
Qatar,Oman,2004,1,1,2
Ethiopia,Burundi,2004,3,0,3
Kenya,Sudan,2004,1,2,3
Indonesia,Malaysia,2004,1,2,3
Myanmar,Singapore,2004,3,4,7
Basque Country,Honduras,2004,2,0,2
Catalonia,Argentina,2004,0,3,3
Andalusia,Malta,2004,0,0,0
Singapore,Myanmar,2005,4,2,6
Malaysia,Indonesia,2005,1,4,5
Egypt,Uganda,2005,3,0,3
Indonesia,Singapore,2005,1,3,4
Jamaica,French Guiana,2005,5,0,5
Haiti,Cuba,2005,0,1,1
Antigua and Barbuda,Trinidad and Tobago,2005,2,1,3
Costa Rica,Haiti,2005,3,3,6
Colombia,South Korea,2005,2,1,3
French Guiana,Jamaica,2005,0,0,0
Malaysia,Myanmar,2005,2,1,3
Cuba,Haiti,2005,1,1,2
Singapore,Indonesia,2005,2,1,3
Guatemala,Colombia,2005,1,1,2
Paraguay,South Korea,2005,1,1,2
Trinidad and Tobago,Azerbaijan,2005,1,0,1
Kuwait,Norway,2005,1,1,2
Sweden,South Korea,2005,1,1,2
Barbados,Grenada,2005,3,0,3
Guatemala,Paraguay,2005,1,2,3
Trinidad and Tobago,Azerbaijan,2005,2,0,2
Bahrain,Norway,2005,0,1,1
Saudi Arabia,Tajikistan,2005,3,0,3
Ecuador,Panama,2005,2,0,2
Kuwait,Syria,2005,3,2,5
Mexico,Sweden,2005,0,0,0
Jordan,Norway,2005,0,0,0
Ecuador,Panama,2005,2,0,2
Japan,Kazakhstan,2005,4,0,4
Saudi Arabia,Turkmenistan,2005,1,0,1
Trinidad and Tobago,Haiti,2005,1,0,1
Bahrain,Lebanon,2005,2,1,3
Hungary,Saudi Arabia,2005,0,0,0
Iran,Bosnia and Herzegovina,2005,2,1,3
Japan,Syria,2005,3,0,3
North Korea,Kuwait,2005,0,0,0
Trinidad and Tobago,Haiti,2005,2,1,3
South Korea,Egypt,2005,0,1,1
Barbados,Antigua and Barbuda,2005,3,2,5
Trinidad and Tobago,Haiti,2005,0,1,1
Cyprus,Austria,2005,1,1,2
Ivory Coast,DR Congo,2005,2,2,4
Latvia,Finland,2005,1,2,3
Albania,Ukraine,2005,0,2,2
Algeria,Burkina Faso,2005,3,0,3
Austria,Latvia,2005,1,1,2
Azerbaijan,Moldova,2005,0,0,0
Bahrain,Iran,2005,0,0,0
Bulgaria,Serbia,2005,0,0,0
Cameroon,Senegal,2005,1,0,1
Chile,Ecuador,2005,3,0,3
Costa Rica,Mexico,2005,1,2,3
Cyprus,Finland,2005,1,2,3
Egypt,Belgium,2005,4,0,4
England,Netherlands,2005,0,0,0
France,Sweden,2005,1,1,2
Georgia,Lithuania,2005,1,0,1
Germany,Argentina,2005,2,2,4
Greece,Denmark,2005,2,1,3
Guinea,Mali,2005,2,2,4
Hong Kong,Brazil,2005,1,7,8
Republic of Ireland,Portugal,2005,1,0,1
Israel,Croatia,2005,3,3,6
Italy,Russia,2005,2,0,2
Japan,North Korea,2005,2,1,3
South Korea,Kuwait,2005,2,0,2
North Macedonia,Andorra,2005,0,0,0
Malta,Norway,2005,0,3,3
Morocco,Kenya,2005,5,1,6
Northern Ireland,Canada,2005,0,1,1
Panama,Guatemala,2005,0,0,0
Poland,Belarus,2005,1,3,4
Romania,Slovakia,2005,2,2,4
Slovenia,Czech Republic,2005,0,3,3
South Africa,Australia,2005,1,1,2
Spain,San Marino,2005,5,0,5
Trinidad and Tobago,United States,2005,1,2,3
United Arab Emirates,Switzerland,2005,1,2,3
Uzbekistan,Saudi Arabia,2005,1,1,2
Venezuela,Estonia,2005,3,0,3
Wales,Hungary,2005,2,0,2
Barbados,Guyana,2005,3,3,6
Guatemala,Haiti,2005,2,1,3
Costa Rica,Ecuador,2005,1,2,3
El Salvador,Panama,2005,0,1,1
Guatemala,Belize,2005,2,0,2
Honduras,Nicaragua,2005,5,1,6
Barbados,Cuba,2005,0,3,3
Jamaica,Trinidad and Tobago,2005,2,1,3
Belize,Honduras,2005,0,4,4
Costa Rica,El Salvador,2005,2,1,3
Guatemala,Nicaragua,2005,4,0,4
Barbados,Jamaica,2005,0,1,1
Congo,Angola,2005,0,2,2
Trinidad and Tobago,Cuba,2005,1,2,3
Guatemala,Honduras,2005,1,1,2
Mexico,Colombia,2005,1,1,2
Nicaragua,Belize,2005,1,0,1
Panama,Costa Rica,2005,0,1,1
Barbados,Trinidad and Tobago,2005,2,3,5
Cuba,Jamaica,2005,0,1,1
Guatemala,Costa Rica,2005,0,4,4
Honduras,Panama,2005,1,0,1
Botswana,Zambia,2005,0,0,0
Mauritius,Madagascar,2005,2,0,2
Seychelles,South Africa,2005,0,3,3
Costa Rica,Honduras,2005,1,1,2
Guatemala,Panama,2005,3,0,3
Malawi,Zimbabwe,2005,2,1,3
Mauritius,South Africa,2005,0,1,1
Hong Kong,Mongolia,2005,6,0,6
Guam,Hong Kong,2005,0,15,15
North Korea,Mongolia,2005,6,0,6
Mexico,Argentina,2005,1,1,2
Mongolia,Guam,2005,4,1,5
United States,Colombia,2005,3,0,3
Guam,North Korea,2005,0,21,21
Kenya,Rwanda,2005,1,1,2
Kuwait,Finland,2005,0,1,1
Sudan,Ethiopia,2005,3,1,4
Hong Kong,North Korea,2005,0,2,2
Saudi Arabia,Egypt,2005,0,1,1
Zimbabwe,Botswana,2005,1,1,2
Kuwait,Armenia,2005,3,1,4
Saudi Arabia,Finland,2005,1,4,5
Gabon,Congo,2005,0,0,0
Lesotho,Namibia,2005,1,2,3
United States,Honduras,2005,1,0,1
South Korea,Burkina Faso,2005,1,0,1
Kenya,Ghana,2005,2,2,4
Iran,Japan,2005,2,1,3
North Korea,Bahrain,2005,1,2,3
Kuwait,Uzbekistan,2005,2,1,3
Saudi Arabia,South Korea,2005,2,0,2
Armenia,Andorra,2005,2,1,3
Australia,Iraq,2005,2,1,3
Belgium,Bosnia and Herzegovina,2005,4,1,5
Bolivia,Argentina,2005,1,2,3
Bulgaria,Sweden,2005,0,3,3
Burkina Faso,Cape Verde,2005,1,2,3
Chile,Uruguay,2005,1,1,2
Costa Rica,Panama,2005,2,1,3
Croatia,Iceland,2005,4,0,4
Cyprus,Jordan,2005,2,1,3
Czech Republic,Finland,2005,4,3,7
Denmark,Kazakhstan,2005,3,0,3
England,Northern Ireland,2005,4,0,4
Estonia,Slovakia,2005,1,2,3
France,Switzerland,2005,0,0,0
Georgia,Greece,2005,1,3,4
Guatemala,Trinidad and Tobago,2005,5,1,6
Israel,Republic of Ireland,2005,1,1,2
Italy,Scotland,2005,2,0,2
Kenya,Botswana,2005,1,0,1
Liechtenstein,Russia,2005,1,2,3
Morocco,Guinea,2005,1,0,1
Nigeria,Gabon,2005,2,0,2
Poland,Azerbaijan,2005,8,0,8
Portugal,Canada,2005,4,1,5
Romania,Netherlands,2005,0,2,2
Senegal,Liberia,2005,6,1,7
Slovenia,Germany,2005,0,1,1
South Africa,Uganda,2005,2,1,3
Spain,China PR,2005,3,0,3
Tunisia,Malawi,2005,7,0,7
Turkey,Albania,2005,2,0,2
Venezuela,Colombia,2005,0,0,0
Wales,Austria,2005,0,2,2
Zambia,Congo,2005,2,0,2
Algeria,Rwanda,2005,1,0,1
Brazil,Peru,2005,1,0,1
Cameroon,Sudan,2005,2,1,3
DR Congo,Ghana,2005,1,1,2
Ecuador,Paraguay,2005,5,2,7
Egypt,Libya,2005,4,1,5
Ivory Coast,Benin,2005,3,0,3
Mali,Togo,2005,1,2,3
Mexico,United States,2005,2,1,3
Zimbabwe,Angola,2005,2,0,2
Australia,Indonesia,2005,3,0,3
Bolivia,Venezuela,2005,3,1,4
Republic of Ireland,China PR,2005,1,0,1
Andorra,Czech Republic,2005,0,4,4
Argentina,Colombia,2005,1,0,1
Austria,Wales,2005,1,0,1
Bosnia and Herzegovina,Lithuania,2005,1,1,2
Croatia,Malta,2005,3,0,3
England,Azerbaijan,2005,2,0,2
Estonia,Russia,2005,1,1,2
Georgia,Turkey,2005,2,5,7
Greece,Albania,2005,2,0,2
Hungary,Bulgaria,2005,1,1,2
Israel,France,2005,1,1,2
Italy,Iceland,2005,0,0,0
Japan,Bahrain,2005,1,0,1
North Korea,Iran,2005,0,2,2
South Korea,Uzbekistan,2005,2,1,3
Kuwait,Saudi Arabia,2005,0,0,0
Latvia,Luxembourg,2005,4,0,4
North Macedonia,Romania,2005,1,2,3
Moldova,Norway,2005,0,0,0
Netherlands,Armenia,2005,2,0,2
Panama,Mexico,2005,1,1,2
Paraguay,Chile,2005,2,1,3
Peru,Ecuador,2005,2,2,4
Poland,Northern Ireland,2005,1,0,1
San Marino,Belgium,2005,1,2,3
Serbia,Spain,2005,0,0,0
Slovakia,Portugal,2005,1,1,2
Slovenia,Belarus,2005,1,1,2
Switzerland,Cyprus,2005,1,0,1
Trinidad and Tobago,Costa Rica,2005,0,0,0
Ukraine,Denmark,2005,1,0,1
Uruguay,Brazil,2005,1,1,2
United States,Guatemala,2005,2,0,2
Mozambique,Zimbabwe,2005,0,3,3
Namibia,Botswana,2005,1,1,2
Botswana,Zimbabwe,2005,0,2,2
Estonia,Norway,2005,1,2,3
Guatemala,Jamaica,2005,0,1,1
Brazil,Guatemala,2005,3,0,3
Mexico,Poland,2005,1,1,2
Guernsey,Jersey,2005,0,0,0
Ecuador,Paraguay,2005,1,0,1
Jersey,Guernsey,2005,3,3,6
Lithuania,Latvia,2005,2,0,2
Japan,Peru,2005,0,1,1
Sudan,Chad,2005,4,1,5
Norway,Costa Rica,2005,1,0,1
Peru,United Arab Emirates,2005,0,0,0
Trinidad and Tobago,Bermuda,2005,4,0,4
Venezuela,Panama,2005,1,1,2
Gibraltar,Monaco,2005,4,0,4
Japan,United Arab Emirates,2005,0,1,1
Kuwait,Egypt,2005,0,1,1
Libya,Malawi,2005,1,1,2
Saudi Arabia,Bahrain,2005,1,1,2
Sudan,Chad,2005,1,1,2
Trinidad and Tobago,Bermuda,2005,1,0,1
Tunisia,Angola,2005,4,1,5
United States,England,2005,1,2,3
Hong Kong,Macau,2005,8,1,9
Iran,Azerbaijan,2005,2,1,3
Poland,Albania,2005,1,0,1
Togo,Burkina Faso,2005,1,0,1
Colombia,England,2005,2,3,5
France,Hungary,2005,2,1,3
Gabon,Zambia,2005,0,1,1
Lesotho,Eswatini,2005,3,4,7
Finland,Denmark,2005,0,1,1
Bahrain,Japan,2005,0,1,1
Iran,North Korea,2005,1,0,1
Libya,Ivory Coast,2005,0,0,0
Saudi Arabia,Kuwait,2005,3,0,3
Uzbekistan,South Korea,2005,1,1,2
Albania,Georgia,2005,3,2,5
Armenia,North Macedonia,2005,1,2,3
Azerbaijan,Poland,2005,0,3,3
Belarus,Slovenia,2005,1,1,2
Benin,Cameroon,2005,1,4,5
Botswana,Tunisia,2005,1,3,4
Bulgaria,Croatia,2005,1,3,4
Cape Verde,South Africa,2005,1,2,3
Chile,Bolivia,2005,3,1,4
Colombia,Peru,2005,5,0,5
Czech Republic,Andorra,2005,8,1,9
Ecuador,Argentina,2005,2,0,2
Estonia,Liechtenstein,2005,2,0,2
Faroe Islands,Switzerland,2005,1,3,4
Guatemala,Mexico,2005,0,2,2
Iceland,Hungary,2005,2,3,5
Republic of Ireland,Israel,2005,2,2,4
Jamaica,Honduras,2005,0,0,0
Morocco,Malawi,2005,4,1,5
Netherlands,Romania,2005,2,0,2
Northern Ireland,Germany,2005,1,4,5
Norway,Italy,2005,0,0,0
Portugal,Slovakia,2005,2,0,2
Russia,Latvia,2005,2,0,2
San Marino,Bosnia and Herzegovina,2005,1,3,4
Scotland,Moldova,2005,2,0,2
Serbia,Belgium,2005,0,0,0
Singapore,Malaysia,2005,2,0,2
Spain,Lithuania,2005,1,0,1
Sweden,Malta,2005,6,0,6
Trinidad and Tobago,Panama,2005,2,0,2
Turkey,Greece,2005,0,0,0
Ukraine,Kazakhstan,2005,2,0,2
United States,Costa Rica,2005,3,0,3
Venezuela,Uruguay,2005,1,1,2
Angola,Algeria,2005,2,1,3
Brazil,Paraguay,2005,4,1,5
Congo,Senegal,2005,0,0,0
DR Congo,Uganda,2005,4,0,4
Egypt,Sudan,2005,6,1,7
Ghana,Burkina Faso,2005,2,1,3
Guinea,Kenya,2005,1,0,1
Mali,Liberia,2005,4,1,5
Rwanda,Nigeria,2005,1,1,2
Togo,Zambia,2005,4,1,5
Zimbabwe,Gabon,2005,1,0,1
Peru,Uruguay,2005,0,0,0
Argentina,Brazil,2005,3,1,4
Belarus,Scotland,2005,0,0,0
Chile,Venezuela,2005,2,1,3
Colombia,Ecuador,2005,3,0,3
Costa Rica,Guatemala,2005,3,2,5
Czech Republic,North Macedonia,2005,6,1,7
Denmark,Albania,2005,3,1,4
Estonia,Portugal,2005,0,1,1
Faroe Islands,Republic of Ireland,2005,0,2,2
Finland,Netherlands,2005,0,4,4
Germany,Russia,2005,2,2,4
Greece,Ukraine,2005,0,1,1
Iceland,Malta,2005,4,1,5
Iran,Bahrain,2005,1,0,1
Italy,Serbia,2005,1,1,2
Jordan,Iraq,2005,0,1,1
Kazakhstan,Turkey,2005,0,6,6
North Korea,Japan,2005,0,2,2
Kuwait,South Korea,2005,0,4,4
Latvia,Liechtenstein,2005,1,0,1
Luxembourg,Slovakia,2005,0,4,4
Malaysia,Singapore,2005,1,2,3
Mexico,Trinidad and Tobago,2005,2,0,2
Panama,United States,2005,0,3,3
Paraguay,Bolivia,2005,4,1,5
Romania,Armenia,2005,3,0,3
Saudi Arabia,Uzbekistan,2005,3,0,3
Spain,Bosnia and Herzegovina,2005,1,1,2
Sweden,Norway,2005,2,3,5
Australia,New Zealand,2005,1,0,1
Gambia,Guinea,2005,2,3,5
Sierra Leone,Liberia,2005,2,0,2
Ecuador,Italy,2005,1,1,2
Lesotho,Malawi,2005,1,2,3
Tunisia,Guinea,2005,2,0,2
Zambia,Eswatini,2005,3,0,3
Algeria,Mali,2005,0,3,3
Pakistan,India,2005,1,1,2
Sierra Leone,Gambia,2005,1,0,1
Zambia,Malawi,2005,2,1,3
Sierra Leone,Guinea,2005,2,0,2
Argentina,Tunisia,2005,2,1,3
Germany,Australia,2005,4,3,7
Brazil,Greece,2005,3,0,3
Japan,Mexico,2005,1,2,3
Pakistan,India,2005,0,1,1
Australia,Argentina,2005,2,4,6
Burkina Faso,DR Congo,2005,2,0,2
Gabon,Rwanda,2005,3,0,3
Germany,Tunisia,2005,3,0,3
Kenya,Morocco,2005,0,0,0
Malawi,Botswana,2005,1,3,4
Nigeria,Angola,2005,1,1,2
Pakistan,India,2005,3,0,3
Senegal,Togo,2005,2,2,4
South Africa,Ghana,2005,0,2,2
Uganda,Cape Verde,2005,1,0,1
Zambia,Mali,2005,2,1,3
Algeria,Zimbabwe,2005,2,2,4
Cameroon,Libya,2005,1,0,1
China PR,Costa Rica,2005,2,2,4
Greece,Japan,2005,0,1,1
Ivory Coast,Egypt,2005,2,0,2
Liberia,Congo,2005,0,2,2
Mexico,Brazil,2005,1,0,1
Australia,Tunisia,2005,0,2,2
Germany,Argentina,2005,2,2,4
China PR,Costa Rica,2005,2,0,2
Greece,Mexico,2005,0,0,0
Japan,Brazil,2005,2,2,4
Germany,Brazil,2005,2,3,5
Mexico,Argentina,2005,1,1,2
Mozambique,Lesotho,2005,1,0,1
Brazil,Argentina,2005,4,1,5
Germany,Mexico,2005,4,3,7
Botswana,DR Congo,2005,0,0,0
Canada,Honduras,2005,1,2,3
Congo,Mali,2005,1,0,1
Colombia,Panama,2005,0,1,1
Trinidad and Tobago,Honduras,2005,1,1,2
Canada,Costa Rica,2005,0,1,1
United States,Cuba,2005,4,1,5
Guatemala,Jamaica,2005,3,4,7
South Africa,Mexico,2005,2,1,3
Costa Rica,Cuba,2005,3,1,4
United States,Canada,2005,2,0,2
Honduras,Colombia,2005,2,1,3
Jamaica,South Africa,2005,3,3,6
Mexico,Guatemala,2005,4,0,4
Panama,Trinidad and Tobago,2005,2,2,4
Saare County,Åland Islands,2005,2,1,3
Shetland,Falkland Islands,2005,4,0,4
Guernsey,Orkney,2005,3,0,3
Greenland,Ynys Môn,2005,0,0,0
Shetland,Åland Islands,2005,3,1,4
Isle of Man,Saare County,2005,2,2,4
Orkney,Greenland,2005,1,2,3
Guernsey,Western Isles,2005,2,1,3
Canada,Cuba,2005,2,1,3
Colombia,Trinidad and Tobago,2005,2,0,2
Honduras,Panama,2005,1,0,1
United States,Costa Rica,2005,0,0,0
Saare County,Falkland Islands,2005,1,2,3
Åland Islands,Isle of Man,2005,0,1,1
Orkney,Ynys Môn,2005,0,2,2
Western Isles,Greenland,2005,4,4,8
Guatemala,South Africa,2005,1,1,2
Mexico,Jamaica,2005,1,0,1
Shetland,Saare County,2005,0,0,0
Falkland Islands,Isle of Man,2005,0,9,9
Ynys Môn,Western Isles,2005,0,0,0
Greenland,Guernsey,2005,0,6,6
Shetland,Isle of Man,2005,0,1,1
Åland Islands,Falkland Islands,2005,2,1,3
Guernsey,Ynys Môn,2005,3,0,3
Western Isles,Orkney,2005,5,4,9
Orkney,Falkland Islands,2005,2,0,2
Åland Islands,Greenland,2005,3,2,5
Ynys Môn,Saare County,2005,3,2,5
Western Isles,Isle of Man,2005,4,0,4
Shetland,Guernsey,2005,2,0,2
Honduras,Costa Rica,2005,3,2,5
United States,Jamaica,2005,3,1,4
Mexico,Colombia,2005,1,2,3
South Africa,Panama,2005,1,1,2
Colombia,Panama,2005,2,3,5
United States,Honduras,2005,2,1,3
United States,Panama,2005,0,0,0
Kuwait,United Arab Emirates,2005,1,1,2
Egypt,United Arab Emirates,2005,0,0,0
North Korea,Japan,2005,1,0,1
South Korea,China PR,2005,1,1,2
Bahrain,Turkmenistan,2005,5,0,5
Japan,China PR,2005,2,2,4
South Korea,North Korea,2005,0,0,0
Bahrain,Iraq,2005,2,2,4
China PR,North Korea,2005,2,0,2
South Korea,Japan,2005,0,1,1
Botswana,Angola,2005,0,0,0
Angola,Botswana,2005,0,0,0
Fiji,India,2005,1,0,1
Angola,Zimbabwe,2005,1,2,3
Cyprus,Iraq,2005,2,1,3
South Africa,Zambia,2005,2,2,4
Fiji,India,2005,2,1,3
South Korea,North Korea,2005,3,0,3
Zambia,Zimbabwe,2005,0,1,1
Poland,Serbia,2005,3,2,5
Ukraine,Israel,2005,0,0,0
DR Congo,Guinea,2005,3,1,4
Albania,Azerbaijan,2005,2,1,3
Angola,Cape Verde,2005,2,1,3
Austria,Scotland,2005,2,2,4
Bahrain,North Korea,2005,2,3,5
Belgium,Greece,2005,2,0,2
Bulgaria,Turkey,2005,3,1,4
Croatia,Brazil,2005,1,1,2
Denmark,England,2005,4,1,5
Ecuador,Venezuela,2005,3,1,4
Estonia,Bosnia and Herzegovina,2005,1,0,1
Faroe Islands,Cyprus,2005,0,3,3
France,Ivory Coast,2005,3,0,3
Guatemala,Panama,2005,2,1,3
Hungary,Argentina,2005,1,2,3
Iceland,South Africa,2005,4,1,5
Republic of Ireland,Italy,2005,1,2,3
Japan,Iran,2005,2,1,3
Jordan,Armenia,2005,0,0,0
Kazakhstan,Georgia,2005,1,2,3
South Korea,Saudi Arabia,2005,0,1,1
Latvia,Russia,2005,1,1,2
Libya,Nigeria,2005,0,1,1
Liechtenstein,Slovakia,2005,0,0,0
Lithuania,Belarus,2005,1,0,1
North Macedonia,Finland,2005,0,3,3
Malta,Northern Ireland,2005,1,1,2
Mexico,Costa Rica,2005,2,0,2
Morocco,Togo,2005,0,1,1
Netherlands,Germany,2005,2,2,4
Norway,Switzerland,2005,0,2,2
Paraguay,El Salvador,2005,3,0,3
Peru,Chile,2005,3,1,4
Poland,Israel,2005,3,2,5
Portugal,Egypt,2005,2,0,2
Romania,Andorra,2005,2,0,2
Senegal,Ghana,2005,0,0,0
Spain,Uruguay,2005,2,0,2
Sudan,Benin,2005,1,0,1
Sweden,Czech Republic,2005,2,1,3
Tunisia,Kenya,2005,1,0,1
Ukraine,Serbia,2005,2,1,3
United States,Trinidad and Tobago,2005,1,0,1
Uzbekistan,Kuwait,2005,3,2,5
Wales,Slovenia,2005,0,0,0
Iran,Libya,2005,4,0,4
Zimbabwe,Mozambique,2005,0,0,0
Libya,Sudan,2005,0,0,0
Albania,Kazakhstan,2005,2,1,3
Andorra,Finland,2005,0,0,0
Armenia,Netherlands,2005,0,1,1
Australia,Solomon Islands,2005,7,0,7
Bolivia,Ecuador,2005,1,2,3
Bosnia and Herzegovina,Belgium,2005,1,0,1
Burkina Faso,South Africa,2005,3,1,4
Estonia,Latvia,2005,2,1,3
France,Faroe Islands,2005,3,0,3
Georgia,Ukraine,2005,1,1,2
Hungary,Malta,2005,4,0,4
Iceland,Croatia,2005,1,3,4
Kenya,Tunisia,2005,0,2,2
Mali,Congo,2005,2,0,2
Moldova,Belarus,2005,2,0,2
Morocco,Botswana,2005,1,0,1
Northern Ireland,Azerbaijan,2005,2,0,2
Panama,Costa Rica,2005,1,3,4
Paraguay,Argentina,2005,1,0,1
Poland,Austria,2005,3,2,5
Portugal,Luxembourg,2005,6,0,6
Romania,Czech Republic,2005,2,0,2
Russia,Liechtenstein,2005,2,0,2
Scotland,Italy,2005,1,1,2
Serbia,Lithuania,2005,2,0,2
Slovakia,Germany,2005,2,0,2
Slovenia,Norway,2005,2,3,5
Spain,Canada,2005,2,1,3
Sweden,Bulgaria,2005,3,0,3
Switzerland,Israel,2005,1,1,2
Trinidad and Tobago,Guatemala,2005,3,2,5
Turkey,Denmark,2005,2,2,4
United States,Mexico,2005,2,0,2
Venezuela,Peru,2005,4,1,5
Wales,England,2005,0,1,1
Zambia,Senegal,2005,0,1,1
Algeria,Nigeria,2005,2,5,7
Angola,Gabon,2005,3,0,3
Brazil,Chile,2005,5,0,5
DR Congo,Cape Verde,2005,2,1,3
Egypt,Benin,2005,4,1,5
Ghana,Uganda,2005,2,0,2
Guinea,Malawi,2005,3,1,4
Ivory Coast,Cameroon,2005,2,3,5
Togo,Liberia,2005,3,0,3
Uruguay,Colombia,2005,3,2,5
Zimbabwe,Rwanda,2005,3,1,4
Solomon Islands,Australia,2005,1,2,3
Azerbaijan,Austria,2005,0,0,0
Belarus,Italy,2005,1,4,5
Belgium,San Marino,2005,8,0,8
Bulgaria,Iceland,2005,3,2,5
Costa Rica,Trinidad and Tobago,2005,2,0,2
Cyprus,Switzerland,2005,1,3,4
Czech Republic,Armenia,2005,4,1,5
Denmark,Georgia,2005,6,1,7
Faroe Islands,Israel,2005,0,2,2
Finland,North Macedonia,2005,5,1,6
Germany,South Africa,2005,4,2,6
Guatemala,United States,2005,0,0,0
Hungary,Sweden,2005,0,1,1
Republic of Ireland,France,2005,0,1,1
Japan,Honduras,2005,5,4,9
Kazakhstan,Greece,2005,1,2,3
Latvia,Slovakia,2005,1,1,2
Liechtenstein,Luxembourg,2005,3,0,3
Lithuania,Bosnia and Herzegovina,2005,0,1,1
Malta,Croatia,2005,1,1,2
Mexico,Panama,2005,5,0,5
Moldova,Slovenia,2005,1,2,3
Netherlands,Andorra,2005,4,0,4
Northern Ireland,England,2005,1,0,1
Norway,Scotland,2005,1,2,3
Poland,Wales,2005,1,0,1
Russia,Portugal,2005,0,0,0
Spain,Serbia,2005,1,1,2
Ukraine,Turkey,2005,0,1,1
United Arab Emirates,Benin,2005,0,0,0
Malawi,Zimbabwe,2005,2,0,2
Mozambique,Zimbabwe,2005,3,2,5
Zambia,DR Congo,2005,2,2,4
DR Congo,Zambia,2005,0,0,0
Guyana,Dominica,2005,3,0,3
Guatemala,Jamaica,2005,1,2,3
Liberia,Zambia,2005,0,5,5
Guyana,Dominica,2005,3,0,3
Poland,Iceland,2005,3,2,5
Belgium,Spain,2005,0,2,2
Bosnia and Herzegovina,San Marino,2005,3,0,3
Botswana,Guinea,2005,1,2,3
Bulgaria,Hungary,2005,2,0,2
Cameroon,Egypt,2005,1,1,2
Cape Verde,Ghana,2005,0,4,4
Colombia,Chile,2005,1,1,2
Congo,Togo,2005,2,3,5
Costa Rica,United States,2005,3,0,3
Croatia,Sweden,2005,1,0,1
Cyprus,Republic of Ireland,2005,0,1,1
Czech Republic,Netherlands,2005,0,2,2
Denmark,Greece,2005,1,0,1
Ecuador,Uruguay,2005,0,0,0
England,Austria,2005,1,0,1
Finland,Romania,2005,0,1,1
Gabon,Algeria,2005,0,0,0
Georgia,Kazakhstan,2005,0,0,0
Israel,Faroe Islands,2005,2,1,3
Italy,Slovenia,2005,1,0,1
Latvia,Japan,2005,2,2,4
Lithuania,Serbia,2005,0,2,2
Malawi,Kenya,2005,3,0,3
Mexico,Guatemala,2005,5,2,7
Nigeria,Zimbabwe,2005,5,1,6
Northern Ireland,Wales,2005,2,3,5
Norway,Moldova,2005,1,0,1
Panama,Trinidad and Tobago,2005,0,1,1
Portugal,Liechtenstein,2005,2,1,3
Russia,Luxembourg,2005,5,1,6
Rwanda,Angola,2005,0,1,1
Scotland,Belarus,2005,0,1,1
Senegal,Mali,2005,3,0,3
Slovakia,Estonia,2005,1,0,1
South Africa,DR Congo,2005,2,2,4
Sudan,Ivory Coast,2005,1,3,4
Switzerland,France,2005,1,1,2
Tunisia,Morocco,2005,2,2,4
Turkey,Germany,2005,2,1,3
Uganda,Burkina Faso,2005,2,2,4
Ukraine,Albania,2005,2,2,4
Uzbekistan,Bahrain,2005,1,1,2
Venezuela,Paraguay,2005,0,1,1
Argentina,Peru,2005,2,0,2
Australia,Jamaica,2005,5,0,5
Benin,Libya,2005,1,0,1
Bolivia,Brazil,2005,1,1,2
Cambodia,Singapore,2005,0,2,2
Qatar,Iraq,2005,0,0,0
United Arab Emirates,Oman,2005,2,2,4
Albania,Turkey,2005,0,1,1
Andorra,Armenia,2005,0,3,3
Austria,Northern Ireland,2005,2,0,2
Bahrain,Uzbekistan,2005,0,0,0
Belarus,Norway,2005,0,1,1
Brazil,Venezuela,2005,3,0,3
Chile,Ecuador,2005,0,0,0
England,Poland,2005,2,1,3
Finland,Czech Republic,2005,0,3,3
France,Cyprus,2005,4,0,4
Germany,China PR,2005,1,0,1
Greece,Georgia,2005,1,0,1
Guatemala,Costa Rica,2005,3,1,4
Hungary,Croatia,2005,0,0,0
Republic of Ireland,Switzerland,2005,0,0,0
Italy,Moldova,2005,2,1,3
Kazakhstan,Denmark,2005,1,2,3
South Korea,Iran,2005,2,0,2
Lithuania,Belgium,2005,1,1,2
Luxembourg,Estonia,2005,0,2,2
Malta,Bulgaria,2005,1,1,2
Netherlands,North Macedonia,2005,0,0,0
Paraguay,Colombia,2005,0,1,1
Peru,Bolivia,2005,4,1,5
Portugal,Latvia,2005,3,0,3
San Marino,Spain,2005,0,6,6
Serbia,Bosnia and Herzegovina,2005,1,0,1
Slovakia,Russia,2005,0,0,0
Slovenia,Scotland,2005,0,3,3
Sweden,Iceland,2005,3,1,4
Trinidad and Tobago,Mexico,2005,2,1,3
Ukraine,Japan,2005,1,0,1
Uruguay,Argentina,2005,1,0,1
United States,Panama,2005,2,0,2
Wales,Azerbaijan,2005,2,0,2
Kernow,Jersey,2005,3,2,5
Madagascar,Mauritius,2005,2,0,2
Oman,Syria,2005,0,0,0
Mexico,Uruguay,2005,3,1,4
Bahrain,Panama,2005,5,0,5
Puerto Rico,Guadeloupe,2005,1,3,4
Zanzibar,Tanzania,2005,0,1,1
France,Costa Rica,2005,3,2,5
Tajikistan,Afghanistan,2005,4,0,4
Tanzania,Zanzibar,2005,1,0,1
DR Congo,Tunisia,2005,2,2,4
Paraguay,Togo,2005,4,2,6
Belarus,Latvia,2005,3,1,4
Bulgaria,Georgia,2005,6,2,8
England,Argentina,2005,3,2,5
Finland,Estonia,2005,2,2,4
France,Germany,2005,0,0,0
South Korea,Sweden,2005,2,2,4
Liechtenstein,North Macedonia,2005,1,2,3
Netherlands,Italy,2005,1,3,4
Norway,Czech Republic,2005,0,1,1
Portugal,Croatia,2005,2,0,2
Romania,Ivory Coast,2005,1,2,3
Scotland,United States,2005,1,1,2
South Africa,Senegal,2005,2,3,5
Spain,Slovakia,2005,5,1,6
Switzerland,Turkey,2005,2,0,2
Trinidad and Tobago,Bahrain,2005,1,1,2
United Arab Emirates,Brazil,2005,0,8,8
Uruguay,Australia,2005,1,0,1
China PR,Serbia,2005,0,2,2
Ecuador,Poland,2005,0,3,3
Iran,Togo,2005,2,0,2
Saudi Arabia,Ghana,2005,1,3,4
Morocco,Cameroon,2005,0,0,0
Northern Ireland,Portugal,2005,1,1,2
Australia,Uruguay,2005,1,0,1
Bahrain,Trinidad and Tobago,2005,0,1,1
Cyprus,Wales,2005,1,0,1
Czech Republic,Norway,2005,1,0,1
Egypt,Tunisia,2005,1,2,3
Georgia,Jordan,2005,3,2,5
Greece,Hungary,2005,2,1,3
Ivory Coast,Italy,2005,1,1,2
Japan,Angola,2005,1,0,1
South Korea,Serbia,2005,2,0,2
Libya,DR Congo,2005,2,1,3
Luxembourg,Canada,2005,0,1,1
Mexico,Bulgaria,2005,0,3,3
Poland,Estonia,2005,3,1,4
Qatar,Argentina,2005,0,3,3
Romania,Nigeria,2005,3,0,3
Slovakia,Spain,2005,1,1,2
Syria,United Arab Emirates,2005,0,3,3
Turkey,Switzerland,2005,4,2,6
Guinea,Guinea-Bissau,2005,2,2,4
Guinea-Bissau,Sierra Leone,2005,1,1,2
Guinea,Sierra Leone,2005,1,0,1
Sudan,Ethiopia,2005,1,5,6
Kuwait,Iraq,2005,0,0,0
Rwanda,Zanzibar,2005,0,1,1
Djibouti,Somalia,2005,1,2,3
Ethiopia,Uganda,2005,0,0,0
Burundi,Tanzania,2005,1,2,3
Eritrea,Zanzibar,2005,0,3,3
Somalia,Sudan,2005,1,4,5
Burundi,Zanzibar,2005,1,2,3
Djibouti,Uganda,2005,1,6,7
Rwanda,Eritrea,2005,3,2,5
Ethiopia,Sudan,2005,3,1,4
Iraq,Palestine,2005,4,0,4
Somalia,Uganda,2005,0,7,7
Burundi,Eritrea,2005,0,0,0
Tanzania,Zanzibar,2005,1,1,2
United Arab Emirates,Libya,2005,1,1,2
Djibouti,Ethiopia,2005,0,6,6
Oman,Syria,2005,1,3,4
Saudi Arabia,Palestine,2005,2,0,2
Sudan,Uganda,2005,0,3,3
Bahrain,Syria,2005,2,2,4
Eritrea,Tanzania,2005,0,1,1
Rwanda,Burundi,2005,2,0,2
Djibouti,Sudan,2005,0,4,4
Ethiopia,Somalia,2005,3,1,4
Iraq,Saudi Arabia,2005,5,1,6
Bahrain,Oman,2005,2,2,4
Rwanda,Tanzania,2005,3,1,4
Maldives,Afghanistan,2005,9,1,10
Pakistan,Sri Lanka,2005,1,0,1
Bangladesh,Bhutan,2005,3,0,3
India,Nepal,2005,2,1,3
Iraq,Saudi Arabia,2005,2,0,2
Rwanda,Uganda,2005,1,0,1
Zanzibar,Ethiopia,2005,0,4,4
Maldives,Sri Lanka,2005,2,0,2
Pakistan,Afghanistan,2005,1,0,1
Bangladesh,Nepal,2005,2,0,2
India,Bhutan,2005,3,0,3
Rwanda,Ethiopia,2005,0,1,1
Syria,Iraq,2005,2,2,4
Zanzibar,Uganda,2005,0,0,0
DR Congo,Zambia,2005,1,1,2
Pakistan,Maldives,2005,0,0,0
Sri Lanka,Afghanistan,2005,1,2,3
Bangladesh,India,2005,1,1,2
Nepal,Bhutan,2005,3,1,4
Maldives,India,2005,0,1,1
Mexico,Hungary,2005,2,0,2
Pakistan,Bangladesh,2005,0,1,1
Zambia,DR Congo,2005,4,1,5
Mauritius,Réunion,2005,1,1,2
Bangladesh,India,2005,0,2,2
Antigua and Barbuda,Hungary,2005,0,3,3
Réunion,Mauritius,2005,1,2,3
Bangladesh,Pakistan,2005,0,0,0
Thailand,Latvia,2005,1,1,2
Galicia,Uruguay,2005,3,2,5
North Korea,Latvia,2005,1,1,2
Pakistan,Bangladesh,2005,0,1,1
Ecuador,Senegal,2005,1,2,3
Egypt,Uganda,2005,2,0,2
Thailand,North Korea,2005,0,2,2
Basque Country,Cameroon,2005,0,1,1
Catalonia,Paraguay,2005,1,1,2
Andalusia,China PR,2005,4,1,5
Ecuador,Uganda,2005,1,2,3
Egypt,Senegal,2005,4,2,6
Latvia,North Korea,2005,2,1,3
Qatar,Libya,2006,2,0,2
Egypt,Zimbabwe,2006,2,0,2
Guinea,Togo,2006,1,0,1
Morocco,DR Congo,2006,3,0,3
Ghana,Togo,2006,0,1,1
Tunisia,Libya,2006,1,0,1
Egypt,South Africa,2006,1,2,3
Morocco,Zimbabwe,2006,1,0,1
Senegal,DR Congo,2006,0,0,0
Tunisia,Ghana,2006,2,0,2
Ivory Coast,Jordan,2006,2,0,2
Morocco,Angola,2006,2,2,4
Saudi Arabia,Sweden,2006,1,1,2
United Arab Emirates,South Korea,2006,1,0,1
Egypt,Libya,2006,3,0,3
Cameroon,Angola,2006,3,1,4
Greece,South Korea,2006,1,1,2
Morocco,Ivory Coast,2006,0,1,1
Saudi Arabia,Finland,2006,1,1,2
Togo,DR Congo,2006,0,2,2
South Africa,Guinea,2006,0,2,2
Tunisia,Zambia,2006,4,1,5
United States,Canada,2006,0,0,0
Jordan,Sweden,2006,0,0,0
Nigeria,Ghana,2006,1,0,1
Zimbabwe,Senegal,2006,0,2,2
Egypt,Morocco,2006,0,0,0
Libya,Ivory Coast,2006,1,2,3
Angola,DR Congo,2006,0,0,0
Cameroon,Togo,2006,2,0,2
Ecuador,Honduras,2006,1,0,1
Finland,South Korea,2006,0,1,1
Mexico,Norway,2006,2,1,3
Saudi Arabia,Greece,2006,1,1,2
Tunisia,South Africa,2006,2,0,2
Zambia,Guinea,2006,1,2,3
Ghana,Senegal,2006,1,0,1
Nigeria,Zimbabwe,2006,2,0,2
Northern Cyprus,Kyrgyzstan,2006,3,2,5
Saudi Arabia,Lebanon,2006,1,2,3
Egypt,Ivory Coast,2006,3,1,4
Libya,Morocco,2006,0,0,0
Angola,Togo,2006,3,2,5
Cameroon,DR Congo,2006,2,0,2
South Korea,Croatia,2006,2,0,2
United States,Norway,2006,5,0,5
Bahrain,Syria,2006,1,1,2
Tunisia,Guinea,2006,0,3,3
Zambia,South Africa,2006,1,0,1
Ghana,Zimbabwe,2006,1,2,3
Nigeria,Senegal,2006,2,1,3
Hong Kong,Croatia,2006,0,4,4
Thailand,Jordan,2006,0,0,0
Egypt,DR Congo,2006,4,1,5
Guinea,Senegal,2006,2,3,5
Cameroon,Ivory Coast,2006,1,1,2
Nigeria,Tunisia,2006,1,1,2
Oman,Singapore,2006,1,0,1
Egypt,Senegal,2006,2,1,3
Kuwait,Jordan,2006,2,1,3
Nigeria,Ivory Coast,2006,0,1,1
Syria,Palestine,2006,3,0,3
Senegal,Nigeria,2006,0,1,1
Egypt,Ivory Coast,2006,0,0,0
United States,Japan,2006,3,2,5
Costa Rica,South Korea,2006,1,0,1
China PR,Honduras,2006,0,1,1
Oman,Iraq,2006,1,0,1
Jordan,Kazakhstan,2006,2,0,2
Qatar,Tajikistan,2006,2,0,2
Saudi Arabia,Syria,2006,1,1,2
Hong Kong,Singapore,2006,1,1,2
Mexico,South Korea,2006,0,1,1
Bahrain,Palestine,2006,0,2,2
Thailand,Iraq,2006,4,3,7
Hong Kong,India,2006,2,2,4
Japan,Finland,2006,2,0,2
Pakistan,Palestine,2006,0,3,3
New Zealand,Malaysia,2006,1,0,1
United States,Guatemala,2006,4,0,4
Bahrain,Australia,2006,1,3,4
China PR,Palestine,2006,2,0,2
Hong Kong,Qatar,2006,0,3,3
Iran,Taiwan,2006,4,0,4
Japan,India,2006,6,0,6
Jordan,Pakistan,2006,3,0,3
Lebanon,Kuwait,2006,1,1,2
Singapore,Iraq,2006,2,0,2
Syria,South Korea,2006,1,2,3
United Arab Emirates,Oman,2006,1,0,1
Uzbekistan,Bangladesh,2006,5,0,5
Yemen,Saudi Arabia,2006,0,4,4
New Zealand,Malaysia,2006,2,1,3
Guyana,Antigua and Barbuda,2006,2,1,3
Kazakhstan,North Korea,2006,0,0,0
Saint Kitts and Nevis,Saint Martin,2006,6,1,7
Guyana,Antigua and Barbuda,2006,4,1,5
Algeria,Burkina Faso,2006,0,0,0
Azerbaijan,Ukraine,2006,0,0,0
Bosnia and Herzegovina,Japan,2006,2,2,4
Cyprus,Slovenia,2006,0,1,1
Finland,Kazakhstan,2006,0,0,0
Greece,Belarus,2006,1,0,1
Iceland,Trinidad and Tobago,2006,0,2,2
Romania,Armenia,2006,2,0,2
Albania,Lithuania,2006,1,2,3
Argentina,Croatia,2006,2,3,5
Austria,Canada,2006,0,2,2
Bangladesh,Hong Kong,2006,0,1,1
Cyprus,Armenia,2006,2,0,2
England,Uruguay,2006,2,1,3
Finland,Belarus,2006,2,2,4
France,Slovakia,2006,1,2,3
India,Yemen,2006,0,3,3
Iran,Costa Rica,2006,3,2,5
Iraq,China PR,2006,2,1,3
Republic of Ireland,Sweden,2006,3,0,3
Israel,Denmark,2006,0,2,2
Italy,Germany,2006,4,1,5
Kazakhstan,Greece,2006,0,2,2
South Korea,Angola,2006,1,0,1
Kuwait,Bahrain,2006,0,0,0
Luxembourg,Belgium,2006,0,2,2
North Macedonia,Bulgaria,2006,0,1,1
Malta,Georgia,2006,0,2,2
Mexico,Ghana,2006,1,0,1
Netherlands,Ecuador,2006,1,0,1
Northern Ireland,Estonia,2006,1,0,1
Oman,Jordan,2006,3,0,3
Pakistan,United Arab Emirates,2006,1,4,5
Palestine,Singapore,2006,1,0,1
Poland,United States,2006,0,1,1
Qatar,Uzbekistan,2006,2,1,3
Russia,Brazil,2006,0,1,1
Saudi Arabia,Portugal,2006,0,3,3
Scotland,Switzerland,2006,1,3,4
Senegal,Norway,2006,2,1,3
Slovenia,Romania,2006,0,2,2
Spain,Ivory Coast,2006,3,2,5
Tunisia,Serbia,2006,0,1,1
Turkey,Czech Republic,2006,2,2,4
Venezuela,Colombia,2006,1,1,2
Wales,Paraguay,2006,0,0,0
Saudi Arabia,Iraq,2006,2,2,4
Albania,Georgia,2006,0,0,0
Germany,United States,2006,4,1,5
Thailand,Philippines,2006,5,0,5
Saudi Arabia,Poland,2006,1,2,3
Equatorial Guinea,Benin,2006,2,0,2
Mexico,Paraguay,2006,2,1,3
Japan,Ecuador,2006,1,0,1
Bangladesh,Cambodia,2006,2,1,3
Palestine,Guam,2006,11,0,11
Tanzania,Zanzibar,2006,2,2,4
Kyrgyzstan,Pakistan,2006,0,1,1
Nepal,Bhutan,2006,2,0,2
Sri Lanka,Brunei,2006,1,0,1
Tajikistan,Macau,2006,4,0,4
Afghanistan,Taiwan,2006,2,2,4
Bangladesh,Guam,2006,3,0,3
Cambodia,Palestine,2006,0,4,4
Bhutan,Sri Lanka,2006,0,1,1
Brunei,Nepal,2006,2,1,3
Pakistan,Tajikistan,2006,0,2,2
Bangladesh,Palestine,2006,1,1,2
Philippines,Afghanistan,2006,1,1,2
Bhutan,Brunei,2006,0,0,0
Cambodia,Guam,2006,3,0,3
Pakistan,Macau,2006,2,2,4
Sri Lanka,Nepal,2006,1,1,2
Tajikistan,Kyrgyzstan,2006,0,1,1
Macau,Kyrgyzstan,2006,0,2,2
Sri Lanka,Taiwan,2006,3,0,3
Palestine,Kyrgyzstan,2006,0,1,1
Bangladesh,Tajikistan,2006,1,6,7
United States,Jamaica,2006,1,1,2
Azerbaijan,Turkey,2006,1,1,2
Sri Lanka,Nepal,2006,1,1,2
Tajikistan,Kyrgyzstan,2006,2,0,2
Lesotho,Eswatini,2006,5,0,5
Lesotho,Eswatini,2006,2,2,4
Sri Lanka,Tajikistan,2006,0,4,4
Kosovo,Monaco,2006,7,1,8
Chile,New Zealand,2006,4,1,5
Chile,New Zealand,2006,1,0,1
Angola,Mauritius,2006,5,1,6
Lesotho,Mozambique,2006,0,0,0
Lesotho,Angola,2006,1,3,4
Mauritius,Mozambique,2006,0,0,0
Jersey,Guernsey,2006,3,2,5
Poland,Lithuania,2006,0,1,1
United Arab Emirates,Syria,2006,2,1,3
Mexico,Venezuela,2006,1,0,1
Japan,Bulgaria,2006,1,2,3
Lesotho,South Africa,2006,0,0,0
Trinidad and Tobago,Peru,2006,1,1,2
Belgium,Saudi Arabia,2006,2,1,3
Bulgaria,Scotland,2006,1,5,6
Mexico,DR Congo,2006,2,1,3
Japan,Scotland,2006,0,0,0
Botswana,Zambia,2006,0,0,0
Poland,Faroe Islands,2006,4,0,4
Saudi Arabia,Togo,2006,1,0,1
Moldova,Azerbaijan,2006,0,0,0
Botswana,Madagascar,2006,2,0,2
Guadeloupe,Saint Lucia,2006,2,1,3
Slovakia,Belgium,2006,1,1,2
South Africa,Eswatini,2006,1,0,1
Botswana,South Africa,2006,0,0,0
Madagascar,Eswatini,2006,0,2,2
Northern Ireland,Uruguay,2006,0,1,1
Basque Country,Wales,2006,0,1,1
Austria,Croatia,2006,1,4,5
South Korea,Senegal,2006,1,1,2
Romania,Uruguay,2006,0,2,2
United States,Morocco,2006,0,1,1
Belgium,Turkey,2006,3,3,6
Colombia,Ecuador,2006,1,1,2
Hungary,New Zealand,2006,2,0,2
Republic of Ireland,Chile,2006,0,1,1
Norway,Paraguay,2006,2,2,4
Catalonia,Costa Rica,2006,2,0,2
Australia,Greece,2006,1,0,1
Sweden,Finland,2006,0,0,0
Czech Republic,Saudi Arabia,2006,2,0,2
South Korea,Bosnia and Herzegovina,2006,2,0,2
Romania,Northern Ireland,2006,2,0,2
Turkey,Ghana,2006,1,1,2
United States,Venezuela,2006,2,0,2
Denmark,Paraguay,2006,1,1,2
France,Mexico,2006,1,0,1
Georgia,New Zealand,2006,1,3,4
Germany,Luxembourg,2006,7,0,7
Netherlands,Cameroon,2006,1,0,1
Portugal,Cape Verde,2006,4,1,5
Romania,Colombia,2006,0,0,0
Serbia,Uruguay,2006,1,1,2
Spain,Russia,2006,0,0,0
Switzerland,Ivory Coast,2006,1,1,2
Wales,Trinidad and Tobago,2006,2,1,3
Croatia,Iran,2006,2,2,4
North Macedonia,Ecuador,2006,2,1,3
Morocco,Mali,2006,0,1,1
Turkey,Estonia,2006,1,1,2
Ukraine,Costa Rica,2006,4,0,4
United States,Latvia,2006,1,0,1
Jamaica,Ghana,2006,1,4,5
Northern Cyprus,Greenland,2006,1,0,1
Republic of St. Pauli,Gibraltar,2006,1,1,2
Argentina,Angola,2006,2,0,2
Chile,Ivory Coast,2006,1,1,2
Czech Republic,Costa Rica,2006,1,0,1
England,Hungary,2006,3,1,4
Germany,Japan,2006,2,2,4
Libya,Uruguay,2006,1,2,3
Poland,Colombia,2006,1,2,3
Tunisia,Belarus,2006,3,0,3
Zanzibar,Northern Cyprus,2006,1,3,4
Republic of St. Pauli,Tibet,2006,7,0,7
Estonia,New Zealand,2006,1,1,2
France,Denmark,2006,2,0,2
Georgia,Paraguay,2006,0,1,1
Gibraltar,Tibet,2006,5,0,5
Greenland,Zanzibar,2006,2,4,6
Iran,Bosnia and Herzegovina,2006,5,2,7
Saudi Arabia,Turkey,2006,0,1,1
Singapore,Malaysia,2006,0,0,0
Slovenia,Trinidad and Tobago,2006,3,1,4
Switzerland,Italy,2006,1,1,2
Netherlands,Mexico,2006,2,1,3
Northern Cyprus,Gibraltar,2006,2,0,2
Republic of St. Pauli,Zanzibar,2006,1,2,3
Norway,South Korea,2006,0,0,0
Angola,Turkey,2006,2,3,5
Germany,Colombia,2006,3,0,3
Italy,Ukraine,2006,0,0,0
Libya,Belarus,2006,1,1,2
Liechtenstein,Togo,2006,0,1,1
Sweden,Chile,2006,1,1,2
Tunisia,Uruguay,2006,0,0,0
Croatia,Poland,2006,0,1,1
Czech Republic,Trinidad and Tobago,2006,3,0,3
England,Jamaica,2006,6,0,6
Luxembourg,Portugal,2006,0,3,3
Macau,Hong Kong,2006,0,0,0
Malaysia,Singapore,2006,0,0,0
Republic of St. Pauli,Gibraltar,2006,1,2,3
Northern Cyprus,Zanzibar,2006,0,0,0
Spain,Egypt,2006,2,0,2
Switzerland,China PR,2006,4,1,5
Algeria,Sudan,2006,1,0,1
Brazil,New Zealand,2006,4,0,4
Colombia,Morocco,2006,2,0,2
Ghana,South Korea,2006,3,1,4
Japan,Malta,2006,1,0,1
Netherlands,Australia,2006,1,1,2
Slovenia,Ivory Coast,2006,0,3,3
Turkey,North Macedonia,2006,0,1,1
Ukraine,Libya,2006,3,0,3
Australia,Liechtenstein,2006,3,1,4
France,China PR,2006,3,1,4
Spain,Croatia,2006,2,1,3
Luxembourg,Ukraine,2006,0,3,3
Germany,Costa Rica,2006,4,2,6
Poland,Ecuador,2006,0,2,2
Argentina,Ivory Coast,2006,2,1,3
England,Paraguay,2006,1,0,1
Trinidad and Tobago,Sweden,2006,0,0,0
Angola,Portugal,2006,0,1,1
Mexico,Iran,2006,3,1,4
Serbia,Netherlands,2006,0,1,1
Australia,Japan,2006,3,1,4
Italy,Ghana,2006,2,0,2
United States,Czech Republic,2006,0,3,3
Brazil,Croatia,2006,1,0,1
France,Switzerland,2006,0,0,0
South Korea,Togo,2006,2,1,3
Germany,Poland,2006,1,0,1
Spain,Ukraine,2006,4,0,4
Tunisia,Saudi Arabia,2006,2,2,4
Ecuador,Costa Rica,2006,3,0,3
England,Trinidad and Tobago,2006,2,0,2
Sweden,Paraguay,2006,1,0,1
Argentina,Serbia,2006,6,0,6
Mexico,Angola,2006,0,0,0
Netherlands,Ivory Coast,2006,2,1,3
Czech Republic,Ghana,2006,0,2,2
Italy,United States,2006,1,1,2
Portugal,Iran,2006,2,0,2
Brazil,Australia,2006,2,0,2
France,South Korea,2006,1,1,2
Japan,Croatia,2006,0,0,0
Saudi Arabia,Ukraine,2006,0,4,4
Spain,Tunisia,2006,3,1,4
Togo,Switzerland,2006,0,2,2
Costa Rica,Poland,2006,1,2,3
Germany,Ecuador,2006,3,0,3
Paraguay,Trinidad and Tobago,2006,2,0,2
Sweden,England,2006,2,2,4
Iran,Angola,2006,1,1,2
Ivory Coast,Serbia,2006,3,2,5
Netherlands,Argentina,2006,0,0,0
Portugal,Mexico,2006,2,1,3
Croatia,Australia,2006,2,2,4
Czech Republic,Italy,2006,0,2,2
Ghana,United States,2006,2,1,3
Japan,Brazil,2006,1,4,5
Saudi Arabia,Spain,2006,0,1,1
Switzerland,South Korea,2006,2,0,2
Togo,France,2006,0,2,2
Ukraine,Tunisia,2006,1,0,1
Argentina,Mexico,2006,2,1,3
Germany,Sweden,2006,2,0,2
Malawi,Zimbabwe,2006,1,1,2
Mozambique,Eswatini,2006,4,0,4
England,Ecuador,2006,1,0,1
Mozambique,Malawi,2006,1,2,3
Portugal,Netherlands,2006,1,0,1
Eswatini,Zimbabwe,2006,1,2,3
Italy,Australia,2006,1,0,1
Mauritius,Tanzania,2006,1,2,3
Switzerland,Ukraine,2006,0,0,0
Brazil,Ghana,2006,3,0,3
Spain,France,2006,1,3,4
Seychelles,Mauritius,2006,2,1,3
Germany,Argentina,2006,1,1,2
Italy,Ukraine,2006,3,0,3
Seychelles,Tanzania,2006,2,1,3
Brazil,France,2006,0,1,1
England,Portugal,2006,0,0,0
Kazakhstan,Tajikistan,2006,4,1,5
Germany,Italy,2006,0,2,2
Kazakhstan,Kyrgyzstan,2006,1,0,1
Portugal,France,2006,0,1,1
Malawi,Botswana,2006,2,1,3
Germany,Portugal,2006,3,1,4
Malawi,Botswana,2006,0,0,0
Italy,France,2006,1,1,2
Syria,Iraq,2006,1,3,4
Zambia,Zimbabwe,2006,0,0,0
Ethiopia,Yemen,2006,1,0,1
Jordan,Iraq,2006,2,1,3
Malawi,Zambia,2006,1,3,4
Namibia,Seychelles,2006,1,1,2
Namibia,Malawi,2006,3,2,5
Seychelles,Zambia,2006,0,2,2
Syria,Iraq,2006,1,2,3
Rwanda,Uganda,2006,1,1,2
Guyana,Saint Lucia,2006,3,2,5
Guyana,Saint Lucia,2006,2,0,2
Jordan,Syria,2006,3,0,3
Tanzania,Rwanda,2006,1,0,1
Syria,Libya,2006,2,1,3
Uganda,Botswana,2006,0,0,0
Iran,United Arab Emirates,2006,1,0,1
Japan,Trinidad and Tobago,2006,2,0,2
Jordan,Iraq,2006,0,1,1
Macau,Taiwan,2006,0,1,1
Saudi Arabia,Bahrain,2006,1,0,1
Ethiopia,Kenya,2006,1,0,1
Hong Kong,Singapore,2006,1,2,3
Ethiopia,Kenya,2006,1,0,1
Algeria,Gabon,2006,0,2,2
Ghana,Togo,2006,2,0,2
Iceland,Spain,2006,0,0,0
Slovakia,Malta,2006,3,0,3
Slovenia,Israel,2006,1,1,2
Ukraine,Azerbaijan,2006,6,0,6
Wales,Bulgaria,2006,0,0,0
Australia,Kuwait,2006,2,0,2
Austria,Hungary,2006,1,2,3
Bangladesh,Qatar,2006,1,4,5
Belarus,Andorra,2006,3,0,3
Belgium,Kazakhstan,2006,0,0,0
Bosnia and Herzegovina,France,2006,1,2,3
Cameroon,Guinea,2006,1,1,2
Chile,Colombia,2006,1,2,3
China PR,Singapore,2006,1,0,1
Czech Republic,Serbia,2006,1,3,4
Denmark,Poland,2006,2,0,2
Egypt,Uruguay,2006,0,2,2
England,Greece,2006,4,0,4
Estonia,North Macedonia,2006,0,1,1
Faroe Islands,Georgia,2006,0,6,6
Finland,Northern Ireland,2006,1,2,3
Germany,Sweden,2006,3,0,3
Guatemala,Haiti,2006,1,1,2
India,Saudi Arabia,2006,0,3,3
Iran,Syria,2006,1,1,2
Republic of Ireland,Netherlands,2006,0,4,4
Italy,Croatia,2006,0,2,2
Ivory Coast,Senegal,2006,0,1,1
Japan,Yemen,2006,2,0,2
Jordan,United Arab Emirates,2006,1,2,3
Libya,Uganda,2006,3,2,5
Liechtenstein,Switzerland,2006,0,3,3
Luxembourg,Turkey,2006,0,1,1
Moldova,Lithuania,2006,3,2,5
Morocco,Burkina Faso,2006,1,0,1
Namibia,South Africa,2006,0,1,1
Norway,Brazil,2006,1,1,2
Pakistan,Oman,2006,1,4,5
Peru,Panama,2006,0,2,2
Romania,Cyprus,2006,2,0,2
Russia,Latvia,2006,1,0,1
San Marino,Albania,2006,0,3,3
Tunisia,Mali,2006,0,1,1
Uzbekistan,Hong Kong,2006,2,2,4
Venezuela,Honduras,2006,0,0,0
Palestine,Iraq,2006,0,3,3
Zambia,Botswana,2006,1,0,1
Malaysia,Indonesia,2006,1,1,2
Indonesia,Myanmar,2006,0,0,0
Eswatini,Lesotho,2006,3,1,4
Tanzania,Zanzibar,2006,1,0,1
Yemen,Libya,2006,0,1,1
Malaysia,Myanmar,2006,1,2,3
Saudi Arabia,United Arab Emirates,2006,1,0,1
Myanmar,Indonesia,2006,2,1,3
Togo,Niger,2006,1,1,2
Uganda,Burkina Faso,2006,0,0,0
Yemen,Libya,2006,1,1,2
Denmark,Portugal,2006,4,2,6
Oman,Syria,2006,3,0,3
Austria,Costa Rica,2006,2,2,4
Bahamas,Cayman Islands,2006,3,1,4
Bahrain,Jordan,2006,0,2,2
Belarus,Albania,2006,2,2,4
Cuba,Turks and Caicos Islands,2006,6,0,6
Czech Republic,Wales,2006,2,1,3
Egypt,Burundi,2006,4,1,5
England,Andorra,2006,5,0,5
Estonia,Israel,2006,0,1,1
Gabon,Madagascar,2006,4,0,4
Georgia,France,2006,0,3,3
Germany,Republic of Ireland,2006,1,0,1
Hungary,Norway,2006,1,4,5
Italy,Lithuania,2006,1,1,2
Kenya,Eritrea,2006,1,2,3
South Korea,Iran,2006,1,1,2
Latvia,Sweden,2006,0,1,1
Luxembourg,Netherlands,2006,0,1,1
Malta,Bosnia and Herzegovina,2006,2,5,7
Moldova,Greece,2006,0,1,1
Nigeria,Niger,2006,2,0,2
Northern Ireland,Iceland,2006,0,3,3
Poland,Finland,2006,1,3,4
Romania,Bulgaria,2006,2,2,4
Scotland,Faroe Islands,2006,6,0,6
Senegal,Mozambique,2006,2,0,2
Serbia,Azerbaijan,2006,1,0,1
Slovakia,Cyprus,2006,6,1,7
South Africa,Congo,2006,0,0,0
Spain,Liechtenstein,2006,4,0,4
Switzerland,Venezuela,2006,1,0,1
Tanzania,Burkina Faso,2006,2,1,3
Uganda,Lesotho,2006,3,0,3
Antigua and Barbuda,Dominica,2006,1,0,1
Argentina,Brazil,2006,0,3,3
Chad,Zambia,2006,0,2,2
DR Congo,Namibia,2006,3,2,5
Equatorial Guinea,Liberia,2006,2,1,3
Ethiopia,Libya,2006,1,0,1
Gambia,Cape Verde,2006,2,0,2
Guinea,Algeria,2006,0,0,0
Mauritius,Tunisia,2006,0,0,0
Rwanda,Cameroon,2006,0,3,3
Saudi Arabia,Japan,2006,1,0,1
Sierra Leone,Mali,2006,0,0,0
Sudan,Seychelles,2006,3,0,3
Eswatini,Angola,2006,0,2,2
Togo,Benin,2006,2,1,3
Canada,Jamaica,2006,1,0,1
Cayman Islands,Turks and Caicos Islands,2006,0,2,2
Cuba,Bahamas,2006,6,0,6
Wales,Brazil,2006,0,2,2
Albania,Romania,2006,0,2,2
Armenia,Belgium,2006,0,1,1
Austria,Venezuela,2006,0,1,1
Azerbaijan,Kazakhstan,2006,1,1,2
Bosnia and Herzegovina,Hungary,2006,1,3,4
Bulgaria,Slovenia,2006,3,0,3
Cuba,Cayman Islands,2006,7,0,7
Curaçao,Grenada,2006,1,1,2
Ecuador,Peru,2006,1,1,2
Finland,Portugal,2006,1,1,2
France,Italy,2006,3,1,4
Guatemala,Panama,2006,1,2,3
Honduras,El Salvador,2006,2,0,2
Hong Kong,Uzbekistan,2006,0,0,0
Iceland,Denmark,2006,0,2,2
Iraq,Palestine,2006,2,2,4
Israel,Andorra,2006,4,1,5
South Korea,Taiwan,2006,8,0,8
Kuwait,Australia,2006,2,0,2
Lithuania,Scotland,2006,1,2,3
Luxembourg,Latvia,2006,0,0,0
North Macedonia,England,2006,0,1,1
Netherlands,Belarus,2006,3,0,3
Northern Ireland,Spain,2006,3,2,5
Norway,Moldova,2006,2,0,2
Oman,Pakistan,2006,5,0,5
Poland,Serbia,2006,1,1,2
Qatar,Bangladesh,2006,3,0,3
Russia,Croatia,2006,0,0,0
San Marino,Germany,2006,0,13,13
Saudi Arabia,India,2006,7,1,8
Singapore,China PR,2006,0,0,0
Slovakia,Czech Republic,2006,0,3,3
Suriname,Guyana,2006,0,5,5
Sweden,Liechtenstein,2006,3,1,4
Switzerland,Costa Rica,2006,2,0,2
Turkey,Malta,2006,2,0,2
Turks and Caicos Islands,Bahamas,2006,2,3,5
Ukraine,Georgia,2006,3,2,5
United Arab Emirates,Jordan,2006,0,0,0
Yemen,Japan,2006,0,1,1
Curaçao,Guyana,2006,0,5,5
Suriname,Grenada,2006,1,0,1
Curaçao,Suriname,2006,0,1,1
Grenada,Guyana,2006,0,1,1
Haiti,Dominican Republic,2006,3,1,4
Dominica,Barbados,2006,0,5,5
Haiti,Dominican Republic,2006,2,1,3
Zimbabwe,Angola,2006,1,2,3
Antigua and Barbuda,Anguilla,2006,5,3,8
Barbados,Saint Kitts and Nevis,2006,1,1,2
Dominica,Martinique,2006,0,4,4
Guadeloupe,Saint Martin,2006,1,0,1
Anguilla,Saint Kitts and Nevis,2006,1,6,7
Antigua and Barbuda,Barbados,2006,1,3,4
Guadeloupe,Dominica,2006,1,0,1
Martinique,Saint Martin,2006,1,0,1
Antigua and Barbuda,Saint Kitts and Nevis,2006,1,0,1
Barbados,Anguilla,2006,7,1,8
Dominica,Saint Martin,2006,0,0,0
Guadeloupe,Martinique,2006,4,0,4
Jamaica,Saint Lucia,2006,4,0,4
Venezuela,Uruguay,2006,1,0,1
United States Virgin Islands,Bermuda,2006,0,6,6
Bermuda,Dominican Republic,2006,3,1,4
Saint Lucia,Haiti,2006,1,7,8
Tanzania,Kenya,2006,0,0,0
Jamaica,Haiti,2006,2,0,2
Libya,Sudan,2006,1,0,1
Saint Vincent and the Grenadines,Saint Lucia,2006,8,0,8
United States Virgin Islands,Dominican Republic,2006,1,6,7
Botswana,Lesotho,2006,1,0,1
Ethiopia,Eswatini,2006,2,0,2
Iran,Iraq,2006,2,0,2
Japan,Ghana,2006,0,1,1
Jordan,Iran,2006,0,0,0
Liechtenstein,Austria,2006,1,2,3
Algeria,Gambia,2006,1,0,1
Armenia,Finland,2006,0,0,0
Australia,Paraguay,2006,1,1,2
Botswana,Egypt,2006,0,0,0
Bulgaria,Netherlands,2006,1,1,2
Burkina Faso,Senegal,2006,1,0,1
Cameroon,Equatorial Guinea,2006,3,0,3
Cape Verde,Guinea,2006,1,0,1
Chile,Peru,2006,3,2,5
Croatia,Andorra,2006,7,0,7
Cyprus,Republic of Ireland,2006,5,2,7
Czech Republic,San Marino,2006,7,0,7
Denmark,Northern Ireland,2006,0,0,0
England,North Macedonia,2006,0,0,0
Eritrea,Eswatini,2006,0,0,0
Faroe Islands,Lithuania,2006,0,1,1
Germany,Georgia,2006,2,0,2
Greece,Norway,2006,1,0,1
Guatemala,Honduras,2006,2,3,5
Hungary,Turkey,2006,0,1,1
Italy,Ukraine,2006,2,0,2
Kazakhstan,Poland,2006,0,1,1
Latvia,Iceland,2006,4,0,4
Malawi,Zimbabwe,2006,1,0,1
Moldova,Bosnia and Herzegovina,2006,2,2,4
Namibia,Ethiopia,2006,1,0,1
Panama,El Salvador,2006,1,0,1
Portugal,Azerbaijan,2006,3,0,3
Romania,Belarus,2006,3,1,4
Russia,Israel,2006,1,1,2
Scotland,France,2006,1,0,1
Serbia,Belgium,2006,1,0,1
Seychelles,Mauritius,2006,2,1,3
Slovenia,Luxembourg,2006,2,0,2
Sweden,Spain,2006,2,0,2
Tunisia,Sudan,2006,1,0,1
Wales,Slovakia,2006,1,5,6
Angola,Kenya,2006,3,1,4
Benin,Sierra Leone,2006,2,0,2
Burundi,Mauritania,2006,3,1,4
Congo,Chad,2006,3,1,4
Ivory Coast,Gabon,2006,5,0,5
Jamaica,Canada,2006,2,1,3
South Korea,Ghana,2006,1,3,4
Lesotho,Nigeria,2006,0,1,1
Liberia,Rwanda,2006,3,2,5
Libya,DR Congo,2006,1,1,2
Mali,Togo,2006,1,0,1
Mozambique,Tanzania,2006,0,0,0
Niger,Uganda,2006,0,0,0
Zambia,South Africa,2006,0,1,1
Catalonia,Basque Country,2006,2,2,4
Brazil,Ecuador,2006,2,1,3
Honduras,Guatemala,2006,2,1,3
Andorra,North Macedonia,2006,0,3,3
Australia,Bahrain,2006,2,0,2
Austria,Switzerland,2006,2,1,3
Bangladesh,Uzbekistan,2006,0,4,4
Belarus,Slovenia,2006,4,2,6
Belgium,Azerbaijan,2006,3,0,3
Bosnia and Herzegovina,Greece,2006,0,4,4
Croatia,England,2006,2,0,2
France,Faroe Islands,2006,5,0,5
Georgia,Italy,2006,1,3,4
Iceland,Sweden,2006,1,2,3
India,Japan,2006,0,3,3
Iraq,Singapore,2006,4,2,6
Republic of Ireland,Czech Republic,2006,1,1,2
Kazakhstan,Finland,2006,0,2,2
South Korea,Syria,2006,1,1,2
Kuwait,Lithuania,2006,1,0,1
Liechtenstein,Denmark,2006,0,4,4
Luxembourg,Bulgaria,2006,0,1,1
Malta,Hungary,2006,2,1,3
Netherlands,Albania,2006,2,1,3
Northern Ireland,Latvia,2006,1,0,1
Oman,United Arab Emirates,2006,2,1,3
Pakistan,Jordan,2006,0,3,3
Palestine,China PR,2006,0,2,2
Peru,Chile,2006,0,1,1
Poland,Portugal,2006,2,1,3
Qatar,Hong Kong,2006,2,0,2
Russia,Estonia,2006,2,0,2
Saudi Arabia,Yemen,2006,5,0,5
Serbia,Armenia,2006,3,0,3
Slovakia,Germany,2006,1,4,5
Spain,Argentina,2006,2,1,3
Trinidad and Tobago,Panama,2006,2,1,3
Turkey,Moldova,2006,5,0,5
Ukraine,Scotland,2006,2,0,2
Wales,Cyprus,2006,3,1,4
Haiti,Cuba,2006,0,0,0
Uruguay,Venezuela,2006,4,0,4
Haiti,Cuba,2006,0,1,1
Zambia,Angola,2006,2,0,2
Saint Vincent and the Grenadines,Martinique,2006,1,1,2
Antigua and Barbuda,Grenada,2006,1,1,2
Barbados,Grenada,2006,2,2,4
Haiti,Cuba,2006,1,2,3
Martinique,Suriname,2006,1,0,1
Oman,Bahrain,2006,1,1,2
Saudi Arabia,Jordan,2006,2,1,3
Kuwait,Taiwan,2006,10,0,10
Cuba,Suriname,2006,3,1,4
Martinique,Haiti,2006,1,0,1
Singapore,Indonesia,2006,1,2,3
Haiti,Suriname,2006,1,1,2
Martinique,Cuba,2006,0,0,0
Philippines,Laos,2006,1,2,3
Australia,Ghana,2006,1,1,2
Cambodia,Laos,2006,2,2,4
Mali,Congo,2006,1,0,1
Philippines,Timor-Leste,2006,7,0,7
Wales,Liechtenstein,2006,4,0,4
Algeria,Burkina Faso,2006,1,2,3
Austria,Trinidad and Tobago,2006,4,1,5
Bahrain,Kuwait,2006,2,1,3
Belgium,Poland,2006,0,1,1
Bolivia,El Salvador,2006,4,1,5
Botswana,Eswatini,2006,1,0,1
Chile,Paraguay,2006,3,2,5
China PR,Iraq,2006,1,1,2
Cyprus,Germany,2006,1,1,2
Czech Republic,Denmark,2006,1,1,2
Egypt,South Africa,2006,1,0,1
Estonia,Belarus,2006,2,1,3
Finland,Armenia,2006,1,0,1
France,Greece,2006,1,0,1
Georgia,Uruguay,2006,2,0,2
Hong Kong,Bangladesh,2006,2,0,2
Hungary,Canada,2006,1,0,1
Iran,South Korea,2006,2,0,2
Republic of Ireland,San Marino,2006,5,0,5
Israel,Croatia,2006,3,4,7
Italy,Turkey,2006,1,1,2
Ivory Coast,Sweden,2006,1,0,1
Jamaica,Peru,2006,1,1,2
Japan,Saudi Arabia,2006,3,1,4
Jordan,Oman,2006,3,0,3
Luxembourg,Togo,2006,0,0,0
North Macedonia,Russia,2006,0,2,2
Malta,Lithuania,2006,1,4,5
Morocco,Gabon,2006,6,0,6
Netherlands,England,2006,1,1,2
Portugal,Kazakhstan,2006,3,0,3
Serbia,Norway,2006,1,1,2
Slovakia,Bulgaria,2006,3,1,4
Spain,Romania,2006,0,1,1
Switzerland,Brazil,2006,1,2,3
Syria,Taiwan,2006,3,0,3
Tunisia,Libya,2006,2,0,2
United Arab Emirates,Pakistan,2006,3,2,5
Uzbekistan,Qatar,2006,2,0,2
Venezuela,Guatemala,2006,2,1,3
Yemen,India,2006,2,1,3
Zimbabwe,Namibia,2006,3,2,5
Laos,Timor-Leste,2006,3,2,5
Philippines,Cambodia,2006,1,0,1
Tanzania,Angola,2006,1,1,2
Barbados,Bahamas,2006,2,1,3
Panama,Peru,2006,1,2,3
Găgăuzia,Greenland,2006,0,2,2
Kyrgyzstan,Zanzibar,2006,0,1,1
Tibet,Tajikistan,2006,0,3,3
Northern Cyprus,Crimea,2006,5,0,5
Cambodia,Timor-Leste,2006,4,1,5
Occitania,Sápmi,2006,0,7,7
Găgăuzia,Kyrgyzstan,2006,1,6,7
Greenland,Zanzibar,2006,1,1,2
Tibet,Crimea,2006,0,1,1
Northern Cyprus,Tajikistan,2006,5,1,6
Bahamas,Bermuda,2006,0,4,4
Occitania,Monaco,2006,2,3,5
Greenland,Kyrgyzstan,2006,0,1,1
Găgăuzia,Zanzibar,2006,1,1,2
Tajikistan,Crimea,2006,1,2,3
Northern Cyprus,Tibet,2006,10,0,10
Barbados,Bermuda,2006,1,1,2
Sápmi,Monaco,2006,14,0,14
Kyrgyzstan,Crimea,2006,2,3,5
Northern Cyprus,Zanzibar,2006,5,0,5
Dominican Republic,Guadeloupe,2006,0,3,3
Guyana,Antigua and Barbuda,2006,6,0,6
Sápmi,Monaco,2006,21,1,22
Ethiopia,Tanzania,2006,1,2,3
Kyrgyzstan,Zanzibar,2006,2,2,4
Northern Cyprus,Crimea,2006,3,1,4
Burundi,Zambia,2006,3,2,5
Djibouti,Malawi,2006,0,3,3
Dominican Republic,Antigua and Barbuda,2006,2,0,2
Guyana,Guadeloupe,2006,3,2,5
Somalia,Rwanda,2006,0,3,3
Sudan,Uganda,2006,1,2,3
Antigua and Barbuda,Guadeloupe,2006,1,3,4
Ethiopia,Djibouti,2006,4,0,4
Guyana,Dominican Republic,2006,4,0,4
Malawi,Tanzania,2006,1,2,3
El Salvador,Panama,2006,0,0,0
Zanzibar,Burundi,2006,0,0,0
Rwanda,Uganda,2006,0,1,1
Somalia,Sudan,2006,0,3,3
Ethiopia,Malawi,2006,1,0,1
Tanzania,Djibouti,2006,3,0,3
Zambia,Zanzibar,2006,4,0,4
Sudan,Rwanda,2006,0,0,0
Uganda,Somalia,2006,2,0,2
Ethiopia,Zambia,2006,0,1,1
Tanzania,Rwanda,2006,1,2,3
Burundi,Sudan,2006,0,1,1
Uganda,Malawi,2006,0,0,0
United Arab Emirates,Poland,2006,2,5,7
Rwanda,Zambia,2006,0,1,1
Uganda,Sudan,2006,2,2,4
Tanzania,DR Congo,2006,2,0,2
Silesia,Poland,2006,1,1,2
Rwanda,Uganda,2006,0,0,0
United Arab Emirates,Slovakia,2006,1,2,3
Zambia,Sudan,2006,0,0,0
Yemen,Comoros,2006,2,0,2
Réunion,Mayotte,2006,3,1,4
Djibouti,Comoros,2006,2,4,6
Yemen,Djibouti,2006,4,1,5
Lebanon,Mauritania,2006,0,0,0
Sudan,Somalia,2006,6,1,7
Lebanon,Somalia,2006,4,0,4
Singapore,Kazakhstan,2006,0,0,0
Sudan,Mauritania,2006,2,0,2
Thailand,Vietnam,2006,2,1,3
Thailand,Singapore,2006,2,0,2
Vietnam,Kazakhstan,2006,2,1,3
Lebanon,Sudan,2006,0,0,0
Somalia,Mauritania,2006,2,8,10
Basque Country,Serbia,2006,4,0,4
Martinique,Saint Vincent and the Grenadines,2006,2,2,4
Singapore,Vietnam,2006,2,3,5
Thailand,Kazakhstan,2006,2,2,4
Galicia,Ecuador,2006,1,1,2
Martinique,Saint Vincent and the Grenadines,2006,1,1,2
Thailand,Vietnam,2006,3,1,4
Martinique,Guadeloupe,2007,3,0,3
Haiti,Bermuda,2007,2,0,2
Singapore,Philippines,2007,4,1,5
Yemen,Eritrea,2007,4,1,5
Saudi Arabia,Gambia,2007,3,0,3
Bermuda,Haiti,2007,0,3,3
Costa Rica,Nicaragua,2007,2,0,2
Saudi Arabia,Syria,2007,2,1,3
Haiti,Martinique,2007,1,0,1
Malaysia,Philippines,2007,4,0,4
Thailand,Myanmar,2007,1,1,2
Trinidad and Tobago,Barbados,2007,1,1,2
Indonesia,Laos,2007,3,1,4
Qatar,Oman,2007,1,1,2
Singapore,Vietnam,2007,0,0,0
Cuba,Guadeloupe,2007,1,2,3
Malaysia,Myanmar,2007,0,0,0
Panama,Armenia,2007,1,1,2
Thailand,Philippines,2007,4,0,4
Venezuela,Sweden,2007,2,0,2
Haiti,Barbados,2007,2,0,2
Singapore,Laos,2007,11,0,11
Trinidad and Tobago,Martinique,2007,5,1,6
Vietnam,Indonesia,2007,1,1,2
Myanmar,Philippines,2007,0,0,0
Guadeloupe,Guyana,2007,3,4,7
Thailand,Malaysia,2007,1,0,1
Barbados,Martinique,2007,2,3,5
Kuwait,Yemen,2007,1,1,2
Singapore,Indonesia,2007,2,2,4
Trinidad and Tobago,Haiti,2007,3,1,4
United Arab Emirates,Oman,2007,1,2,3
Vietnam,Laos,2007,9,0,9
Cuba,Guyana,2007,0,0,0
Ecuador,Sweden,2007,2,1,3
Qatar,Iraq,2007,0,1,1
Saudi Arabia,Bahrain,2007,2,1,3
Saint Vincent and the Grenadines,Guadeloupe,2007,0,1,1
Guadeloupe,Haiti,2007,1,3,4
Kuwait,Oman,2007,1,2,3
Trinidad and Tobago,Cuba,2007,3,1,4
United Arab Emirates,Yemen,2007,2,1,3
Bahrain,Iraq,2007,1,1,2
Ecuador,Sweden,2007,1,1,2
Saudi Arabia,Qatar,2007,1,1,2
Cuba,Guadeloupe,2007,2,1,3
Malaysia,Singapore,2007,1,1,2
Oman,Yemen,2007,2,1,3
Trinidad and Tobago,Haiti,2007,1,2,3
United Arab Emirates,Kuwait,2007,3,2,5
Qatar,Bahrain,2007,1,2,3
Saudi Arabia,Iraq,2007,1,0,1
Vietnam,Thailand,2007,0,2,2
Zanzibar,Northern Cyprus,2007,2,1,3
Oman,Bahrain,2007,1,0,1
Singapore,Malaysia,2007,1,1,2
United Arab Emirates,Saudi Arabia,2007,1,0,1
Thailand,Vietnam,2007,0,0,0
United Arab Emirates,Oman,2007,1,0,1
Panama,Trinidad and Tobago,2007,2,1,3
Singapore,Thailand,2007,2,1,3
Poland,Estonia,2007,4,0,4
Costa Rica,Trinidad and Tobago,2007,4,0,4
Thailand,Singapore,2007,1,1,2
Australia,Denmark,2007,1,3,4
Botswana,Namibia,2007,1,0,1
Cyprus,Hungary,2007,2,1,3
Greece,South Korea,2007,0,1,1
Ivory Coast,Guinea,2007,1,0,1
Latvia,Bulgaria,2007,0,2,2
Lithuania,Mali,2007,1,3,4
Nigeria,Ghana,2007,1,4,5
Northern Ireland,Wales,2007,0,0,0
Portugal,Brazil,2007,2,0,2
Albania,North Macedonia,2007,0,1,1
Algeria,Libya,2007,2,1,3
Andorra,Armenia,2007,0,0,0
Belgium,Czech Republic,2007,0,2,2
China PR,Kazakhstan,2007,2,1,3
Colombia,Uruguay,2007,1,3,4
Croatia,Norway,2007,2,1,3
Cyprus,Bulgaria,2007,0,3,3
Egypt,Sweden,2007,2,0,2
England,Spain,2007,0,1,1
France,Argentina,2007,0,1,1
Georgia,Turkey,2007,1,0,1
Germany,Switzerland,2007,3,1,4
Iran,Belarus,2007,2,2,4
Israel,Ukraine,2007,1,1,2
Latvia,Hungary,2007,0,2,2
Luxembourg,Gambia,2007,2,1,3
Malta,Austria,2007,1,1,2
Morocco,Tunisia,2007,1,1,2
Netherlands,Russia,2007,4,1,5
Poland,Slovakia,2007,2,2,4
Romania,Moldova,2007,2,0,2
San Marino,Republic of Ireland,2007,1,2,3
Senegal,Benin,2007,2,1,3
Slovenia,Estonia,2007,1,0,1
Togo,Cameroon,2007,2,2,4
United States,Mexico,2007,2,0,2
Uzbekistan,Azerbaijan,2007,0,0,0
Venezuela,Chile,2007,0,1,1
El Salvador,Belize,2007,2,1,3
Guatemala,Nicaragua,2007,1,0,1
Costa Rica,Honduras,2007,3,1,4
El Salvador,Nicaragua,2007,2,1,3
Guatemala,Belize,2007,1,0,1
Honduras,Panama,2007,1,1,2
El Salvador,Guatemala,2007,0,0,0
Nicaragua,Belize,2007,4,2,6
Lesotho,Eswatini,2007,0,1,1
Panama,Costa Rica,2007,1,0,1
Nicaragua,Honduras,2007,1,9,10
El Salvador,Costa Rica,2007,0,2,2
Panama,Guatemala,2007,2,0,2
Costa Rica,Panama,2007,1,1,2
El Salvador,Guatemala,2007,0,1,1
Benin,Chad,2007,0,1,1
Mexico,Venezuela,2007,3,1,4
Azerbaijan,Uzbekistan,2007,1,0,1
Kazakhstan,Kyrgyzstan,2007,2,0,2
Kazakhstan,Azerbaijan,2007,1,0,1
Kyrgyzstan,Uzbekistan,2007,0,6,6
Azerbaijan,Kyrgyzstan,2007,1,0,1
Kazakhstan,Uzbekistan,2007,1,1,2
Eswatini,Lesotho,2007,0,1,1
Libya,Mauritania,2007,0,0,0
Mauritius,Ivory Coast,2007,0,3,3
Jamaica,Switzerland,2007,0,2,2
Albania,Slovenia,2007,0,0,0
Algeria,Cape Verde,2007,2,0,2
Austria,Ghana,2007,1,1,2
Brazil,Chile,2007,4,0,4
Burkina Faso,Mozambique,2007,1,1,2
Cameroon,Liberia,2007,3,1,4
Chad,South Africa,2007,0,3,3
China PR,Australia,2007,0,2,2
Costa Rica,New Zealand,2007,4,0,4
Croatia,North Macedonia,2007,2,1,3
Cyprus,Slovakia,2007,1,3,4
Czech Republic,Germany,2007,1,2,3
El Salvador,Honduras,2007,0,2,2
Estonia,Russia,2007,0,2,2
Faroe Islands,Ukraine,2007,0,2,2
Gambia,Guinea,2007,0,2,2
Greece,Turkey,2007,1,4,5
Guadeloupe,Trinidad and Tobago,2007,2,2,4
Haiti,Panama,2007,3,0,3
Republic of Ireland,Wales,2007,1,0,1
Israel,England,2007,0,0,0
Japan,Peru,2007,2,0,2
Kazakhstan,Serbia,2007,2,1,3
South Korea,Uruguay,2007,0,2,2
Liechtenstein,Northern Ireland,2007,1,4,5
Lithuania,France,2007,0,1,1
Luxembourg,Belarus,2007,1,2,3
Moldova,Malta,2007,1,1,2
Montenegro,Hungary,2007,2,1,3
Netherlands,Romania,2007,0,0,0
Nigeria,Uganda,2007,1,0,1
Norway,Bosnia and Herzegovina,2007,1,2,3
Poland,Azerbaijan,2007,5,0,5
Portugal,Belgium,2007,4,0,4
Qatar,Iran,2007,0,1,1
Scotland,Georgia,2007,2,1,3
Senegal,Tanzania,2007,4,0,4
Seychelles,Tunisia,2007,0,3,3
Spain,Denmark,2007,2,1,3
Togo,Sierra Leone,2007,3,1,4
Venezuela,Cuba,2007,3,1,4
Kernow,Guernsey,2007,1,1,2
Angola,Eritrea,2007,6,1,7
Barbados,Guatemala,2007,0,0,0
Bermuda,Canada,2007,0,3,3
Botswana,Burundi,2007,1,0,1
Colombia,Switzerland,2007,3,1,4
Congo,Zambia,2007,0,0,0
Egypt,Mauritania,2007,3,0,3
Equatorial Guinea,Rwanda,2007,3,1,4
Kenya,Eswatini,2007,2,0,2
Lesotho,Niger,2007,3,1,4
Libya,Namibia,2007,2,1,3
Madagascar,Ivory Coast,2007,0,3,3
Mali,Benin,2007,1,1,2
Mauritius,Sudan,2007,1,2,3
Mexico,Paraguay,2007,2,1,3
Northern Mariana Islands,Guam,2007,2,3,5
United States,Ecuador,2007,3,1,4
Zimbabwe,Morocco,2007,1,1,2
Jamaica,Panama,2007,1,1,2
Brazil,Ghana,2007,1,0,1
China PR,Uzbekistan,2007,3,1,4
El Salvador,Honduras,2007,0,2,2
Andorra,England,2007,0,3,3
Azerbaijan,Finland,2007,1,0,1
Bulgaria,Albania,2007,0,0,0
Chile,Costa Rica,2007,1,1,2
Colombia,Paraguay,2007,2,0,2
Czech Republic,Cyprus,2007,1,0,1
France,Austria,2007,1,0,1
Georgia,Faroe Islands,2007,3,1,4
Germany,Denmark,2007,0,1,1
Hungary,Moldova,2007,2,0,2
Republic of Ireland,Slovakia,2007,1,0,1
Israel,Estonia,2007,4,0,4
Italy,Scotland,2007,2,0,2
Liechtenstein,Latvia,2007,1,0,1
Malta,Greece,2007,0,1,1
Mexico,Ecuador,2007,4,2,6
Northern Ireland,Sweden,2007,2,1,3
Poland,Armenia,2007,1,0,1
Romania,Luxembourg,2007,3,0,3
Serbia,Portugal,2007,1,1,2
Slovenia,Netherlands,2007,0,1,1
South Africa,Bolivia,2007,0,1,1
Spain,Iceland,2007,1,0,1
Turkey,Norway,2007,2,2,4
Ukraine,Lithuania,2007,1,0,1
United States,Guatemala,2007,0,0,0
Venezuela,New Zealand,2007,5,0,5
Wales,San Marino,2007,3,0,3
Guam,Northern Mariana Islands,2007,9,0,9
Angola,Congo,2007,0,0,0
El Salvador,Haiti,2007,0,1,1
Argentina,Chile,2007,0,0,0
Honduras,Haiti,2007,1,3,4
Seychelles,Réunion,2007,2,0,2
Mauritius,Réunion,2007,1,1,2
Madagascar,Zimbabwe,2007,0,1,1
Mozambique,Seychelles,2007,2,0,2
DR Congo,Ethiopia,2007,2,0,2
Madagascar,Seychelles,2007,5,0,5
Mozambique,Zimbabwe,2007,0,0,0
Guernsey,Jersey,2007,0,0,0
Chile,Cuba,2007,3,0,3
Panama,Colombia,2007,0,4,4
Chile,Cuba,2007,2,0,2
Thailand,China PR,2007,1,0,1
Guadeloupe,Dominica,2007,2,0,2
Guadeloupe,Dominica,2007,0,0,0
Eritrea,Sudan,2007,1,0,1
Ecuador,Republic of Ireland,2007,1,1,2
Haiti,Chile,2007,0,0,0
Venezuela,Honduras,2007,2,1,3
Zimbabwe,Lesotho,2007,1,1,2
Bolivia,Republic of Ireland,2007,1,1,2
Eritrea,Sudan,2007,1,1,2
Malawi,South Africa,2007,0,0,0
Namibia,Zambia,2007,1,2,3
Eswatini,Mauritius,2007,0,0,0
Uganda,Tanzania,2007,1,1,2
Wales,New Zealand,2007,2,2,4
Botswana,Libya,2007,0,0,0
Kenya,Nigeria,2007,0,1,1
Mauritius,South Africa,2007,0,2,2
Rwanda,Burundi,2007,1,0,1
Eswatini,Malawi,2007,1,0,1
Congo,DR Congo,2007,2,1,3
Trinidad and Tobago,Haiti,2007,1,0,1
Zimbabwe,Burkina Faso,2007,1,1,2
Austria,Scotland,2007,0,1,1
Saint Vincent and the Grenadines,Haiti,2007,0,3,3
England,Brazil,2007,1,1,2
Ethiopia,DR Congo,2007,1,0,1
Indonesia,Hong Kong,2007,3,0,3
Japan,Montenegro,2007,2,0,2
Venezuela,Canada,2007,2,2,4
Albania,Luxembourg,2007,2,0,2
Australia,Uruguay,2007,1,2,3
Austria,Paraguay,2007,0,0,0
Azerbaijan,Poland,2007,1,3,4
Belarus,Bulgaria,2007,0,2,2
Belgium,Portugal,2007,1,2,3
Bosnia and Herzegovina,Turkey,2007,3,2,5
Cape Verde,Algeria,2007,2,2,4
Costa Rica,Chile,2007,2,0,2
Denmark,Sweden,2007,0,3,3
Eritrea,Angola,2007,1,1,2
Estonia,Croatia,2007,0,1,1
Faroe Islands,Italy,2007,1,2,3
Finland,Serbia,2007,0,2,2
France,Ukraine,2007,2,0,2
Germany,San Marino,2007,6,0,6
Greece,Hungary,2007,2,0,2
Honduras,Trinidad and Tobago,2007,3,1,4
Iceland,Liechtenstein,2007,1,1,2
Kazakhstan,Armenia,2007,1,2,3
South Korea,Netherlands,2007,0,2,2
Latvia,Spain,2007,0,2,2
Lithuania,Georgia,2007,1,0,1
North Macedonia,Israel,2007,1,2,3
Mexico,Iran,2007,4,0,4
Morocco,Zimbabwe,2007,2,0,2
Namibia,Libya,2007,1,0,1
Norway,Malta,2007,4,0,4
Russia,Andorra,2007,4,0,4
Rwanda,Equatorial Guinea,2007,2,0,2
Slovenia,Romania,2007,1,2,3
South Africa,Chad,2007,4,0,4
Sudan,Mauritius,2007,3,0,3
Switzerland,Argentina,2007,1,1,2
Tanzania,Senegal,2007,1,1,2
Tunisia,Seychelles,2007,4,0,4
Uganda,Nigeria,2007,2,1,3
United States,China PR,2007,4,1,5
Wales,Czech Republic,2007,0,0,0
Zambia,Congo,2007,3,0,3
Benin,Mali,2007,0,0,0
Burundi,Botswana,2007,1,0,1
Colombia,Montenegro,2007,1,0,1
Ecuador,Peru,2007,1,2,3
Guinea,Gambia,2007,2,2,4
Ivory Coast,Madagascar,2007,5,0,5
Liberia,Cameroon,2007,1,2,3
Mauritania,Egypt,2007,1,1,2
Mozambique,Burkina Faso,2007,3,0,3
Niger,Lesotho,2007,2,0,2
Sierra Leone,Togo,2007,0,1,1
Eswatini,Kenya,2007,0,0,0
Algeria,Argentina,2007,3,4,7
Jamaica,Chile,2007,0,1,1
Japan,Colombia,2007,0,0,0
Kuwait,Portugal,2007,1,1,2
Mexico,Paraguay,2007,0,1,1
Turkey,Brazil,2007,0,0,0
Andorra,Israel,2007,0,2,2
Armenia,Poland,2007,1,0,1
Bosnia and Herzegovina,Malta,2007,1,0,1
Bulgaria,Belarus,2007,2,1,3
Costa Rica,Canada,2007,1,2,3
Croatia,Russia,2007,0,0,0
Ecuador,Peru,2007,2,0,2
Estonia,England,2007,0,3,3
Faroe Islands,Scotland,2007,0,2,2
Finland,Belgium,2007,2,0,2
France,Georgia,2007,1,0,1
Germany,Slovakia,2007,2,1,3
Greece,Moldova,2007,2,1,3
Guadeloupe,Haiti,2007,1,1,2
Kazakhstan,Azerbaijan,2007,1,1,2
Latvia,Denmark,2007,0,2,2
Liechtenstein,Spain,2007,0,2,2
Lithuania,Italy,2007,0,2,2
Luxembourg,Albania,2007,0,3,3
Norway,Hungary,2007,4,0,4
Romania,Slovenia,2007,2,0,2
Sweden,Iceland,2007,5,0,5
Thailand,Netherlands,2007,1,3,4
El Salvador,Trinidad and Tobago,2007,2,1,3
United States,Guatemala,2007,1,0,1
Jordan,Iraq,2007,1,1,2
Mexico,Cuba,2007,2,1,3
Panama,Honduras,2007,3,2,5
Burkina Faso,Mali,2007,0,1,1
Canada,Guadeloupe,2007,1,2,3
Guatemala,El Salvador,2007,1,0,1
Haiti,Costa Rica,2007,1,1,2
Tanzania,Zambia,2007,1,1,2
United States,Trinidad and Tobago,2007,2,0,2
Honduras,Mexico,2007,2,1,3
Hong Kong,Macau,2007,2,1,3
Kenya,Rwanda,2007,2,0,2
Malawi,Senegal,2007,2,3,5
Panama,Cuba,2007,2,2,4
Costa Rica,Guadeloupe,2007,1,0,1
Haiti,Canada,2007,0,2,2
Jordan,Iraq,2007,0,0,0
Kuwait,Egypt,2007,1,1,2
Réunion,Gabon,2007,0,3,3
Trinidad and Tobago,Guatemala,2007,1,1,2
United States,El Salvador,2007,4,0,4
Cuba,Honduras,2007,0,5,5
Mexico,Panama,2007,1,0,1
Algeria,Guinea,2007,0,2,2
Botswana,Mauritania,2007,2,1,3
Burkina Faso,Tanzania,2007,0,1,1
Canada,Guatemala,2007,3,0,3
Cape Verde,Gambia,2007,0,0,0
Eritrea,Kenya,2007,1,0,1
Iran,Iraq,2007,0,0,0
Lebanon,Syria,2007,0,1,1
Malawi,Morocco,2007,0,1,1
Namibia,DR Congo,2007,1,1,2
Seychelles,Sudan,2007,0,2,2
Tunisia,Mauritius,2007,2,0,2
United States,Panama,2007,2,1,3
Zambia,Chad,2007,1,1,2
Angola,Eswatini,2007,3,0,3
Benin,Togo,2007,4,1,5
Cameroon,Rwanda,2007,2,1,3
Congo,South Africa,2007,1,1,2
Guam,Taiwan,2007,0,10,10
Honduras,Guadeloupe,2007,1,2,3
Liberia,Equatorial Guinea,2007,0,0,0
Libya,Ethiopia,2007,3,1,4
Macau,Mongolia,2007,0,0,0
Madagascar,Gabon,2007,0,2,2
Mali,Sierra Leone,2007,6,0,6
Mexico,Costa Rica,2007,1,0,1
Mozambique,Senegal,2007,0,0,0
Niger,Nigeria,2007,1,3,4
Jordan,Syria,2007,0,1,1
Malaysia,Cambodia,2007,6,0,6
Palestine,Iraq,2007,0,1,1
Hong Kong,Taiwan,2007,1,1,2
North Korea,Mongolia,2007,7,0,7
Lesotho,Uganda,2007,0,0,0
Bolivia,Paraguay,2007,0,0,0
Iran,Palestine,2007,2,0,2
Jordan,Lebanon,2007,3,0,3
Venezuela,Basque Country,2007,3,4,7
Hong Kong,Guam,2007,15,1,16
Indonesia,Jamaica,2007,2,1,3
Macau,North Korea,2007,1,7,8
Malaysia,United Arab Emirates,2007,1,3,4
Mexico,Guadeloupe,2007,1,0,1
United States,Canada,2007,2,1,3
Jordan,Iran,2007,0,1,1
Syria,Iraq,2007,0,3,3
Colombia,Ecuador,2007,3,1,4
Mongolia,Guam,2007,5,2,7
Indonesia,Oman,2007,0,1,1
Iraq,Iran,2007,1,2,3
North Korea,Hong Kong,2007,1,0,1
United Arab Emirates,Saudi Arabia,2007,0,2,2
United States,Mexico,2007,2,1,3
Vietnam,Jamaica,2007,3,0,3
Qatar,Turkmenistan,2007,1,0,1
Uruguay,Peru,2007,0,3,3
Venezuela,Bolivia,2007,2,2,4
Brazil,Mexico,2007,0,2,2
Ecuador,Chile,2007,2,3,5
Singapore,Saudi Arabia,2007,1,2,3
United Arab Emirates,Bahrain,2007,2,2,4
Argentina,United States,2007,4,1,5
Malaysia,Jamaica,2007,0,2,2
Oman,North Korea,2007,2,2,4
Paraguay,Colombia,2007,5,0,5
South Korea,Iraq,2007,3,0,3
Bolivia,Uruguay,2007,0,1,1
Singapore,Australia,2007,0,3,3
Thailand,Qatar,2007,1,1,2
Venezuela,Peru,2007,2,0,2
Vietnam,Bahrain,2007,5,3,8
Menorca,Jersey,2007,0,1,1
Bermuda,Ynys Môn,2007,1,2,3
Rhodes,Saare County,2007,2,0,2
Brazil,Chile,2007,3,0,3
Mexico,Ecuador,2007,2,1,3
Oman,Saudi Arabia,2007,1,1,2
United Arab Emirates,North Korea,2007,1,0,1
Jersey,Gibraltar,2007,1,1,2
Åland Islands,Bermuda,2007,0,2,2
Rhodes,Frøya,2007,3,1,4
Western Isles,Gotland,2007,2,1,3
Argentina,Colombia,2007,4,2,6
Iran,Jamaica,2007,8,1,9
Iraq,Uzbekistan,2007,0,2,2
Thailand,Qatar,2007,2,0,2
United States,Paraguay,2007,1,3,4
Gibraltar,Menorca,2007,2,1,3
Ynys Môn,Åland Islands,2007,0,2,2
Saare County,Frøya,2007,2,3,5
Gotland,Western Isles,2007,1,3,4
Peru,Bolivia,2007,2,2,4
Venezuela,Uruguay,2007,0,0,0
Brazil,Ecuador,2007,1,0,1
Mexico,Chile,2007,0,0,0
Saudi Arabia,North Korea,2007,1,1,2
Menorca,Ynys Môn,2007,6,1,7
Jersey,Åland Islands,2007,1,0,1
Frøya,Gotland,2007,0,3,3
Gibraltar,Bermuda,2007,2,0,2
Rhodes,Western Isles,2007,1,0,1
Argentina,Paraguay,2007,1,0,1
Colombia,United States,2007,1,0,1
South Korea,Uzbekistan,2007,2,1,3
Menorca,Saare County,2007,4,1,5
Åland Islands,Frøya,2007,3,1,4
Jersey,Gotland,2007,1,0,1
Bermuda,Western Isles,2007,0,1,1
Rhodes,Gibraltar,2007,0,4,4
Malawi,Namibia,2007,1,2,3
Chile,Brazil,2007,1,6,7
Thailand,Iraq,2007,1,1,2
Venezuela,Uruguay,2007,1,4,5
Argentina,Peru,2007,4,0,4
Australia,Oman,2007,1,1,2
Mexico,Paraguay,2007,6,0,6
Vietnam,United Arab Emirates,2007,2,0,2
Japan,Qatar,2007,1,1,2
Indonesia,Bahrain,2007,2,1,3
Malaysia,China PR,2007,1,5,6
Uruguay,Brazil,2007,2,2,4
Iran,Uzbekistan,2007,2,1,3
South Korea,Saudi Arabia,2007,1,1,2
Mexico,Argentina,2007,0,3,3
Thailand,Oman,2007,2,0,2
Vietnam,Qatar,2007,1,1,2
Iraq,Australia,2007,3,1,4
Solomon Islands,Papua New Guinea,2007,2,1,3
United Arab Emirates,Japan,2007,1,3,4
Indonesia,Saudi Arabia,2007,1,2,3
Malaysia,Uzbekistan,2007,0,5,5
Mexico,Uruguay,2007,3,1,4
Bahrain,South Korea,2007,2,1,3
Brazil,Argentina,2007,3,0,3
China PR,Iran,2007,2,2,4
Oman,Iraq,2007,0,0,0
Qatar,United Arab Emirates,2007,1,2,3
Thailand,Australia,2007,0,4,4
Vietnam,Japan,2007,1,4,5
New Caledonia,Vanuatu,2007,5,3,8
Indonesia,South Korea,2007,0,1,1
Malaysia,Iran,2007,0,2,2
Saudi Arabia,Bahrain,2007,4,0,4
Uzbekistan,China PR,2007,3,0,3
Madagascar,Mayotte,2007,2,2,4
New Caledonia,Vanuatu,2007,0,2,2
Iraq,Vietnam,2007,2,0,2
Japan,Australia,2007,1,1,2
Iran,South Korea,2007,0,0,0
Saudi Arabia,Uzbekistan,2007,2,1,3
Botswana,Zambia,2007,0,0,0
Iraq,South Korea,2007,0,0,0
Japan,Saudi Arabia,2007,2,3,5
Angola,Lesotho,2007,2,0,2
Botswana,Namibia,2007,1,0,1
South Korea,Japan,2007,0,0,0
Botswana,Angola,2007,0,0,0
Iraq,Saudi Arabia,2007,1,0,1
Lesotho,Namibia,2007,2,3,5
Madagascar,DR Congo,2007,0,0,0
India,Cambodia,2007,6,0,6
Bangladesh,Syria,2007,0,2,2
Kyrgyzstan,Cambodia,2007,4,3,7
Myanmar,Lesotho,2007,1,0,1
India,Bangladesh,2007,1,0,1
Mozambique,Zimbabwe,2007,0,0,0
Singapore,Zimbabwe,2007,4,2,6
Benin,Gabon,2007,2,2,4
Ghana,Senegal,2007,1,1,2
Syria,Kyrgyzstan,2007,4,1,5
Albania,Malta,2007,3,0,3
Algeria,Brazil,2007,0,2,2
Armenia,Portugal,2007,1,1,2
Austria,Czech Republic,2007,1,1,2
Bangladesh,Cambodia,2007,1,1,2
Belarus,Israel,2007,2,1,3
Belgium,Serbia,2007,3,2,5
Bosnia and Herzegovina,Croatia,2007,3,5,8
Bulgaria,Wales,2007,0,1,1
DR Congo,Angola,2007,3,1,4
Costa Rica,Peru,2007,1,1,2
Denmark,Republic of Ireland,2007,0,4,4
Ecuador,Bolivia,2007,1,0,1
El Salvador,Honduras,2007,2,0,2
England,Germany,2007,1,2,3
Estonia,Andorra,2007,2,1,3
Finland,Kazakhstan,2007,2,1,3
Greece,Spain,2007,2,3,5
Hungary,Italy,2007,3,1,4
Iceland,Canada,2007,1,1,2
Ivory Coast,Egypt,2007,0,0,0
Japan,Cameroon,2007,2,0,2
Latvia,Moldova,2007,1,2,3
Lesotho,Laos,2007,3,1,4
Lithuania,Turkmenistan,2007,2,1,3
Luxembourg,Georgia,2007,0,0,0
North Macedonia,Nigeria,2007,0,0,0
Mali,Burkina Faso,2007,3,2,5
Mexico,Colombia,2007,0,1,1
Montenegro,Slovenia,2007,1,1,2
Northern Ireland,Liechtenstein,2007,3,1,4
Norway,Argentina,2007,2,1,3
Panama,Guatemala,2007,2,1,3
Paraguay,Venezuela,2007,1,1,2
Romania,Turkey,2007,2,0,2
Russia,Poland,2007,2,2,4
San Marino,Cyprus,2007,0,1,1
Scotland,South Africa,2007,1,0,1
Slovakia,France,2007,0,1,1
Sudan,Libya,2007,1,0,1
Sweden,United States,2007,1,0,1
Switzerland,Netherlands,2007,2,1,3
Tajikistan,Azerbaijan,2007,2,3,5
Togo,Zambia,2007,3,1,4
Tunisia,Guinea,2007,1,1,2
Ukraine,Uzbekistan,2007,2,1,3
India,Syria,2007,2,3,5
Singapore,Bangladesh,2007,4,2,6
Bangladesh,Kyrgyzstan,2007,0,3,3
Zimbabwe,Bangladesh,2007,2,1,3
Myanmar,Laos,2007,1,0,1
Cambodia,Syria,2007,1,5,6
Fiji,Tuvalu,2007,16,0,16
Samoa,Vanuatu,2007,0,4,4
Solomon Islands,American Samoa,2007,12,1,13
Tahiti,New Caledonia,2007,0,1,1
India,Kyrgyzstan,2007,3,0,3
Zimbabwe,Myanmar,2007,1,3,4
Fiji,Cook Islands,2007,4,0,4
Samoa,American Samoa,2007,7,0,7
Solomon Islands,Tonga,2007,4,0,4
Tuvalu,New Caledonia,2007,0,1,1
American Samoa,Vanuatu,2007,0,15,15
India,Syria,2007,1,0,1
New Caledonia,Cook Islands,2007,3,0,3
Samoa,Tonga,2007,2,1,3
Tuvalu,Tahiti,2007,1,1,2
Cook Islands,Tuvalu,2007,4,1,5
Tahiti,Fiji,2007,0,4,4
Tanzania,Uganda,2007,1,0,1
Tonga,American Samoa,2007,4,0,4
Vanuatu,Solomon Islands,2007,0,2,2
Cook Islands,Tahiti,2007,0,1,1
New Caledonia,Fiji,2007,1,1,2
Samoa,Solomon Islands,2007,0,3,3
Tonga,Vanuatu,2007,1,4,5
Fiji,Vanuatu,2007,3,0,3
Solomon Islands,New Caledonia,2007,2,3,5
Austria,Japan,2007,0,0,0
Bahrain,Jordan,2007,1,3,4
New Caledonia,Fiji,2007,1,0,1
Solomon Islands,Vanuatu,2007,0,2,2
Switzerland,Chile,2007,2,1,3
Belarus,Romania,2007,1,3,4
DR Congo,Libya,2007,1,1,2
Croatia,Estonia,2007,2,0,2
Cyprus,Armenia,2007,3,1,4
Ecuador,El Salvador,2007,5,1,6
England,Israel,2007,3,0,3
Ethiopia,Namibia,2007,2,3,5
Gabon,Ivory Coast,2007,0,0,0
Georgia,Ukraine,2007,1,1,2
Hungary,Bosnia and Herzegovina,2007,1,0,1
Iceland,Spain,2007,1,1,2
Italy,France,2007,0,0,0
Kazakhstan,Tajikistan,2007,1,1,2
Kenya,Angola,2007,2,1,3
Latvia,Northern Ireland,2007,1,0,1
Luxembourg,Slovenia,2007,0,3,3
Malta,Turkey,2007,2,2,4
Moldova,Norway,2007,0,1,1
Morocco,Ghana,2007,0,2,2
Netherlands,Bulgaria,2007,2,0,2
Nigeria,Lesotho,2007,2,0,2
Peru,Colombia,2007,2,2,4
Portugal,Poland,2007,2,2,4
Russia,North Macedonia,2007,3,0,3
Rwanda,Liberia,2007,4,0,4
San Marino,Czech Republic,2007,0,3,3
Scotland,Lithuania,2007,3,1,4
Senegal,Burkina Faso,2007,5,1,6
Serbia,Finland,2007,0,0,0
Slovakia,Republic of Ireland,2007,2,2,4
Sweden,Denmark,2007,0,0,0
Tanzania,Mozambique,2007,0,1,1
Uganda,Niger,2007,3,1,4
Venezuela,Paraguay,2007,3,2,5
Wales,Germany,2007,0,2,2
Burundi,Egypt,2007,0,0,0
Chad,Congo,2007,1,1,2
Costa Rica,Honduras,2007,0,0,0
Equatorial Guinea,Cameroon,2007,1,0,1
Gambia,Algeria,2007,2,1,3
Guinea,Cape Verde,2007,4,0,4
Mauritius,Seychelles,2007,1,1,2
Mexico,Panama,2007,1,0,1
South Africa,Zambia,2007,1,3,4
Sudan,Tunisia,2007,3,2,5
Eswatini,Eritrea,2007,0,0,0
United States,Brazil,2007,2,4,6
Zimbabwe,Malawi,2007,3,1,4
Australia,Argentina,2007,0,1,1
Austria,Chile,2007,0,2,2
Saudi Arabia,Ghana,2007,5,0,5
Switzerland,Japan,2007,3,4,7
Albania,Netherlands,2007,0,1,1
Andorra,Croatia,2007,0,6,6
Azerbaijan,Georgia,2007,1,1,2
Bosnia and Herzegovina,Moldova,2007,0,1,1
Bulgaria,Luxembourg,2007,3,0,3
Canada,Costa Rica,2007,1,1,2
Colombia,Paraguay,2007,1,0,1
Cyprus,San Marino,2007,3,0,3
Czech Republic,Republic of Ireland,2007,1,0,1
Denmark,Liechtenstein,2007,4,0,4
England,Russia,2007,3,0,3
Finland,Poland,2007,0,0,0
France,Scotland,2007,0,1,1
Germany,Romania,2007,3,1,4
Honduras,Ecuador,2007,2,1,3
Iceland,Northern Ireland,2007,2,1,3
Kazakhstan,Belgium,2007,2,2,4
Lithuania,Faroe Islands,2007,2,1,3
North Macedonia,Estonia,2007,1,1,2
Malta,Armenia,2007,0,1,1
Mexico,Brazil,2007,1,3,4
Montenegro,Sweden,2007,1,2,3
Norway,Greece,2007,2,2,4
Peru,Bolivia,2007,2,0,2
Portugal,Serbia,2007,1,1,2
Singapore,United Arab Emirates,2007,1,1,2
Slovakia,Wales,2007,2,5,7
Slovenia,Belarus,2007,1,0,1
South Africa,Uruguay,2007,0,0,0
Spain,Latvia,2007,2,0,2
Turkey,Hungary,2007,3,0,3
Ukraine,Italy,2007,1,2,3
Venezuela,Panama,2007,1,1,2
Qatar,Oman,2007,1,1,2
United Arab Emirates,Lebanon,2007,1,1,2
Mozambique,Zambia,2007,0,3,3
South Africa,Botswana,2007,1,0,1
Oman,Maldives,2007,1,0,1
Thailand,United Arab Emirates,2007,1,1,2
Bahrain,Singapore,2007,3,1,4
Bangladesh,Tajikistan,2007,1,1,2
Lebanon,India,2007,4,1,5
Oman,Nepal,2007,2,0,2
Palestine,Singapore,2007,0,4,4
Syria,Afghanistan,2007,3,0,3
Thailand,Macau,2007,6,1,7
Vietnam,United Arab Emirates,2007,0,1,1
Yemen,Maldives,2007,3,0,3
Cambodia,Turkmenistan,2007,0,1,1
Sierra Leone,Benin,2007,0,2,2
Togo,Mali,2007,0,2,2
Argentina,Chile,2007,2,0,2
Armenia,Serbia,2007,0,0,0
Azerbaijan,Portugal,2007,0,2,2
Belarus,Luxembourg,2007,0,1,1
Belgium,Finland,2007,0,0,0
Croatia,Israel,2007,1,0,1
Cyprus,Wales,2007,3,1,4
Denmark,Spain,2007,1,3,4
Ecuador,Venezuela,2007,0,1,1
Egypt,Botswana,2007,1,0,1
El Salvador,Costa Rica,2007,2,2,4
England,Estonia,2007,3,0,3
Faroe Islands,France,2007,0,6,6
Greece,Bosnia and Herzegovina,2007,3,2,5
Hungary,Malta,2007,2,0,2
Iceland,Latvia,2007,2,4,6
Republic of Ireland,Germany,2007,0,0,0
Italy,Georgia,2007,2,0,2
Liechtenstein,Sweden,2007,0,3,3
Mauritania,Burundi,2007,2,1,3
Moldova,Turkey,2007,1,1,2
Peru,Paraguay,2007,0,0,0
Poland,Kazakhstan,2007,3,1,4
Romania,Netherlands,2007,1,0,1
Scotland,Ukraine,2007,3,1,4
Slovakia,San Marino,2007,7,0,7
Slovenia,Albania,2007,0,0,0
Switzerland,Austria,2007,3,1,4
Uruguay,Bolivia,2007,5,0,5
Uzbekistan,Taiwan,2007,9,0,9
Colombia,Brazil,2007,0,0,0
Honduras,Panama,2007,1,0,1
Madagascar,Comoros,2007,6,2,8
Mexico,Nigeria,2007,2,2,4
Senegal,Guinea,2007,3,1,4
Macau,Thailand,2007,1,7,8
Bahrain,Libya,2007,2,0,2
Croatia,Slovakia,2007,3,0,3
Qatar,Iraq,2007,3,2,5
Venezuela,Argentina,2007,0,2,2
Albania,Bulgaria,2007,1,1,2
Austria,Ivory Coast,2007,3,2,5
Azerbaijan,Serbia,2007,1,6,7
Belgium,Armenia,2007,3,0,3
Bolivia,Colombia,2007,0,0,0
Bosnia and Herzegovina,Norway,2007,0,2,2
Brazil,Ecuador,2007,5,0,5
Chile,Peru,2007,2,0,2
Costa Rica,Haiti,2007,1,1,2
Denmark,Latvia,2007,3,1,4
El Salvador,Trinidad and Tobago,2007,0,0,0
Estonia,Montenegro,2007,0,1,1
Fiji,New Zealand,2007,0,2,2
Finland,Spain,2007,0,0,0
France,Lithuania,2007,2,0,2
Georgia,Scotland,2007,2,0,2
Germany,Czech Republic,2007,0,3,3
Republic of Ireland,Cyprus,2007,1,1,2
Israel,Belarus,2007,2,1,3
Italy,South Africa,2007,2,0,2
Japan,Egypt,2007,4,1,5
Kazakhstan,Portugal,2007,1,2,3
Liechtenstein,Iceland,2007,3,0,3
Luxembourg,Romania,2007,0,2,2
North Macedonia,Andorra,2007,3,0,3
Malta,Moldova,2007,2,3,5
Mexico,Guatemala,2007,2,3,5
Morocco,Namibia,2007,2,0,2
Netherlands,Slovenia,2007,2,0,2
Paraguay,Uruguay,2007,1,0,1
Poland,Hungary,2007,0,1,1
Russia,England,2007,2,1,3
San Marino,Wales,2007,1,2,3
Sierra Leone,Guinea-Bissau,2007,1,0,1
Sweden,Northern Ireland,2007,1,1,2
Switzerland,United States,2007,0,1,1
Turkey,Greece,2007,0,1,1
Ukraine,Faroe Islands,2007,5,0,5
United Arab Emirates,Tunisia,2007,0,1,1
Kyrgyzstan,Jordan,2007,2,0,2
Bahrain,Malaysia,2007,4,1,5
China PR,Myanmar,2007,7,0,7
Timor-Leste,Hong Kong,2007,2,3,5
Mongolia,North Korea,2007,1,4,5
Sri Lanka,Qatar,2007,0,1,1
Pakistan,Iraq,2007,0,7,7
South Africa,Zambia,2007,0,0,0
Afghanistan,Syria,2007,1,2,3
Myanmar,China PR,2007,0,4,4
Hong Kong,Timor-Leste,2007,8,1,9
Iraq,Pakistan,2007,0,0,0
Jordan,Kyrgyzstan,2007,2,0,2
North Korea,Mongolia,2007,5,1,6
Malaysia,Bahrain,2007,0,0,0
Maldives,Yemen,2007,2,0,2
Nepal,Oman,2007,0,2,2
Qatar,Sri Lanka,2007,5,0,5
Tajikistan,Bangladesh,2007,5,0,5
Turkmenistan,Cambodia,2007,4,1,5
United Arab Emirates,Vietnam,2007,5,0,5
India,Lebanon,2007,2,2,4
Bhutan,Tibet,2007,3,0,3
Saudi Arabia,Namibia,2007,1,0,1
Indonesia,Syria,2007,1,4,5
Saudi Arabia,Estonia,2007,2,0,2
Singapore,Tajikistan,2007,2,0,2
Yemen,Thailand,2007,1,1,2
Hong Kong,Turkmenistan,2007,0,0,0
Saint Martin,British Virgin Islands,2007,0,1,1
French Guiana,Guadeloupe,2007,2,3,5
Austria,England,2007,0,1,1
Djibouti,Somalia,2007,1,0,1
France,Morocco,2007,2,2,4
Qatar,Georgia,2007,1,2,3
Albania,Belarus,2007,2,4,6
Andorra,Estonia,2007,0,2,2
Angola,Ivory Coast,2007,2,1,3
Argentina,Bolivia,2007,3,0,3
Australia,Nigeria,2007,1,0,1
Benin,United Arab Emirates,2007,1,0,1
Bulgaria,Romania,2007,1,0,1
Colombia,Venezuela,2007,1,0,1
Comoros,Madagascar,2007,0,4,4
Czech Republic,Slovakia,2007,3,1,4
Fiji,New Caledonia,2007,3,3,6
Finland,Azerbaijan,2007,2,1,3
Germany,Cyprus,2007,4,0,4
Greece,Malta,2007,5,0,5
Guatemala,Honduras,2007,0,1,1
Guinea-Bissau,Sierra Leone,2007,0,0,0
Israel,Russia,2007,2,1,3
Latvia,Liechtenstein,2007,4,1,5
Lithuania,Ukraine,2007,2,0,2
North Macedonia,Croatia,2007,2,0,2
Moldova,Hungary,2007,3,0,3
Netherlands,Luxembourg,2007,1,0,1
Northern Ireland,Denmark,2007,2,1,3
Norway,Turkey,2007,1,2,3
Paraguay,Ecuador,2007,5,1,6
Poland,Belgium,2007,2,0,2
Portugal,Armenia,2007,1,0,1
Scotland,Italy,2007,1,2,3
Senegal,Mali,2007,3,2,5
South Africa,United States,2007,0,1,1
Spain,Sweden,2007,3,0,3
Tunisia,Namibia,2007,2,0,2
Vanuatu,New Zealand,2007,1,2,3
Wales,Republic of Ireland,2007,2,2,4
Ghana,Togo,2007,2,0,2
Jamaica,El Salvador,2007,3,0,3
Peru,Brazil,2007,1,1,2
Saint Kitts and Nevis,Antigua and Barbuda,2007,3,0,3
Eswatini,Malawi,2007,0,3,3
Syria,Indonesia,2007,7,0,7
Tajikistan,Singapore,2007,1,1,2
Thailand,Yemen,2007,1,0,1
Turkmenistan,Hong Kong,2007,3,0,3
Uruguay,Chile,2007,2,2,4
Algeria,Mali,2007,3,2,5
Angola,Guinea,2007,0,3,3
Colombia,Argentina,2007,2,1,3
South Africa,Canada,2007,2,0,2
Switzerland,Nigeria,2007,0,1,1
Venezuela,Bolivia,2007,5,3,8
Andorra,Russia,2007,0,1,1
Armenia,Kazakhstan,2007,0,1,1
Austria,Tunisia,2007,0,0,0
Azerbaijan,Belgium,2007,0,1,1
Belarus,Netherlands,2007,2,1,3
Brazil,Uruguay,2007,2,1,3
Chile,Paraguay,2007,0,3,3
Cyprus,Czech Republic,2007,0,2,2
Denmark,Iceland,2007,3,0,3
Ecuador,Peru,2007,5,1,6
England,Croatia,2007,2,3,5
Equatorial Guinea,Niger,2007,1,1,2
Georgia,Lithuania,2007,0,2,2
Germany,Wales,2007,0,0,0
Ghana,Benin,2007,4,2,6
Hungary,Greece,2007,1,2,3
Israel,North Macedonia,2007,1,0,1
Italy,Faroe Islands,2007,3,1,4
Jamaica,Guatemala,2007,2,0,2
Malta,Norway,2007,1,4,5
Morocco,Senegal,2007,3,0,3
New Caledonia,Fiji,2007,4,0,4
New Zealand,Vanuatu,2007,4,1,5
Oman,Kenya,2007,2,2,4
Panama,Costa Rica,2007,1,1,2
Portugal,Finland,2007,0,0,0
Qatar,Ivory Coast,2007,1,6,7
Romania,Albania,2007,6,1,7
San Marino,Slovakia,2007,0,5,5
Serbia,Poland,2007,2,2,4
Slovenia,Bulgaria,2007,0,2,2
Spain,Northern Ireland,2007,1,0,1
Sweden,Latvia,2007,2,1,3
Tanzania,Zambia,2007,1,0,1
Turkey,Bosnia and Herzegovina,2007,1,0,1
Ukraine,France,2007,2,2,4
United Arab Emirates,Togo,2007,0,5,5
Uzbekistan,Estonia,2007,0,0,0
Oman,Kenya,2007,1,1,2
Serbia,Kazakhstan,2007,1,0,1
Sudan,Eritrea,2007,1,0,1
Antigua and Barbuda,Saint Kitts and Nevis,2007,2,0,2
Guinea-Bissau,Sierra Leone,2007,2,0,2
Cape Verde,Gambia,2007,0,0,0
Sudan,Eritrea,2007,1,0,1
Guinea-Bissau,Cape Verde,2007,1,1,2
Tanzania,Kenya,2007,2,1,3
Rwanda,Eritrea,2007,2,1,3
Sudan,Zanzibar,2007,2,2,4
Uganda,Djibouti,2007,7,0,7
Somalia,Burundi,2007,0,3,3
Djibouti,Eritrea,2007,2,3,5
Oman,Jordan,2007,0,3,3
Rwanda,Uganda,2007,0,2,2
Kenya,Burundi,2007,0,1,1
Tanzania,Somalia,2007,1,0,1
Djibouti,Rwanda,2007,0,9,9
Zanzibar,Ethiopia,2007,3,1,4
Bermuda,Saint Kitts and Nevis,2007,1,2,3
Eritrea,Uganda,2007,3,2,5
Kenya,Somalia,2007,2,0,2
Ethiopia,Sudan,2007,0,0,0
Tanzania,Burundi,2007,0,0,0
Bermuda,Saint Kitts and Nevis,2007,4,2,6
Oman,Tajikistan,2007,4,2,6
Burundi,Eritrea,2007,2,1,3
Tanzania,Sudan,2007,1,2,3
Uganda,Kenya,2007,1,1,2
Zanzibar,Rwanda,2007,0,0,0
Burundi,Sudan,2007,1,2,3
Uganda,Rwanda,2007,0,1,1
Burundi,Uganda,2007,0,2,2
Sudan,Rwanda,2007,2,2,4
Thailand,Uzbekistan,2007,3,2,5
Gambia,Sierra Leone,2007,2,1,3
North Korea,Uzbekistan,2007,2,2,4
Thailand,North Korea,2007,1,0,1
Galicia,Cameroon,2007,1,1,2
Andalusia,Zambia,2007,4,1,5
Basque Country,Catalonia,2007,1,1,2
Canary Islands,Angola,2007,2,0,2
Kuwait,Lebanon,2008,3,2,5
Egypt,Namibia,2008,3,0,3
Tunisia,Zambia,2008,1,2,3
Tunisia,Zambia,2008,1,0,1
Nigeria,Sudan,2008,2,0,2
Egypt,Mali,2008,1,0,1
Qatar,Iran,2008,0,0,0
United Arab Emirates,China PR,2008,0,0,0
Guinea,Sudan,2008,6,0,6
Kuwait,Ivory Coast,2008,0,2,2
Morocco,Zambia,2008,2,0,2
Senegal,Namibia,2008,3,1,4
Angola,Egypt,2008,3,3,6
Barbados,Antigua and Barbuda,2008,3,2,5
Costa Rica,Sweden,2008,0,1,1
South Africa,Mozambique,2008,2,0,2
Syria,Qatar,2008,0,0,0
Bahrain,Kuwait,2008,1,0,1
Benin,Senegal,2008,1,2,3
Bermuda,Puerto Rico,2008,0,2,2
Morocco,Angola,2008,2,1,3
South Africa,Botswana,2008,2,1,3
Bermuda,Puerto Rico,2008,0,1,1
Dominica,Guadeloupe,2008,0,3,3
United States,Sweden,2008,2,0,2
China PR,Lebanon,2008,0,0,0
Ghana,Guinea,2008,2,1,3
Guyana,Grenada,2008,1,2,3
Mali,Benin,2008,1,0,1
Namibia,Morocco,2008,1,5,6
Nigeria,Ivory Coast,2008,0,1,1
Belize,El Salvador,2008,0,1,1
Egypt,Cameroon,2008,4,2,6
Sudan,Zambia,2008,0,3,3
Bahrain,Syria,2008,1,2,3
South Africa,Angola,2008,1,1,2
Tunisia,Senegal,2008,2,2,4
Ghana,Namibia,2008,1,0,1
Guinea,Morocco,2008,3,2,5
Iraq,Jordan,2008,1,1,2
Kuwait,Singapore,2008,0,2,2
Ivory Coast,Benin,2008,4,1,5
Nigeria,Mali,2008,0,0,0
Bahrain,Yemen,2008,2,1,3
Cameroon,Zambia,2008,5,1,6
Egypt,Sudan,2008,3,0,3
Haiti,El Salvador,2008,0,0,0
Japan,Chile,2008,0,0,0
Puerto Rico,Trinidad and Tobago,2008,2,2,4
China PR,Syria,2008,2,1,3
Oman,Singapore,2008,2,0,2
Senegal,Angola,2008,1,3,4
Tunisia,South Africa,2008,3,1,4
Ghana,Morocco,2008,2,0,2
Guinea,Namibia,2008,1,1,2
Jordan,Lebanon,2008,4,1,5
Haiti,El Salvador,2008,0,0,0
Ivory Coast,Mali,2008,3,0,3
Nigeria,Benin,2008,2,0,2
Trinidad and Tobago,Guyana,2008,2,1,3
Cameroon,Sudan,2008,3,0,3
Egypt,Zambia,2008,1,1,2
Iran,Costa Rica,2008,0,0,0
Japan,Bosnia and Herzegovina,2008,3,0,3
South Korea,Chile,2008,0,1,1
Martinique,Canada,2008,0,1,1
Oman,Kuwait,2008,1,1,2
Saudi Arabia,Luxembourg,2008,2,1,3
Jordan,Singapore,2008,2,1,3
Senegal,South Africa,2008,1,1,2
Tunisia,Angola,2008,0,0,0
United Arab Emirates,Iraq,2008,0,1,1
Belarus,Iceland,2008,2,0,2
Malta,Armenia,2008,0,1,1
Azerbaijan,Kazakhstan,2008,0,0,0
Bermuda,Cayman Islands,2008,1,1,2
Ghana,Nigeria,2008,2,1,3
Ivory Coast,Guinea,2008,5,0,5
Venezuela,Haiti,2008,1,0,1
Armenia,Belarus,2008,2,1,3
Egypt,Angola,2008,2,1,3
Malta,Iceland,2008,1,0,1
Tunisia,Cameroon,2008,2,3,5
Armenia,Iceland,2008,0,2,2
Aruba,Antigua and Barbuda,2008,0,3,3
Australia,Qatar,2008,3,0,3
Austria,Germany,2008,0,3,3
Belize,Saint Kitts and Nevis,2008,3,1,4
Bolivia,Peru,2008,2,1,3
Burundi,Rwanda,2008,0,0,0
Croatia,Netherlands,2008,0,3,3
Cyprus,Ukraine,2008,1,1,2
Czech Republic,Poland,2008,0,2,2
Dominica,Barbados,2008,1,1,2
El Salvador,Anguilla,2008,12,0,12
England,Switzerland,2008,2,1,3
Georgia,Latvia,2008,1,3,4
Greece,Finland,2008,2,1,3
Honduras,Paraguay,2008,2,0,2
Hungary,Slovakia,2008,1,1,2
Iran,Syria,2008,0,0,0
Iraq,China PR,2008,1,1,2
Republic of Ireland,Brazil,2008,0,1,1
Israel,Romania,2008,1,0,1
Italy,Portugal,2008,3,1,4
Jamaica,Costa Rica,2008,1,1,2
Japan,Thailand,2008,4,1,5
Jordan,North Korea,2008,0,1,1
Kazakhstan,Moldova,2008,0,1,1
South Korea,Turkmenistan,2008,4,0,4
Lebanon,Uzbekistan,2008,0,1,1
North Macedonia,Serbia,2008,1,1,2
Malta,Belarus,2008,0,1,1
Nicaragua,Curaçao,2008,0,1,1
Northern Ireland,Bulgaria,2008,0,1,1
Oman,Bahrain,2008,0,1,1
Saudi Arabia,Singapore,2008,2,0,2
Slovenia,Denmark,2008,1,2,3
Spain,France,2008,1,0,1
Trinidad and Tobago,Guadeloupe,2008,0,0,0
Turkey,Sweden,2008,0,0,0
Turks and Caicos Islands,Saint Lucia,2008,2,1,3
United Arab Emirates,Kuwait,2008,2,0,2
Uruguay,Colombia,2008,2,2,4
United States,Mexico,2008,2,2,4
Venezuela,Haiti,2008,1,1,2
Wales,Norway,2008,3,0,3
Ghana,Cameroon,2008,0,1,1
Ivory Coast,Egypt,2008,1,4,5
Ghana,Ivory Coast,2008,4,2,6
Lesotho,Mozambique,2008,0,1,1
Eswatini,Botswana,2008,1,4,5
Botswana,Mozambique,2008,1,0,1
Cameroon,Egypt,2008,0,1,1
Eswatini,Lesotho,2008,2,2,4
China PR,South Korea,2008,2,3,5
Japan,North Korea,2008,1,1,2
China PR,Japan,2008,0,1,1
South Korea,North Korea,2008,1,1,2
China PR,North Korea,2008,3,1,4
Japan,South Korea,2008,1,1,2
Guyana,Cuba,2008,0,0,0
Dominican Republic,Haiti,2008,1,2,3
Poland,Estonia,2008,2,0,2
Dominican Republic,Haiti,2008,0,2,2
Qatar,Bahrain,2008,1,2,3
Mauritius,Madagascar,2008,1,2,3
South Africa,Zimbabwe,2008,2,1,3
British Virgin Islands,United States Virgin Islands,2008,0,0,0
British Virgin Islands,United States Virgin Islands,2008,1,1,2
China PR,Thailand,2008,3,3,6
Iceland,Faroe Islands,2008,3,0,3
Qatar,Jordan,2008,2,1,3
Oman,United Arab Emirates,2008,1,1,2
Trinidad and Tobago,El Salvador,2008,1,0,1
Bahrain,Iran,2008,1,0,1
Kuwait,Iraq,2008,0,0,0
Singapore,Australia,2008,0,0,0
Uzbekistan,Jordan,2008,4,1,5
Venezuela,El Salvador,2008,1,0,1
Gabon,DR Congo,2008,0,0,0
Nepal,Pakistan,2008,2,1,3
Togo,Guinea,2008,0,2,2
Algeria,DR Congo,2008,1,1,2
Andorra,Latvia,2008,0,3,3
Anguilla,El Salvador,2008,0,4,4
Antigua and Barbuda,Aruba,2008,1,0,1
Armenia,Kazakhstan,2008,1,0,1
Austria,Netherlands,2008,3,4,7
Bahamas,British Virgin Islands,2008,1,1,2
Bahrain,Japan,2008,1,0,1
Barbados,Dominica,2008,1,0,1
Belarus,Turkey,2008,2,2,4
Belgium,Morocco,2008,1,4,5
Bosnia and Herzegovina,North Macedonia,2008,2,2,4
Botswana,Zimbabwe,2008,0,1,1
Brazil,Sweden,2008,1,0,1
Bulgaria,Finland,2008,2,1,3
China PR,Australia,2008,0,0,0
Curaçao,Nicaragua,2008,2,0,2
Denmark,Czech Republic,2008,1,1,2
Ecuador,Haiti,2008,3,1,4
Egypt,Argentina,2008,0,2,2
Estonia,Canada,2008,2,0,2
France,England,2008,1,0,1
Ghana,Mexico,2008,1,2,3
Grenada,United States Virgin Islands,2008,10,0,10
Honduras,Colombia,2008,2,1,3
Hungary,Slovenia,2008,0,1,1
Israel,Chile,2008,1,0,1
Ivory Coast,Tunisia,2008,0,2,2
Jamaica,Trinidad and Tobago,2008,2,2,4
North Korea,South Korea,2008,0,0,0
Kuwait,Iran,2008,2,2,4
Lithuania,Azerbaijan,2008,1,0,1
Luxembourg,Wales,2008,0,2,2
Malta,Liechtenstein,2008,7,1,8
Montenegro,Norway,2008,3,1,4
Montserrat,Suriname,2008,1,7,8
Namibia,Malawi,2008,1,3,4
Northern Ireland,Georgia,2008,4,1,5
Peru,Costa Rica,2008,3,1,4
Poland,United States,2008,0,3,3
Portugal,Greece,2008,1,2,3
Puerto Rico,Dominican Republic,2008,1,0,1
Qatar,Iraq,2008,2,0,2
Romania,Russia,2008,3,0,3
Scotland,Croatia,2008,1,1,2
Singapore,Lebanon,2008,2,0,2
Slovakia,Iceland,2008,1,2,3
South Africa,Paraguay,2008,3,0,3
Spain,Italy,2008,1,0,1
Saint Kitts and Nevis,Belize,2008,1,1,2
Saint Lucia,Turks and Caicos Islands,2008,2,0,2
Sudan,Liberia,2008,0,2,2
Switzerland,Germany,2008,0,4,4
Syria,United Arab Emirates,2008,1,1,2
Thailand,Oman,2008,0,1,1
Turkmenistan,Jordan,2008,0,2,2
Uganda,Libya,2008,1,1,2
Ukraine,Serbia,2008,2,0,2
Uzbekistan,Saudi Arabia,2008,3,0,3
Venezuela,Bolivia,2008,0,1,1
Nepal,Pakistan,2008,0,2,2
Bahamas,British Virgin Islands,2008,2,2,4
Cayman Islands,Bermuda,2008,1,3,4
Sri Lanka,Guam,2008,5,1,6
Pakistan,Sri Lanka,2008,1,7,8
Taiwan,Guam,2008,4,1,5
Yemen,Tanzania,2008,2,1,3
Pakistan,Guam,2008,9,2,11
Taiwan,Sri Lanka,2008,2,2,4
Lebanon,Maldives,2008,4,0,4
Mexico,China PR,2008,1,0,1
El Salvador,China PR,2008,2,2,4
Guatemala,Haiti,2008,1,0,1
Maldives,Lebanon,2008,1,2,3
Oman,Liberia,2008,1,0,1
Indonesia,Yemen,2008,1,0,1
Northern Mariana Islands,Guam,2008,2,3,5
Oman,Kyrgyzstan,2008,2,0,2
Trinidad and Tobago,Grenada,2008,2,0,2
Colombia,Venezuela,2008,5,2,7
Liberia,Sierra Leone,2008,3,1,4
Oman,Yemen,2008,0,0,0
Bangladesh,Afghanistan,2008,0,0,0
Jersey,Guernsey,2008,1,1,2
Kyrgyzstan,Afghanistan,2008,0,1,1
Kyrgyzstan,Bangladesh,2008,2,1,3
Syria,Oman,2008,2,1,3
Trinidad and Tobago,Barbados,2008,3,0,3
Philippines,Brunei,2008,1,0,1
Tajikistan,Bhutan,2008,3,1,4
Bhutan,Brunei,2008,1,1,2
Philippines,Tajikistan,2008,0,0,0
Philippines,Bhutan,2008,3,0,3
Syria,Iraq,2008,2,1,3
Tajikistan,Brunei,2008,4,0,4
Antigua and Barbuda,Saint Lucia,2008,6,1,7
Oman,Turkmenistan,2008,2,1,3
Greece,Cyprus,2008,2,0,2
Thailand,Nepal,2008,7,0,7
Turkey,Slovakia,2008,1,0,1
Brittany,Congo,2008,3,1,4
Curaçao,Suriname,2008,2,1,3
Mozambique,Lesotho,2008,2,3,5
Ivory Coast,Paraguay,2008,1,1,2
Libya,Zambia,2008,2,2,4
Yemen,Sudan,2008,1,1,2
Australia,Ghana,2008,1,0,1
Honduras,Belize,2008,2,0,2
Qatar,Kuwait,2008,1,1,2
Russia,Kazakhstan,2008,6,0,6
Eswatini,Lesotho,2008,1,1,2
Burkina Faso,Cape Verde,2008,0,1,1
Croatia,Moldova,2008,1,0,1
Hungary,Greece,2008,3,2,5
India,Taiwan,2008,3,0,3
Republic of Ireland,Serbia,2008,1,1,2
Japan,Ivory Coast,2008,1,0,1
Nepal,Macau,2008,3,2,5
Netherlands,Ukraine,2008,3,0,3
Saudi Arabia,Syria,2008,1,0,1
Switzerland,Slovakia,2008,2,0,2
Catalonia,Argentina,2008,0,1,1
China PR,Jordan,2008,2,0,2
Iran,Zambia,2008,3,2,5
Tanzania,Malawi,2008,1,1,2
Thailand,Iraq,2008,2,1,3
Turkey,Uruguay,2008,2,3,5
Cambodia,Nepal,2008,0,1,1
North Macedonia,Poland,2008,1,1,2
Sweden,Slovenia,2008,1,0,1
Albania,Poland,2008,0,1,1
Austria,Nigeria,2008,1,1,2
Czech Republic,Lithuania,2008,2,0,2
Estonia,Georgia,2008,1,1,2
France,Ecuador,2008,2,0,2
Germany,Belarus,2008,2,2,4
India,Taiwan,2008,2,2,4
Japan,Paraguay,2008,0,0,0
Libya,Liberia,2008,4,2,6
Luxembourg,Cape Verde,2008,1,1,2
Montenegro,Kazakhstan,2008,3,0,3
Qatar,Lebanon,2008,2,1,3
Saudi Arabia,Kuwait,2008,2,1,3
Cambodia,Macau,2008,3,1,4
England,United States,2008,2,0,2
Iceland,Wales,2008,0,1,1
Moldova,Armenia,2008,2,2,4
Norway,Uruguay,2008,2,2,4
Russia,Serbia,2008,2,1,3
Singapore,Bahrain,2008,0,1,1
Finland,Turkey,2008,0,2,2
Republic of Ireland,Colombia,2008,1,0,1
Netherlands,Denmark,2008,1,1,2
Austria,Malta,2008,5,1,6
Czech Republic,Scotland,2008,3,1,4
Guatemala,El Salvador,2008,0,0,0
Italy,Belgium,2008,3,1,4
Latvia,Estonia,2008,1,0,1
Switzerland,Liechtenstein,2008,3,0,3
Venezuela,Honduras,2008,1,1,2
Botswana,Madagascar,2008,0,0,0
Brazil,Canada,2008,3,2,5
Cameroon,Cape Verde,2008,2,0,2
Estonia,Lithuania,2008,0,1,1
France,Paraguay,2008,0,0,0
Germany,Serbia,2008,2,1,3
Hungary,Croatia,2008,1,1,2
South Korea,Jordan,2008,2,2,4
Malawi,Djibouti,2008,8,1,9
Morocco,Ethiopia,2008,3,0,3
Namibia,Kenya,2008,2,1,3
Portugal,Georgia,2008,2,0,2
Romania,Montenegro,2008,4,0,4
Rwanda,Mauritania,2008,3,0,3
Senegal,Algeria,2008,1,0,1
Spain,Peru,2008,2,1,3
Tanzania,Mauritius,2008,1,1,2
Togo,Zambia,2008,1,0,1
Uganda,Niger,2008,1,0,1
Angola,Benin,2008,3,0,3
Armenia,Greece,2008,0,0,0
Australia,Iraq,2008,1,0,1
Bosnia and Herzegovina,Azerbaijan,2008,1,0,1
Burundi,Seychelles,2008,1,0,1
Egypt,DR Congo,2008,2,1,3
Equatorial Guinea,Sierra Leone,2008,2,0,2
Ghana,Libya,2008,3,0,3
Guatemala,Panama,2008,0,1,1
Guinea,Zimbabwe,2008,0,0,0
Ivory Coast,Mozambique,2008,1,0,1
Latvia,Lithuania,2008,2,1,3
Liberia,Gambia,2008,1,1,2
Mali,Congo,2008,4,2,6
Netherlands,Wales,2008,2,0,2
Nigeria,South Africa,2008,2,0,2
Poland,Denmark,2008,1,1,2
Sweden,Ukraine,2008,0,1,1
Trinidad and Tobago,England,2008,0,3,3
Tunisia,Burkina Faso,2008,1,2,3
Finland,Belarus,2008,1,1,2
Iran,United Arab Emirates,2008,0,0,0
Japan,Oman,2008,3,0,3
Qatar,China PR,2008,0,0,0
Saudi Arabia,Lebanon,2008,4,1,5
Singapore,Uzbekistan,2008,3,7,10
Syria,Kuwait,2008,1,0,1
Thailand,Bahrain,2008,2,3,5
Turkmenistan,North Korea,2008,0,0,0
France,Colombia,2008,1,0,1
India,Nepal,2008,4,0,4
Maldives,Pakistan,2008,3,0,3
Andorra,Azerbaijan,2008,1,2,3
Bangladesh,Bhutan,2008,1,1,2
Chile,Guatemala,2008,2,0,2
Estonia,Faroe Islands,2008,4,3,7
Honduras,Puerto Rico,2008,4,0,4
Lithuania,Russia,2008,1,4,5
Mexico,Argentina,2008,1,4,5
Panama,Canada,2008,2,2,4
Spain,United States,2008,1,0,1
Sri Lanka,Afghanistan,2008,2,2,4
India,Pakistan,2008,2,1,3
Maldives,Nepal,2008,4,1,5
Algeria,Liberia,2008,3,0,3
Bangladesh,Afghanistan,2008,2,2,4
Bermuda,Barbados,2008,2,1,3
Brazil,Venezuela,2008,0,2,2
Indonesia,Malaysia,2008,1,1,2
Sri Lanka,Bhutan,2008,2,0,2
Bahrain,Thailand,2008,1,1,2
Burkina Faso,Burundi,2008,2,0,2
Cape Verde,Tanzania,2008,1,0,1
Chad,Mali,2008,1,2,3
Chile,Panama,2008,0,0,0
China PR,Qatar,2008,0,1,1
Cuba,Saint Vincent and the Grenadines,2008,1,0,1
Honduras,Haiti,2008,3,1,4
Iraq,Australia,2008,1,0,1
Jordan,South Korea,2008,0,1,1
Kenya,Guinea,2008,2,0,2
North Korea,Turkmenistan,2008,1,0,1
Libya,Gabon,2008,1,0,1
Maldives,India,2008,0,1,1
Mauritania,Morocco,2008,1,4,5
Oman,Japan,2008,1,1,2
Pakistan,Nepal,2008,1,4,5
Portugal,Turkey,2008,2,0,2
Saudi Arabia,Lebanon,2008,2,1,3
Seychelles,Tunisia,2008,0,2,2
Sierra Leone,Nigeria,2008,0,1,1
Switzerland,Czech Republic,2008,0,1,1
Trinidad and Tobago,Jamaica,2008,1,1,2
United Arab Emirates,Iran,2008,0,1,1
Uzbekistan,Singapore,2008,3,0,3
Afghanistan,Bhutan,2008,1,3,4
Antigua and Barbuda,Saint Kitts and Nevis,2008,2,0,2
Austria,Croatia,2008,0,1,1
Benin,Uganda,2008,4,1,5
Congo,Sudan,2008,1,0,1
DR Congo,Malawi,2008,1,0,1
Ethiopia,Rwanda,2008,1,2,3
Gambia,Senegal,2008,0,0,0
Germany,Poland,2008,2,0,2
Kuwait,Syria,2008,4,2,6
Lesotho,Ghana,2008,2,3,5
Madagascar,Ivory Coast,2008,0,0,0
Mauritius,Cameroon,2008,0,3,3
Mexico,Peru,2008,4,0,4
Mozambique,Botswana,2008,1,2,3
Niger,Angola,2008,1,2,3
Sri Lanka,Bangladesh,2008,1,0,1
Eswatini,Togo,2008,2,1,3
United States,Argentina,2008,0,0,0
Zimbabwe,Namibia,2008,2,0,2
Bermuda,Barbados,2008,3,0,3
Curaçao,Venezuela,2008,0,1,1
Netherlands,Italy,2008,3,0,3
Romania,France,2008,0,0,0
Greece,Sweden,2008,0,2,2
Grenada,Jamaica,2008,2,1,3
Spain,Russia,2008,4,1,5
Czech Republic,Portugal,2008,1,3,4
India,Bhutan,2008,2,1,3
Indonesia,Vietnam,2008,1,0,1
Sri Lanka,Maldives,2008,0,1,1
Switzerland,Turkey,2008,1,2,3
Austria,Poland,2008,1,1,2
Croatia,Germany,2008,2,1,3
Djibouti,DR Congo,2008,0,6,6
Italy,Romania,2008,1,1,2
Mauritania,Ethiopia,2008,0,1,1
Netherlands,France,2008,4,1,5
Bahrain,Oman,2008,1,1,2
Botswana,Ivory Coast,2008,1,1,2
Chad,Congo,2008,2,1,3
China PR,Iraq,2008,1,2,3
Gabon,Ghana,2008,2,0,2
Gambia,Algeria,2008,1,0,1
Greece,Russia,2008,0,1,1
Grenada,Costa Rica,2008,2,2,4
Guatemala,Saint Lucia,2008,6,0,6
India,Maldives,2008,0,1,1
Kenya,Zimbabwe,2008,2,0,2
North Korea,Jordan,2008,2,0,2
Kuwait,United Arab Emirates,2008,2,3,5
Malawi,Egypt,2008,1,0,1
Namibia,Guinea,2008,1,2,3
Niger,Benin,2008,0,2,2
Peru,Colombia,2008,1,1,2
Puerto Rico,Honduras,2008,2,2,4
Qatar,Australia,2008,1,3,4
Rwanda,Morocco,2008,3,1,4
Seychelles,Burkina Faso,2008,2,3,5
Sierra Leone,South Africa,2008,1,0,1
Singapore,Saudi Arabia,2008,0,3,3
Sudan,Mali,2008,3,2,5
Suriname,Guyana,2008,1,0,1
Sweden,Spain,2008,1,2,3
Syria,Iran,2008,0,2,2
Tanzania,Cameroon,2008,0,0,0
Thailand,Japan,2008,0,3,3
Turkmenistan,South Korea,2008,1,3,4
Uganda,Angola,2008,3,1,4
Uruguay,Venezuela,2008,1,1,2
Uzbekistan,Lebanon,2008,3,0,3
Vanuatu,New Caledonia,2008,1,1,2
Argentina,Ecuador,2008,1,1,2
Belize,Mexico,2008,0,2,2
Bolivia,Chile,2008,0,2,2
Burundi,Tunisia,2008,0,1,1
Equatorial Guinea,Nigeria,2008,0,1,1
Haiti,Curaçao,2008,0,0,0
Jamaica,Bahamas,2008,7,0,7
Lesotho,Libya,2008,0,1,1
Liberia,Senegal,2008,2,2,4
Macau,Hong Kong,2008,0,1,1
Madagascar,Mozambique,2008,1,1,2
Mauritius,Cape Verde,2008,0,1,1
Panama,El Salvador,2008,1,0,1
Paraguay,Brazil,2008,2,0,2
Eswatini,Zambia,2008,0,0,0
Switzerland,Portugal,2008,2,0,2
Trinidad and Tobago,Bermuda,2008,1,2,3
Turkey,Czech Republic,2008,3,2,5
United States,Barbados,2008,8,0,8
Austria,Germany,2008,0,1,1
Poland,Croatia,2008,0,1,1
Antigua and Barbuda,Cuba,2008,3,4,7
France,Italy,2008,0,2,2
Netherlands,Romania,2008,2,0,2
Uruguay,Peru,2008,6,0,6
Bolivia,Paraguay,2008,4,2,6
Ecuador,Colombia,2008,0,0,0
Greece,Spain,2008,1,2,3
Jamaica,Bahamas,2008,6,0,6
Russia,Sweden,2008,2,0,2
Brazil,Argentina,2008,0,0,0
Portugal,Germany,2008,2,3,5
Venezuela,Chile,2008,2,3,5
Algeria,Gambia,2008,1,0,1
Canada,Saint Vincent and the Grenadines,2008,4,1,5
Croatia,Turkey,2008,1,1,2
Libya,Lesotho,2008,4,0,4
Burkina Faso,Seychelles,2008,4,1,5
Cameroon,Tanzania,2008,2,1,3
Costa Rica,Grenada,2008,3,0,3
Mexico,Belize,2008,7,0,7
Morocco,Rwanda,2008,2,0,2
Netherlands,Russia,2008,1,3,4
New Caledonia,Vanuatu,2008,3,0,3
Nigeria,Equatorial Guinea,2008,2,0,2
Senegal,Liberia,2008,3,1,4
South Africa,Sierra Leone,2008,0,0,0
Saint Lucia,Guatemala,2008,1,3,4
Tunisia,Burundi,2008,2,1,3
Zambia,Eswatini,2008,1,0,1
Australia,China PR,2008,0,1,1
Barbados,United States,2008,0,1,1
Benin,Niger,2008,2,0,2
Bermuda,Trinidad and Tobago,2008,0,2,2
Cape Verde,Mauritius,2008,3,1,4
Congo,Chad,2008,2,0,2
DR Congo,Djibouti,2008,5,1,6
Cuba,Antigua and Barbuda,2008,4,0,4
Curaçao,Haiti,2008,0,1,1
Egypt,Malawi,2008,2,0,2
El Salvador,Panama,2008,3,1,4
Ethiopia,Mauritania,2008,6,1,7
Ghana,Gabon,2008,2,0,2
Guinea,Namibia,2008,4,0,4
Guyana,Suriname,2008,1,2,3
Iran,Kuwait,2008,2,0,2
Iraq,Qatar,2008,0,1,1
Ivory Coast,Botswana,2008,4,0,4
Japan,Bahrain,2008,1,0,1
Jordan,Turkmenistan,2008,2,0,2
South Korea,North Korea,2008,0,0,0
Lebanon,Singapore,2008,1,2,3
Mali,Sudan,2008,3,0,3
Mozambique,Madagascar,2008,3,0,3
Oman,Thailand,2008,2,1,3
Saudi Arabia,Uzbekistan,2008,4,0,4
Spain,Italy,2008,0,0,0
United Arab Emirates,Syria,2008,1,3,4
Zimbabwe,Kenya,2008,0,0,0
Angola,Uganda,2008,0,0,0
Germany,Turkey,2008,3,2,5
Russia,Spain,2008,0,3,3
Gabon,Lesotho,2008,2,0,2
Germany,Spain,2008,0,1,1
Solomon Islands,Vanuatu,2008,1,2,3
Sápmi,Iraqi Kurdistan,2008,2,2,4
Trinidad and Tobago,Guyana,2008,2,0,2
Provence,Padania,2008,1,6,7
Provence,Iraqi Kurdistan,2008,0,3,3
Sápmi,Arameans Suryoye,2008,0,1,1
Arameans Suryoye,Provence,2008,5,0,5
Padania,Iraqi Kurdistan,2008,2,1,3
Sápmi,Padania,2008,0,2,2
Iraqi Kurdistan,Arameans Suryoye,2008,0,0,0
Padania,Arameans Suryoye,2008,4,1,5
Sápmi,Provence,2008,4,2,6
Sápmi,Iraqi Kurdistan,2008,3,1,4
Padania,Arameans Suryoye,2008,2,0,2
Trinidad and Tobago,Curaçao,2008,2,0,2
Madagascar,Eswatini,2008,1,1,2
Mauritius,Seychelles,2008,0,7,7
Comoros,Namibia,2008,0,3,3
El Salvador,Guatemala,2008,0,0,0
Lesotho,Malawi,2008,0,1,1
Madagascar,Seychelles,2008,1,1,2
Mauritius,Eswatini,2008,1,1,2
Comoros,Malawi,2008,0,1,1
India,Malaysia,2008,1,1,2
Lesotho,Namibia,2008,1,1,2
Madagascar,Mauritius,2008,2,1,3
Seychelles,Eswatini,2008,0,1,1
Comoros,Lesotho,2008,0,1,1
Malawi,Namibia,2008,0,1,1
El Salvador,Jamaica,2008,0,0,0
South Africa,Namibia,2008,1,0,1
Botswana,Mozambique,2008,0,2,2
Curaçao,Aruba,2008,0,0,0
Zambia,Zimbabwe,2008,0,0,0
Grenada,Aruba,2008,3,1,4
India,Afghanistan,2008,1,0,1
Madagascar,Mozambique,2008,1,2,3
South Africa,Zambia,2008,1,0,1
Trinidad and Tobago,Haiti,2008,2,0,2
Turkmenistan,Tajikistan,2008,0,0,0
Myanmar,Nepal,2008,3,0,3
Curaçao,Grenada,2008,2,0,2
North Korea,Sri Lanka,2008,3,0,3
Afghanistan,Turkmenistan,2008,0,5,5
India,Tajikistan,2008,1,1,2
Nepal,North Korea,2008,0,1,1
Sri Lanka,Myanmar,2008,1,3,4
Afghanistan,Tajikistan,2008,0,4,4
India,Turkmenistan,2008,2,1,3
Madagascar,Zambia,2008,0,2,2
South Africa,Mozambique,2008,2,1,3
North Korea,Myanmar,2008,1,0,1
Nepal,Sri Lanka,2008,3,0,3
Guatemala,Bolivia,2008,3,0,3
India,Myanmar,2008,1,0,1
Iran,Palestine,2008,3,0,3
North Korea,Tajikistan,2008,0,1,1
Syria,Jordan,2008,0,0,0
Guyana,Dominica,2008,3,0,3
Dominica,Suriname,2008,1,3,4
Oman,Syria,2008,1,2,3
Palestine,Qatar,2008,0,1,1
Guyana,Suriname,2008,1,1,2
Haiti,Trinidad and Tobago,2008,1,0,1
Iran,Qatar,2008,6,1,7
Myanmar,North Korea,2008,0,4,4
India,Tajikistan,2008,4,1,5
Iran,Syria,2008,2,0,2
Jordan,Qatar,2008,3,0,3
El Salvador,Trinidad and Tobago,2008,1,3,4
Iran,Jordan,2008,2,1,3
Australia,South Africa,2008,2,2,4
Gabon,Mali,2008,1,0,1
Albania,Liechtenstein,2008,2,0,2
Algeria,United Arab Emirates,2008,1,0,1
Bahrain,Burkina Faso,2008,3,1,4
Belarus,Argentina,2008,0,0,0
Bolivia,Panama,2008,1,0,1
Bosnia and Herzegovina,Bulgaria,2008,1,2,3
Canada,Jamaica,2008,1,1,2
Colombia,Ecuador,2008,0,1,1
DR Congo,Togo,2008,2,1,3
Costa Rica,El Salvador,2008,1,0,1
Cuba,Trinidad and Tobago,2008,1,3,4
Denmark,Spain,2008,0,3,3
England,Czech Republic,2008,2,2,4
Estonia,Malta,2008,2,1,3
Finland,Israel,2008,2,0,2
Germany,Belgium,2008,2,0,2
Guatemala,United States,2008,0,1,1
Guinea,Ivory Coast,2008,1,2,3
Haiti,Suriname,2008,2,2,4
Hungary,Montenegro,2008,3,3,6
Iceland,Azerbaijan,2008,1,1,2
Italy,Austria,2008,2,2,4
Japan,Uruguay,2008,1,3,4
Kazakhstan,Andorra,2008,3,0,3
Libya,Senegal,2008,0,0,0
Lithuania,Moldova,2008,3,0,3
Luxembourg,North Macedonia,2008,1,4,5
Mexico,Honduras,2008,2,1,3
Morocco,Benin,2008,3,1,4
Mozambique,Eswatini,2008,3,0,3
Norway,Republic of Ireland,2008,1,1,2
Oman,Uzbekistan,2008,2,0,2
Portugal,Faroe Islands,2008,5,0,5
Qatar,Tajikistan,2008,5,0,5
Romania,Latvia,2008,1,0,1
Russia,Netherlands,2008,1,1,2
Saudi Arabia,Paraguay,2008,1,1,2
Scotland,Northern Ireland,2008,0,0,0
Slovakia,Greece,2008,0,2,2
Slovenia,Croatia,2008,2,3,5
Sudan,Egypt,2008,4,0,4
Sweden,France,2008,2,3,5
Switzerland,Cyprus,2008,4,1,5
Tanzania,Ghana,2008,1,1,2
Tunisia,Angola,2008,1,1,2
Turkey,Chile,2008,1,0,1
Ukraine,Poland,2008,1,0,1
Venezuela,Syria,2008,4,1,5
Wales,Georgia,2008,1,2,3
Zimbabwe,Botswana,2008,1,0,1
Indonesia,Cambodia,2008,7,0,7
Cambodia,Myanmar,2008,1,7,8
Libya,Chad,2008,3,0,3
Qatar,North Korea,2008,2,1,3
Indonesia,Myanmar,2008,4,0,4
Bermuda,Antigua and Barbuda,2008,0,4,4
Cayman Islands,Saint Martin,2008,3,0,3
Iran,Azerbaijan,2008,1,0,1
Libya,Niger,2008,6,2,8
United Arab Emirates,Bahrain,2008,2,3,5
Uzbekistan,North Korea,2008,0,0,0
Cayman Islands,Antigua and Barbuda,2008,1,1,2
Saudi Arabia,Qatar,2008,2,1,3
Saint Martin,Bermuda,2008,0,7,7
Suriname,French Guiana,2008,2,1,3
Antigua and Barbuda,Saint Martin,2008,3,2,5
Cayman Islands,Bermuda,2008,0,0,0
Trinidad and Tobago,Guyana,2008,3,0,3
Algeria,Senegal,2008,3,2,5
Djibouti,Malawi,2008,0,3,3
South Korea,Jordan,2008,1,0,1
Libya,Ghana,2008,1,0,1
Albania,Sweden,2008,0,0,0
Andorra,England,2008,0,2,2
Argentina,Paraguay,2008,1,1,2
Armenia,Turkey,2008,0,2,2
Austria,France,2008,3,1,4
Bahrain,Japan,2008,2,3,5
Belgium,Estonia,2008,3,2,5
Burkina Faso,Tunisia,2008,0,0,0
Cape Verde,Cameroon,2008,1,2,3
Colombia,Uruguay,2008,0,1,1
Croatia,Kazakhstan,2008,3,0,3
Cuba,United States,2008,0,1,1
Cyprus,Italy,2008,1,2,3
Ecuador,Bolivia,2008,3,1,4
Fiji,Vanuatu,2008,2,0,2
Gambia,Liberia,2008,3,0,3
Georgia,Republic of Ireland,2008,1,2,3
Hungary,Denmark,2008,0,0,0
Israel,Switzerland,2008,2,2,4
Kenya,Namibia,2008,1,0,1
Liechtenstein,Germany,2008,0,6,6
Luxembourg,Greece,2008,0,3,3
North Macedonia,Scotland,2008,1,0,1
Malta,Portugal,2008,0,4,4
Martinique,French Guiana,2008,2,1,3
Mauritania,Rwanda,2008,0,1,1
Mauritius,Tanzania,2008,1,4,5
Moldova,Latvia,2008,1,2,3
Montenegro,Bulgaria,2008,2,2,4
Netherlands,Australia,2008,1,2,3
New Caledonia,New Zealand,2008,1,3,4
Norway,Iceland,2008,2,2,4
Oman,Morocco,2008,0,0,0
Peru,Venezuela,2008,1,0,1
Poland,Slovenia,2008,1,1,2
Qatar,Uzbekistan,2008,3,0,3
Romania,Lithuania,2008,0,3,3
Saudi Arabia,Iran,2008,1,1,2
Serbia,Faroe Islands,2008,2,0,2
Seychelles,Burundi,2008,1,2,3
Sierra Leone,Equatorial Guinea,2008,2,1,3
Slovakia,Northern Ireland,2008,2,1,3
South Africa,Nigeria,2008,0,1,1
Spain,Bosnia and Herzegovina,2008,1,0,1
Sudan,Chad,2008,1,2,3
Trinidad and Tobago,Guatemala,2008,1,1,2
Ukraine,Belarus,2008,1,0,1
United Arab Emirates,North Korea,2008,1,2,3
Wales,Azerbaijan,2008,1,0,1
Benin,Angola,2008,3,2,5
Chile,Brazil,2008,0,3,3
Congo,Mali,2008,1,0,1
DR Congo,Egypt,2008,0,1,1
Lesotho,Gabon,2008,0,3,3
Madagascar,Botswana,2008,1,0,1
Mozambique,Ivory Coast,2008,1,1,2
Niger,Uganda,2008,3,1,4
Zimbabwe,Guinea,2008,0,0,0
Paraguay,Venezuela,2008,2,0,2
South Africa,Guinea,2008,0,1,1
Albania,Malta,2008,3,0,3
Andorra,Belarus,2008,1,3,4
Azerbaijan,Liechtenstein,2008,0,0,0
Bosnia and Herzegovina,Estonia,2008,7,0,7
Brazil,Bolivia,2008,0,0,0
Chad,Sudan,2008,1,3,4
Chile,Colombia,2008,4,0,4
Croatia,England,2008,1,4,5
Faroe Islands,Romania,2008,0,1,1
Finland,Germany,2008,3,3,6
France,Serbia,2008,2,1,3
Guatemala,Cuba,2008,4,1,5
Haiti,Costa Rica,2008,1,3,4
Honduras,Jamaica,2008,2,0,2
Iceland,Scotland,2008,1,2,3
Italy,Georgia,2008,2,0,2
Kazakhstan,Ukraine,2008,1,3,4
North Korea,South Korea,2008,1,1,2
Latvia,Greece,2008,0,2,2
Lithuania,Austria,2008,2,0,2
North Macedonia,Netherlands,2008,1,2,3
Mexico,Canada,2008,2,1,3
Moldova,Israel,2008,1,2,3
Montenegro,Republic of Ireland,2008,0,0,0
New Zealand,New Caledonia,2008,3,0,3
Northern Ireland,Czech Republic,2008,0,0,0
Oman,Zimbabwe,2008,3,2,5
Peru,Argentina,2008,1,1,2
Portugal,Denmark,2008,2,3,5
Qatar,Bahrain,2008,1,1,2
Russia,Wales,2008,2,1,3
San Marino,Poland,2008,0,2,2
Slovenia,Slovakia,2008,2,1,3
Spain,Armenia,2008,4,0,4
Suriname,El Salvador,2008,0,2,2
Sweden,Hungary,2008,2,1,3
Switzerland,Luxembourg,2008,1,2,3
Turkey,Belgium,2008,1,1,2
United Arab Emirates,Saudi Arabia,2008,1,2,3
Uruguay,Ecuador,2008,0,0,0
United States,Trinidad and Tobago,2008,3,0,3
Uzbekistan,Australia,2008,0,1,1
Vanuatu,Fiji,2008,2,1,3
Zambia,Togo,2008,1,0,1
Martinique,Anguilla,2008,3,1,4
Antigua and Barbuda,Guyana,2008,3,0,3
Guadeloupe,Martinique,2008,0,1,1
Mexico,Chile,2008,0,1,1
Saint Kitts and Nevis,British Virgin Islands,2008,4,0,4
Tahiti,New Caledonia,2008,0,1,1
Mayotte,Réunion,2008,1,6,7
British Virgin Islands,Barbados,2008,1,2,3
New Caledonia,Guadeloupe,2008,0,4,4
Tahiti,Martinique,2008,0,1,1
French Guiana,Mayotte,2008,4,2,6
Saint Kitts and Nevis,Barbados,2008,1,3,4
New Caledonia,Martinique,2008,1,1,2
South Africa,Malawi,2008,3,0,3
Tahiti,Guadeloupe,2008,0,1,1
French Guiana,Réunion,2008,0,2,2
Vietnam,Myanmar,2008,2,3,5
Myanmar,Turkmenistan,2008,1,2,3
Guadeloupe,French Guiana,2008,4,0,4
New Caledonia,Mayotte,2008,3,2,5
Martinique,Réunion,2008,0,1,1
Trinidad and Tobago,Dominican Republic,2008,9,0,9
Japan,United Arab Emirates,2008,1,1,2
Malaysia,Pakistan,2008,4,1,5
Argentina,Uruguay,2008,2,1,3
Belgium,Armenia,2008,2,0,2
Bolivia,Peru,2008,3,0,3
Botswana,Mozambique,2008,0,1,1
Bulgaria,Italy,2008,0,0,0
Cameroon,Mauritius,2008,5,0,5
Colombia,Paraguay,2008,0,1,1
Denmark,Malta,2008,3,0,3
England,Kazakhstan,2008,5,1,6
Equatorial Guinea,South Africa,2008,0,1,1
Estonia,Spain,2008,0,3,3
Faroe Islands,Austria,2008,1,1,2
Finland,Azerbaijan,2008,1,0,1
Gabon,Libya,2008,1,0,1
Georgia,Cyprus,2008,1,1,2
Germany,Russia,2008,2,1,3
Ghana,Lesotho,2008,3,0,3
Greece,Moldova,2008,3,0,3
Guadeloupe,Cayman Islands,2008,7,1,8
Guatemala,Trinidad and Tobago,2008,0,0,0
Haiti,El Salvador,2008,0,0,0
Honduras,Canada,2008,3,1,4
Hungary,Albania,2008,2,0,2
Ivory Coast,Madagascar,2008,3,0,3
Jamaica,Mexico,2008,1,0,1
South Korea,Uzbekistan,2008,3,0,3
Liberia,Algeria,2008,0,0,0
Luxembourg,Israel,2008,1,3,4
Malawi,DR Congo,2008,2,1,3
Mali,Chad,2008,2,1,3
Martinique,Grenada,2008,2,2,4
Morocco,Mauritania,2008,4,1,5
Namibia,Zimbabwe,2008,4,2,6
Netherlands,Iceland,2008,2,0,2
Nigeria,Sierra Leone,2008,4,1,5
Poland,Czech Republic,2008,2,1,3
Romania,France,2008,2,2,4
San Marino,Slovakia,2008,1,3,4
Scotland,Norway,2008,0,0,0
Senegal,Gambia,2008,1,1,2
Serbia,Lithuania,2008,3,0,3
Slovenia,Northern Ireland,2008,2,0,2
Sudan,Congo,2008,2,0,2
Suriname,Costa Rica,2008,1,4,5
Sweden,Portugal,2008,0,0,0
Switzerland,Latvia,2008,2,1,3
Tanzania,Cape Verde,2008,3,1,4
Togo,Eswatini,2008,6,0,6
Tunisia,Seychelles,2008,5,0,5
Turkey,Bosnia and Herzegovina,2008,2,1,3
Ukraine,Croatia,2008,0,0,0
United States,Cuba,2008,6,1,7
Wales,Liechtenstein,2008,2,0,2
Angola,Niger,2008,3,1,4
Burundi,Burkina Faso,2008,1,3,4
Ecuador,Chile,2008,1,0,1
Egypt,Djibouti,2008,4,0,4
Guinea,Kenya,2008,3,2,5
Uganda,Benin,2008,2,1,3
Venezuela,Brazil,2008,0,4,4
Cayman Islands,Martinique,2008,0,1,1
Guadeloupe,Grenada,2008,2,1,3
Bolivia,Uruguay,2008,2,2,4
France,Tunisia,2008,3,1,4
Vietnam,Singapore,2008,0,0,0
Australia,Qatar,2008,4,0,4
Austria,Serbia,2008,1,3,4
Bahrain,Azerbaijan,2008,1,2,3
Belarus,England,2008,1,3,4
Belgium,Spain,2008,1,2,3
Bosnia and Herzegovina,Armenia,2008,4,1,5
Brazil,Colombia,2008,0,0,0
Canada,Mexico,2008,2,2,4
Chile,Argentina,2008,1,0,1
Costa Rica,Haiti,2008,2,0,2
Croatia,Andorra,2008,4,0,4
Cuba,Guatemala,2008,2,1,3
Czech Republic,Slovenia,2008,1,0,1
El Salvador,Suriname,2008,3,0,3
Estonia,Turkey,2008,0,0,0
Georgia,Bulgaria,2008,0,0,0
Germany,Wales,2008,1,0,1
Greece,Switzerland,2008,1,2,3
Grenada,Cayman Islands,2008,4,2,6
Guadeloupe,Martinique,2008,3,1,4
Iceland,North Macedonia,2008,1,0,1
Iran,North Korea,2008,2,1,3
Republic of Ireland,Cyprus,2008,1,0,1
Italy,Montenegro,2008,2,1,3
Jamaica,Honduras,2008,1,0,1
Japan,Uzbekistan,2008,1,1,2
South Korea,United Arab Emirates,2008,4,1,5
Latvia,Israel,2008,1,1,2
Lithuania,Faroe Islands,2008,1,0,1
Luxembourg,Moldova,2008,0,0,0
Malaysia,Nepal,2008,4,0,4
Malta,Hungary,2008,0,1,1
Northern Ireland,San Marino,2008,4,0,4
Norway,Netherlands,2008,0,1,1
Paraguay,Peru,2008,1,0,1
Portugal,Albania,2008,0,0,0
Russia,Finland,2008,3,0,3
Slovakia,Poland,2008,2,1,3
South Africa,Ghana,2008,2,1,3
Trinidad and Tobago,United States,2008,2,1,3
Venezuela,Ecuador,2008,3,1,4
Cambodia,Laos,2008,3,2,5
Nepal,Afghanistan,2008,2,2,4
Philippines,Timor-Leste,2008,1,0,1
Bangladesh,Myanmar,2008,0,1,1
Brunei,Philippines,2008,1,1,2
Cambodia,Timor-Leste,2008,2,2,4
Malaysia,Afghanistan,2008,6,0,6
Timor-Leste,Brunei,2008,1,4,5
Philippines,Laos,2008,1,2,3
Bolivia,El Salvador,2008,0,2,2
Barbados,Suriname,2008,3,2,5
Cambodia,Philippines,2008,2,3,5
Cuba,Curaçao,2008,7,1,8
Laos,Brunei,2008,3,2,5
Malaysia,Myanmar,2008,4,0,4
Cambodia,Brunei,2008,2,1,3
Cuba,Barbados,2008,1,1,2
Laos,Timor-Leste,2008,2,1,3
Suriname,Curaçao,2008,2,1,3
Palestine,Jordan,2008,1,1,2
Cuba,Suriname,2008,6,0,6
Curaçao,Barbados,2008,1,2,3
Thailand,North Korea,2008,1,0,1
Vietnam,North Korea,2008,0,0,0
Guyana,Saint Kitts and Nevis,2008,1,1,2
Trinidad and Tobago,Antigua and Barbuda,2008,3,2,5
Antigua and Barbuda,Guyana,2008,2,1,3
Trinidad and Tobago,Saint Kitts and Nevis,2008,3,1,4
Jersey,Gibraltar,2008,2,1,3
Saudi Arabia,Thailand,2008,1,0,1
Cayman Islands,Jamaica,2008,0,2,2
Qatar,Iran,2008,0,1,1
Saint Kitts and Nevis,Antigua and Barbuda,2008,3,4,7
Trinidad and Tobago,Guyana,2008,1,1,2
Myanmar,Bangladesh,2008,0,0,0
Estonia,Latvia,2008,1,1,2
Mexico,Ecuador,2008,2,1,3
Saudi Arabia,Bahrain,2008,4,0,4
Bangladesh,Indonesia,2008,0,2,2
Japan,Syria,2008,3,1,4
Myanmar,Indonesia,2008,2,1,3
Vietnam,Thailand,2008,2,2,4
Algeria,Mali,2008,1,1,2
Myanmar,Malaysia,2008,4,1,5
Estonia,Moldova,2008,1,0,1
Gabon,Guinea,2008,3,3,6
Austria,Turkey,2008,2,4,6
Azerbaijan,Albania,2008,1,1,2
Bahrain,Australia,2008,0,1,1
Brazil,Portugal,2008,6,2,8
Colombia,Nigeria,2008,1,0,1
Cyprus,Belarus,2008,2,1,3
Denmark,Wales,2008,0,1,1
Egypt,Benin,2008,5,1,6
El Salvador,Costa Rica,2008,1,3,4
Fiji,New Zealand,2008,2,0,2
France,Uruguay,2008,0,0,0
Germany,England,2008,1,2,3
Ghana,Tunisia,2008,0,0,0
Greece,Italy,2008,1,1,2
Honduras,Mexico,2008,1,0,1
Republic of Ireland,Poland,2008,2,3,5
Israel,Ivory Coast,2008,2,2,4
Jamaica,Canada,2008,3,0,3
Luxembourg,Belgium,2008,1,1,2
Macau,Hong Kong,2008,1,9,10
Malta,Iceland,2008,0,1,1
Moldova,Lithuania,2008,1,1,2
Montenegro,North Macedonia,2008,2,1,3
Morocco,Zambia,2008,3,0,3
Netherlands,Sweden,2008,3,1,4
Northern Ireland,Hungary,2008,0,2,2
Oman,Paraguay,2008,0,1,1
Qatar,Japan,2008,0,3,3
Romania,Georgia,2008,2,1,3
San Marino,Czech Republic,2008,0,3,3
Saudi Arabia,South Korea,2008,0,2,2
Scotland,Argentina,2008,0,1,1
Serbia,Bulgaria,2008,6,1,7
Slovakia,Liechtenstein,2008,4,0,4
Slovenia,Bosnia and Herzegovina,2008,3,4,7
South Africa,Cameroon,2008,3,2,5
Spain,Chile,2008,3,0,3
Suriname,Haiti,2008,1,1,2
Switzerland,Finland,2008,1,0,1
Tanzania,Mozambique,2008,1,0,1
Togo,Rwanda,2008,1,0,1
Trinidad and Tobago,Cuba,2008,3,0,3
Ukraine,Norway,2008,1,0,1
United Arab Emirates,Iran,2008,1,1,2
United States,Guatemala,2008,2,0,2
Venezuela,Angola,2008,0,0,0
Myanmar,Indonesia,2008,2,1,3
Estonia,Lithuania,2008,1,1,2
Malaysia,Singapore,2008,2,2,4
Jamaica,Barbados,2008,2,1,3
Trinidad and Tobago,Grenada,2008,1,2,3
Guadeloupe,Cuba,2008,1,2,3
Haiti,Antigua and Barbuda,2008,1,1,2
Barbados,Trinidad and Tobago,2008,1,2,3
Indonesia,Myanmar,2008,3,0,3
Jamaica,Grenada,2008,4,0,4
Singapore,Cambodia,2008,5,0,5
Cuba,Antigua and Barbuda,2008,3,0,3
Haiti,Guadeloupe,2008,2,3,5
Malaysia,Laos,2008,3,0,3
Thailand,Vietnam,2008,2,0,2
Grenada,Barbados,2008,4,2,6
Indonesia,Cambodia,2008,4,0,4
Jamaica,Trinidad and Tobago,2008,1,1,2
Singapore,Myanmar,2008,3,1,4
Antigua and Barbuda,Guadeloupe,2008,2,2,4
Cuba,Haiti,2008,0,1,1
Malaysia,Vietnam,2008,2,3,5
Thailand,Laos,2008,6,0,6
Myanmar,Cambodia,2008,3,2,5
Indonesia,Singapore,2008,0,2,2
Thailand,Malaysia,2008,3,0,3
Vietnam,Laos,2008,4,0,4
Cuba,Grenada,2008,2,2,4
Jamaica,Guadeloupe,2008,2,0,2
Cuba,Guadeloupe,2008,0,0,0
Jamaica,Grenada,2008,2,0,2
Serbia,Poland,2008,0,1,1
Indonesia,Thailand,2008,0,1,1
Iran,Ecuador,2008,0,1,1
Oman,China PR,2008,3,1,4
Vietnam,Singapore,2008,0,0,0
Iran,China PR,2008,2,0,2
Oman,Ecuador,2008,2,0,2
Jordan,China PR,2008,0,1,1
Bahrain,Saudi Arabia,2008,1,0,1
Djibouti,Somalia,2008,2,3,5
Thailand,Vietnam,2008,1,2,3
Saudi Arabia,Syria,2008,1,1,2
United Arab Emirates,Iraq,2008,2,2,4
Galicia,Iran,2008,3,2,5
Vietnam,Thailand,2008,1,1,2
Catalonia,Colombia,2008,2,1,3
Bahrain,Syria,2008,2,2,4
United Arab Emirates,Kuwait,2008,0,0,0
Sudan,Kenya,2008,0,0,0
Zambia,Djibouti,2008,3,0,3
Uganda,Rwanda,2009,4,0,4
Zanzibar,Somalia,2009,2,0,2
Djibouti,Burundi,2009,0,4,4
Kenya,Zambia,2009,0,0,0
Somalia,Tanzania,2009,1,0,1
Uganda,Zanzibar,2009,0,0,0
Bahrain,Iraq,2009,3,1,4
Djibouti,Sudan,2009,1,1,2
Oman,Kuwait,2009,0,0,0
Zambia,Burundi,2009,1,1,2
Rwanda,Somalia,2009,3,0,3
Saudi Arabia,Qatar,2009,0,0,0
Tanzania,Zanzibar,2009,2,1,3
United Arab Emirates,Yemen,2009,3,1,4
Burundi,Sudan,2009,1,0,1
Kenya,Djibouti,2009,5,1,6
Bahrain,Kuwait,2009,0,1,1
Oman,Iraq,2009,4,0,4
Rwanda,Tanzania,2009,0,2,2
Uganda,Somalia,2009,4,0,4
Burundi,Kenya,2009,0,1,1
Qatar,United Arab Emirates,2009,0,0,0
Saudi Arabia,Yemen,2009,6,0,6
Sudan,Zambia,2009,2,0,2
Iran,China PR,2009,3,1,4
Uganda,Tanzania,2009,2,1,3
Zanzibar,Rwanda,2009,0,3,3
Iraq,Kuwait,2009,1,1,2
Oman,Bahrain,2009,2,0,2
Kenya,Tanzania,2009,2,1,3
Qatar,Yemen,2009,2,1,3
Uganda,Burundi,2009,5,0,5
United Arab Emirates,Saudi Arabia,2009,0,3,3
Tanzania,Burundi,2009,3,2,5
Uganda,Kenya,2009,1,0,1
Hong Kong,India,2009,2,1,3
Iran,Singapore,2009,6,0,6
Jordan,Thailand,2009,0,0,0
Kuwait,Saudi Arabia,2009,0,1,1
Oman,Qatar,2009,1,0,1
Syria,China PR,2009,3,2,5
Vietnam,Lebanon,2009,3,1,4
Guatemala,Haiti,2009,1,0,1
Oman,Saudi Arabia,2009,0,0,0
Honduras,Chile,2009,2,0,2
Syria,Turkmenistan,2009,5,1,6
Oman,Indonesia,2009,0,0,0
Japan,Yemen,2009,2,1,3
Kuwait,Turkmenistan,2009,2,0,2
China PR,Vietnam,2009,6,1,7
Hong Kong,Bahrain,2009,1,3,4
Malaysia,United Arab Emirates,2009,0,5,5
Thailand,Lebanon,2009,2,1,3
El Salvador,Nicaragua,2009,1,1,2
Honduras,Belize,2009,2,1,3
Costa Rica,Panama,2009,3,0,3
Egypt,Kenya,2009,1,0,1
North Korea,Lebanon,2009,0,1,1
Kuwait,Syria,2009,2,3,5
Belize,El Salvador,2009,1,4,5
Honduras,Nicaragua,2009,4,1,5
United States,Sweden,2009,3,2,5
Guatemala,Costa Rica,2009,1,3,4
Honduras,El Salvador,2009,2,0,2
Nicaragua,Belize,2009,1,1,2
Panama,Guatemala,2009,1,0,1
South Africa,Zambia,2009,1,0,1
Bahrain,Japan,2009,1,0,1
Indonesia,Australia,2009,0,0,0
Kuwait,Oman,2009,0,1,1
Lebanon,Syria,2009,0,2,2
Mexico,Sweden,2009,0,1,1
Singapore,Jordan,2009,2,1,3
Thailand,Iran,2009,0,0,0
United Arab Emirates,Uzbekistan,2009,0,1,1
Yemen,Hong Kong,2009,1,0,1
Nicaragua,Guatemala,2009,2,0,2
Costa Rica,El Salvador,2009,3,0,3
Honduras,Panama,2009,0,1,1
Azerbaijan,Uzbekistan,2009,1,1,2
Costa Rica,Panama,2009,0,0,0
Honduras,El Salvador,2009,1,0,1
Syria,South Korea,2009,1,1,2
Bahrain,South Korea,2009,2,2,4
Japan,Finland,2009,5,1,6
Saudi Arabia,Thailand,2009,2,1,3
El Salvador,Peru,2009,1,0,1
Lithuania,Poland,2009,1,1,2
Barbados,Grenada,2009,5,0,5
Brazil,Italy,2009,2,0,2
Cyprus,Serbia,2009,0,2,2
Slovakia,Ukraine,2009,2,3,5
Algeria,Benin,2009,2,1,3
Andorra,Lithuania,2009,1,3,4
Angola,Mali,2009,0,4,4
Austria,Sweden,2009,0,2,2
Belgium,Slovenia,2009,2,0,2
Burkina Faso,Togo,2009,1,1,2
Cameroon,Guinea,2009,3,1,4
Colombia,Haiti,2009,2,0,2
Costa Rica,Honduras,2009,2,0,2
Cyprus,Slovakia,2009,3,2,5
Egypt,Ghana,2009,2,2,4
El Salvador,Trinidad and Tobago,2009,2,2,4
Estonia,Kazakhstan,2009,0,2,2
France,Argentina,2009,0,2,2
Germany,Norway,2009,0,1,1
Greece,Denmark,2009,1,1,2
Iran,South Korea,2009,1,1,2
Republic of Ireland,Georgia,2009,2,1,3
Israel,Hungary,2009,1,0,1
Japan,Australia,2009,0,0,0
North Korea,Saudi Arabia,2009,1,0,1
Kuwait,Azerbaijan,2009,1,1,2
Latvia,Armenia,2009,0,0,0
Libya,Uruguay,2009,2,3,5
Liechtenstein,Iceland,2009,0,2,2
North Macedonia,Moldova,2009,1,1,2
Malta,Albania,2009,0,0,0
Morocco,Czech Republic,2009,0,0,0
Mozambique,Malawi,2009,2,0,2
Nigeria,Jamaica,2009,0,0,0
Peru,Paraguay,2009,0,1,1
Portugal,Finland,2009,1,0,1
Romania,Croatia,2009,1,2,3
San Marino,Northern Ireland,2009,0,3,3
Serbia,Ukraine,2009,0,1,1
South Africa,Chile,2009,0,2,2
Spain,England,2009,2,0,2
Switzerland,Bulgaria,2009,1,1,2
Tanzania,Zimbabwe,2009,0,0,0
Tunisia,Netherlands,2009,1,1,2
Turkey,Ivory Coast,2009,1,1,2
United States,Mexico,2009,2,0,2
Uzbekistan,Bahrain,2009,0,1,1
Venezuela,Guatemala,2009,2,1,3
Wales,Poland,2009,0,1,1
Australia,Kuwait,2009,0,1,1
Sudan,Uganda,2009,0,2,2
Guam,Mongolia,2009,1,0,1
Macau,Northern Mariana Islands,2009,6,1,7
Mexico,Bolivia,2009,5,1,6
Nepal,Pakistan,2009,1,0,1
Guam,Northern Mariana Islands,2009,2,1,3
Macau,Mongolia,2009,1,2,3
Iran,Kenya,2009,1,0,1
Nepal,Sri Lanka,2009,4,2,6
Guam,Macau,2009,2,2,4
Northern Mariana Islands,Mongolia,2009,1,4,5
Qatar,Kuwait,2009,1,0,1
Trinidad and Tobago,Panama,2009,1,0,1
Namibia,Botswana,2009,0,0,0
Syria,Qatar,2009,1,2,3
Uganda,Malawi,2009,2,1,3
Iceland,Faroe Islands,2009,1,2,3
Saudi Arabia,Iraq,2009,0,0,0
Bahrain,Zimbabwe,2009,5,2,7
Kuwait,Iran,2009,0,1,1
Angola,Cape Verde,2009,0,1,1
Nepal,Palestine,2009,0,0,0
Albania,Hungary,2009,0,1,1
Argentina,Venezuela,2009,4,0,4
Armenia,Estonia,2009,2,2,4
Belgium,Bosnia and Herzegovina,2009,2,4,6
Burkina Faso,Guinea,2009,4,2,6
Cape Verde,Equatorial Guinea,2009,5,0,5
Colombia,Bolivia,2009,2,0,2
Cyprus,Georgia,2009,2,1,3
El Salvador,United States,2009,2,2,4
England,Slovakia,2009,4,0,4
Germany,Liechtenstein,2009,4,0,4
Iran,Saudi Arabia,2009,1,2,3
Republic of Ireland,Bulgaria,2009,1,1,2
Israel,Greece,2009,1,1,2
Japan,Bahrain,2009,1,0,1
Kenya,Tunisia,2009,1,2,3
North Korea,United Arab Emirates,2009,2,0,2
South Korea,Iraq,2009,2,1,3
Lithuania,France,2009,0,1,1
Luxembourg,Latvia,2009,0,4,4
Malta,Denmark,2009,0,3,3
Mexico,Costa Rica,2009,2,0,2
Moldova,Switzerland,2009,0,2,2
Montenegro,Italy,2009,0,2,2
Morocco,Gabon,2009,1,2,3
Nepal,Kyrgyzstan,2009,1,1,2
Netherlands,Scotland,2009,3,0,3
Northern Ireland,Poland,2009,3,2,5
Oman,Senegal,2009,2,0,2
Portugal,Sweden,2009,0,0,0
Romania,Serbia,2009,2,3,5
Russia,Azerbaijan,2009,2,0,2
Rwanda,Algeria,2009,0,0,0
Slovenia,Czech Republic,2009,0,0,0
South Africa,Norway,2009,2,1,3
Spain,Turkey,2009,1,0,1
Sri Lanka,Maldives,2009,1,1,2
Sudan,Mali,2009,1,1,2
Thailand,New Zealand,2009,3,1,4
Togo,Cameroon,2009,1,0,1
Trinidad and Tobago,Honduras,2009,1,1,2
Uruguay,Paraguay,2009,2,0,2
Uzbekistan,Qatar,2009,4,0,4
Wales,Finland,2009,0,2,2
Ivory Coast,Malawi,2009,5,0,5
Ecuador,Brazil,2009,1,1,2
Peru,Chile,2009,1,3,4
Kyrgyzstan,Palestine,2009,1,1,2
Angola,Morocco,2009,0,2,2
Panama,Haiti,2009,4,0,4
Portugal,South Africa,2009,2,0,2
Venezuela,Colombia,2009,2,0,2
Andorra,Croatia,2009,0,2,2
Australia,Uzbekistan,2009,2,0,2
Austria,Romania,2009,2,1,3
Bahrain,Qatar,2009,1,0,1
Bosnia and Herzegovina,Belgium,2009,2,1,3
Bulgaria,Cyprus,2009,2,0,2
Costa Rica,El Salvador,2009,1,0,1
Czech Republic,Slovakia,2009,1,2,3
Denmark,Albania,2009,3,0,3
England,Ukraine,2009,2,1,3
Estonia,Armenia,2009,1,0,1
France,Lithuania,2009,1,0,1
Georgia,Montenegro,2009,0,0,0
Greece,Israel,2009,2,1,3
Honduras,Mexico,2009,3,1,4
Hungary,Malta,2009,3,0,3
Iran,Senegal,2009,1,1,2
Italy,Republic of Ireland,2009,1,1,2
Kazakhstan,Belarus,2009,1,5,6
South Korea,North Korea,2009,1,0,1
Latvia,Luxembourg,2009,2,0,2
Lebanon,Namibia,2009,1,1,2
Lesotho,Botswana,2009,0,0,0
Liechtenstein,Russia,2009,0,1,1
Netherlands,North Macedonia,2009,4,0,4
Northern Ireland,Slovenia,2009,1,0,1
Norway,Finland,2009,3,2,5
Poland,San Marino,2009,10,0,10
Saudi Arabia,United Arab Emirates,2009,3,2,5
Scotland,Iceland,2009,2,1,3
Serbia,Sweden,2009,2,0,2
Switzerland,Moldova,2009,2,0,2
Turkey,Spain,2009,1,2,3
United States,Trinidad and Tobago,2009,3,0,3
Wales,Germany,2009,0,2,2
Bolivia,Argentina,2009,6,1,7
Ecuador,Paraguay,2009,1,1,2
Chile,Uruguay,2009,0,0,0
Brazil,Peru,2009,3,0,3
Angola,Namibia,2009,0,0,0
Pakistan,Taiwan,2009,1,1,2
Sri Lanka,Brunei,2009,5,1,6
Brunei,Pakistan,2009,0,6,6
Macau,Mongolia,2009,2,0,2
Sri Lanka,Pakistan,2009,2,2,4
Maldives,Turkmenistan,2009,1,3,4
Mongolia,Macau,2009,3,1,4
Philippines,Bhutan,2009,1,0,1
Bhutan,Turkmenistan,2009,0,7,7
Maldives,Philippines,2009,3,2,5
Maldives,Bhutan,2009,5,0,5
Turkmenistan,Philippines,2009,5,0,5
French Guiana,Suriname,2009,0,0,0
Bangladesh,Cambodia,2009,1,0,1
Myanmar,Macau,2009,4,0,4
Bangladesh,Myanmar,2009,1,2,3
Macau,Cambodia,2009,1,2,3
Bangladesh,Macau,2009,3,0,3
Myanmar,Cambodia,2009,1,0,1
Guernsey,Jersey,2009,0,1,1
Tanzania,DR Congo,2009,0,2,2
Jordan,Zimbabwe,2009,2,0,2
Venezuela,Costa Rica,2009,1,1,2
Argentina,Panama,2009,3,1,4
Jamaica,Haiti,2009,2,2,4
Qatar,Saudi Arabia,2009,2,1,3
El Salvador,Ecuador,2009,3,1,4
Japan,Chile,2009,4,0,4
Jordan,Congo,2009,1,1,2
Tunisia,Sudan,2009,4,0,4
Belgium,Chile,2009,1,1,2
China PR,Germany,2009,1,1,2
Republic of Ireland,Nigeria,2009,1,1,2
Wales,Estonia,2009,1,0,1
Cyprus,Canada,2009,0,1,1
El Salvador,Jamaica,2009,0,0,0
Oman,Egypt,2009,0,1,1
Bahrain,Congo,2009,3,1,4
Ghana,Uganda,2009,2,1,3
Japan,Belgium,2009,4,0,4
Kuwait,Vietnam,2009,0,1,1
Malawi,Rwanda,2009,2,0,2
Qatar,Iraq,2009,1,0,1
China PR,Iran,2009,1,0,1
Uzbekistan,Bosnia and Herzegovina,2009,0,0,0
France,Nigeria,2009,0,1,1
Turkey,Azerbaijan,2009,2,0,2
United Arab Emirates,Germany,2009,2,7,9
Antigua and Barbuda,Guyana,2009,2,1,3
Bahrain,Jordan,2009,4,0,4
Costa Rica,United States,2009,3,1,4
Tanzania,New Zealand,2009,2,1,3
China PR,Saudi Arabia,2009,1,4,5
Antigua and Barbuda,French Guiana,2009,1,2,3
Czech Republic,Malta,2009,1,0,1
France,Turkey,2009,1,0,1
Albania,Portugal,2009,1,2,3
Argentina,Colombia,2009,1,0,1
Azerbaijan,Wales,2009,0,1,1
Belarus,Andorra,2009,5,1,6
Bolivia,Venezuela,2009,0,1,1
Botswana,New Zealand,2009,0,0,0
Bulgaria,Republic of Ireland,2009,1,1,2
Croatia,Ukraine,2009,2,2,4
Cyprus,Montenegro,2009,2,2,4
El Salvador,Mexico,2009,2,1,3
Estonia,Equatorial Guinea,2009,3,0,3
Finland,Liechtenstein,2009,2,1,3
Gabon,Togo,2009,3,0,3
Georgia,Moldova,2009,1,2,3
Iceland,Netherlands,2009,1,2,3
Italy,Northern Ireland,2009,3,0,3
Kazakhstan,England,2009,0,4,4
North Korea,Iran,2009,0,0,0
Lithuania,Romania,2009,0,1,1
North Macedonia,Norway,2009,0,0,0
Malawi,Burkina Faso,2009,0,1,1
Namibia,DR Congo,2009,4,0,4
Paraguay,Chile,2009,0,2,2
Qatar,Australia,2009,0,0,0
Serbia,Austria,2009,1,0,1
Slovakia,San Marino,2009,7,0,7
South Africa,Poland,2009,1,0,1
Sweden,Denmark,2009,0,1,1
Trinidad and Tobago,Costa Rica,2009,2,3,5
Tunisia,Mozambique,2009,2,0,2
United Arab Emirates,South Korea,2009,0,2,2
Uruguay,Brazil,2009,0,4,4
United States,Honduras,2009,2,1,3
Uzbekistan,Japan,2009,0,1,1
Zambia,Rwanda,2009,1,0,1
Corsica,Congo,2009,1,1,2
Guinea,Ivory Coast,2009,1,2,3
Guyana,French Guiana,2009,2,3,5
Jamaica,Panama,2009,3,2,5
Peru,Ecuador,2009,1,2,3
Azerbaijan,Spain,2009,0,6,6
Bosnia and Herzegovina,Oman,2009,2,1,3
Iraq,Poland,2009,1,1,2
Albania,Georgia,2009,1,1,2
Australia,Bahrain,2009,2,0,2
Belarus,Moldova,2009,2,2,4
Brazil,Paraguay,2009,2,1,3
Chile,Bolivia,2009,4,0,4
Colombia,Peru,2009,1,0,1
Ecuador,Argentina,2009,2,0,2
England,Andorra,2009,6,0,6
Estonia,Portugal,2009,0,0,0
Faroe Islands,Serbia,2009,0,2,2
Finland,Russia,2009,0,3,3
Honduras,El Salvador,2009,1,0,1
Iran,United Arab Emirates,2009,1,0,1
Italy,New Zealand,2009,4,3,7
Japan,Qatar,2009,1,1,2
South Korea,Saudi Arabia,2009,0,0,0
North Macedonia,Iceland,2009,2,0,2
Mexico,Trinidad and Tobago,2009,2,1,3
Netherlands,Norway,2009,2,0,2
Sweden,Malta,2009,4,0,4
Ukraine,Kazakhstan,2009,2,1,3
Venezuela,Uruguay,2009,2,2,4
Tonga,Cook Islands,2009,1,1,2
Ivory Coast,Cameroon,2009,2,1,3
Tonga,Cook Islands,2009,1,2,3
Madagascar,Mayotte,2009,2,0,2
New Zealand,Spain,2009,0,5,5
South Africa,Iraq,2009,0,0,0
Brazil,Egypt,2009,4,3,7
United States,Italy,2009,1,3,4
Australia,Japan,2009,2,1,3
Bahrain,Uzbekistan,2009,1,0,1
South Korea,Iran,2009,1,1,2
Saudi Arabia,North Korea,2009,0,0,0
South Africa,New Zealand,2009,2,0,2
Spain,Iraq,2009,1,0,1
Egypt,Italy,2009,1,0,1
United States,Brazil,2009,0,3,3
Haiti,Panama,2009,1,1,2
Eswatini,Lesotho,2009,1,1,2
Burkina Faso,Ivory Coast,2009,2,3,5
Iraq,New Zealand,2009,0,0,0
Kenya,Mozambique,2009,2,1,3
Morocco,Togo,2009,0,0,0
South Africa,Spain,2009,0,2,2
Sudan,Ghana,2009,0,2,2
Tunisia,Nigeria,2009,0,0,0
Zambia,Algeria,2009,0,2,2
Egypt,United States,2009,0,3,3
Italy,Brazil,2009,0,3,3
Eswatini,Lesotho,2009,1,1,2
Padania,Occitania,2009,1,0,1
Provence,Gozo,2009,3,1,4
Haiti,Martinique,2009,0,0,0
Occitania,Iraqi Kurdistan,2009,0,4,4
Sápmi,Provence,2009,1,2,3
Mexico,Venezuela,2009,4,0,4
Spain,United States,2009,0,2,2
Padania,Iraqi Kurdistan,2009,2,1,3
Sápmi,Gozo,2009,7,2,9
South Africa,Brazil,2009,0,1,1
Provence,Iraqi Kurdistan,2009,0,6,6
Padania,Sápmi,2009,4,0,4
Occitania,Gozo,2009,2,1,3
Provence,Sápmi,2009,4,4,8
Costa Rica,Venezuela,2009,1,0,1
Haiti,Syria,2009,1,2,3
Padania,Iraqi Kurdistan,2009,2,0,2
Cayman Islands,Jamaica,2009,1,4,5
Grenada,Antigua and Barbuda,2009,2,2,4
Mexico,Guatemala,2009,0,0,0
Panama,Honduras,2009,0,2,2
South Africa,Spain,2009,2,3,5
United States,Brazil,2009,2,3,5
Åland Islands,Greenland,2009,4,2,6
Shetland,Menorca,2009,2,2,4
Gibraltar,Guernsey,2009,0,0,0
Ynys Môn,Frøya,2009,3,0,3
Rhodes,Isle of Wight,2009,2,0,2
Saare County,Jersey,2009,0,1,1
Western Isles,Gotland,2009,2,1,3
Falkland Islands,Isle of Man,2009,1,2,3
Menorca,Greenland,2009,6,0,6
Åland Islands,Shetland,2009,2,1,3
Ynys Môn,Guernsey,2009,0,2,2
Frøya,Gibraltar,2009,0,8,8
Jersey,Rhodes,2009,1,0,1
Isle of Wight,Saare County,2009,5,1,6
Isle of Man,Western Isles,2009,5,0,5
Gotland,Falkland Islands,2009,2,0,2
Guatemala,Canada,2009,0,3,3
Greenland,Shetland,2009,3,1,4
Åland Islands,Menorca,2009,1,1,2
Gibraltar,Ynys Môn,2009,1,3,4
Guernsey,Frøya,2009,8,0,8
Rhodes,Saare County,2009,3,0,3
Jersey,Isle of Wight,2009,4,1,5
Western Isles,Falkland Islands,2009,7,1,8
Isle of Man,Gotland,2009,4,2,6
Falkland Islands,Frøya,2009,1,3,4
Shetland,Saare County,2009,3,2,5
Gotland,Greenland,2009,4,2,6
Åland Islands,Isle of Man,2009,2,1,3
Guernsey,Jersey,2009,0,2,2
Canada,Jamaica,2009,1,0,1
Costa Rica,El Salvador,2009,1,2,3
Gibraltar,Isle of Wight,2009,3,0,3
Menorca,Western Isles,2009,4,1,5
Rhodes,Ynys Môn,2009,4,0,4
Isle of Man,Guernsey,2009,0,5,5
Åland Islands,Jersey,2009,1,2,3
Honduras,Haiti,2009,1,0,1
United States,Grenada,2009,4,0,4
Botswana,Iran,2009,1,1,2
Egypt,Rwanda,2009,3,0,3
Nicaragua,Mexico,2009,0,2,2
Panama,Guadeloupe,2009,1,2,3
Malawi,Eswatini,2009,3,1,4
El Salvador,Canada,2009,0,1,1
Jamaica,Costa Rica,2009,0,1,1
Haiti,Grenada,2009,2,0,2
United States,Honduras,2009,2,0,2
Guadeloupe,Nicaragua,2009,2,0,2
Mexico,Panama,2009,1,1,2
Costa Rica,Canada,2009,2,2,4
El Salvador,Jamaica,2009,0,1,1
Iraq,Palestine,2009,3,0,3
Honduras,Grenada,2009,4,0,4
United States,Haiti,2009,2,2,4
Mayotte,Madagascar,2009,2,2,4
Mexico,Guadeloupe,2009,2,0,2
Panama,Nicaragua,2009,4,0,4
Saint Kitts and Nevis,Trinidad and Tobago,2009,2,3,5
Iraq,Palestine,2009,4,0,4
Canada,Honduras,2009,0,1,1
China PR,Palestine,2009,3,1,4
United States,Panama,2009,2,1,3
Guadeloupe,Costa Rica,2009,1,5,6
Mexico,Haiti,2009,4,0,4
Costa Rica,Mexico,2009,1,1,2
United States,Honduras,2009,2,0,2
China PR,Kyrgyzstan,2009,3,0,3
United States,Mexico,2009,0,5,5
Colombia,El Salvador,2009,2,1,3
Benin,Gabon,2009,1,1,2
Albania,Cyprus,2009,6,1,7
Algeria,Uruguay,2009,1,0,1
Armenia,Moldova,2009,1,4,5
Austria,Cameroon,2009,0,2,2
Azerbaijan,Germany,2009,0,2,2
Belarus,Croatia,2009,1,3,4
Bosnia and Herzegovina,Iran,2009,2,3,5
Bulgaria,Latvia,2009,1,0,1
Colombia,Venezuela,2009,1,2,3
DR Congo,Senegal,2009,1,2,3
Czech Republic,Belgium,2009,3,1,4
Denmark,Chile,2009,1,2,3
Ecuador,Jamaica,2009,0,0,0
Egypt,Guinea,2009,3,3,6
Estonia,Brazil,2009,0,1,1
Faroe Islands,France,2009,0,1,1
Ghana,Zambia,2009,4,1,5
Honduras,Costa Rica,2009,4,0,4
Hungary,Romania,2009,0,1,1
Iceland,Slovakia,2009,1,1,2
Republic of Ireland,Australia,2009,0,3,3
South Korea,Paraguay,2009,1,0,1
Liechtenstein,Portugal,2009,0,3,3
Luxembourg,Lithuania,2009,0,1,1
North Macedonia,Spain,2009,2,3,5
Malaysia,Kenya,2009,0,0,0
Mali,Burkina Faso,2009,3,0,3
Malta,Georgia,2009,2,0,2
Mexico,United States,2009,2,1,3
Montenegro,Wales,2009,2,1,3
Morocco,Congo,2009,1,1,2
Mozambique,Eswatini,2009,1,0,1
Netherlands,England,2009,2,2,4
Northern Ireland,Israel,2009,1,1,2
Norway,Scotland,2009,4,0,4
Oman,Saudi Arabia,2009,2,1,3
Poland,Greece,2009,2,0,2
Russia,Argentina,2009,2,3,5
Rwanda,Tanzania,2009,1,2,3
Singapore,China PR,2009,1,1,2
Slovenia,San Marino,2009,5,0,5
South Africa,Serbia,2009,1,3,4
Sweden,Finland,2009,1,0,1
Switzerland,Italy,2009,0,0,0
Togo,Angola,2009,0,2,2
Trinidad and Tobago,El Salvador,2009,1,0,1
Tunisia,Ivory Coast,2009,0,0,0
Ukraine,Turkey,2009,0,3,3
Zimbabwe,Lesotho,2009,1,1,2
Malaysia,China PR,2009,0,0,0
Saint Kitts and Nevis,Jamaica,2009,0,1,1
India,Lebanon,2009,0,1,1
Syria,Kyrgyzstan,2009,2,0,2
Sri Lanka,Lebanon,2009,4,3,7
India,Kyrgyzstan,2009,2,1,3
North Korea,Guam,2009,9,2,11
Syria,Sri Lanka,2009,4,0,4
Hong Kong,North Korea,2009,0,0,0
Kyrgyzstan,Lebanon,2009,1,1,2
Bahrain,Kenya,2009,2,1,3
India,Sri Lanka,2009,3,1,4
Hong Kong,Guam,2009,12,0,12
Syria,Lebanon,2009,1,0,1
Sri Lanka,Kyrgyzstan,2009,1,4,5
India,Syria,2009,0,1,1
Saudi Arabia,Malaysia,2009,2,1,3
Bahrain,Iran,2009,4,2,6
India,Syria,2009,1,1,2
Malta,Cape Verde,2009,0,2,2
Angola,Senegal,2009,1,1,2
Argentina,Brazil,2009,1,3,4
Armenia,Bosnia and Herzegovina,2009,0,2,2
Austria,Faroe Islands,2009,3,1,4
Azerbaijan,Finland,2009,1,2,3
Bahrain,Saudi Arabia,2009,0,0,0
Bulgaria,Montenegro,2009,4,1,5
Chile,Venezuela,2009,2,2,4
Colombia,Ecuador,2009,2,0,2
Costa Rica,Mexico,2009,0,3,3
Croatia,Belarus,2009,1,0,1
Cyprus,Republic of Ireland,2009,1,2,3
Denmark,Portugal,2009,1,1,2
England,Slovenia,2009,2,1,3
France,Romania,2009,1,1,2
Gabon,Cameroon,2009,0,2,2
Georgia,Italy,2009,0,2,2
Germany,South Africa,2009,2,0,2
Honduras,Trinidad and Tobago,2009,4,1,5
Hungary,Sweden,2009,1,2,3
Iceland,Norway,2009,1,1,2
Israel,Latvia,2009,0,1,1
Ivory Coast,Burkina Faso,2009,5,0,5
Jordan,Malaysia,2009,0,0,0
South Korea,Australia,2009,3,1,4
Malawi,Guinea,2009,2,1,3
Moldova,Luxembourg,2009,0,0,0
Namibia,Eswatini,2009,1,1,2
Netherlands,Japan,2009,3,0,3
Paraguay,Bolivia,2009,1,0,1
Peru,Uruguay,2009,1,0,1
Poland,Northern Ireland,2009,1,1,2
Russia,Liechtenstein,2009,3,0,3
Rwanda,Egypt,2009,0,1,1
Scotland,North Macedonia,2009,2,0,2
Slovakia,Czech Republic,2009,2,2,4
Spain,Belgium,2009,5,0,5
Saint Vincent and the Grenadines,Saint Kitts and Nevis,2009,0,3,3
Switzerland,Greece,2009,2,0,2
Turkey,Estonia,2009,4,2,6
Ukraine,Andorra,2009,5,0,5
United States,El Salvador,2009,2,1,3
Uzbekistan,Iran,2009,0,0,0
Algeria,Zambia,2009,1,0,1
Benin,Mali,2009,1,1,2
Ghana,Sudan,2009,2,0,2
Mozambique,Kenya,2009,1,0,1
Nigeria,Tunisia,2009,2,2,4
Togo,Morocco,2009,1,1,2
Republic of Ireland,South Africa,2009,1,0,1
Albania,Denmark,2009,1,1,2
Andorra,Kazakhstan,2009,1,3,4
Angola,Cape Verde,2009,1,1,2
Armenia,Belgium,2009,2,1,3
Belarus,Ukraine,2009,0,0,0
Bolivia,Ecuador,2009,1,3,4
Bosnia and Herzegovina,Turkey,2009,1,1,2
Cameroon,Gabon,2009,2,1,3
Czech Republic,San Marino,2009,7,0,7
El Salvador,Costa Rica,2009,1,0,1
England,Croatia,2009,5,1,6
Faroe Islands,Lithuania,2009,2,1,3
Germany,Azerbaijan,2009,4,0,4
Hungary,Portugal,2009,0,1,1
Iceland,Georgia,2009,3,1,4
Israel,Luxembourg,2009,7,0,7
Italy,Bulgaria,2009,2,0,2
Japan,Ghana,2009,4,3,7
Jordan,New Zealand,2009,1,3,4
Latvia,Switzerland,2009,2,2,4
Liechtenstein,Finland,2009,1,1,2
Malta,Sweden,2009,0,1,1
Mexico,Honduras,2009,1,0,1
Moldova,Greece,2009,1,1,2
Montenegro,Cyprus,2009,1,1,2
Northern Ireland,Slovakia,2009,0,2,2
Norway,North Macedonia,2009,2,1,3
Qatar,Oman,2009,1,1,2
Romania,Austria,2009,1,1,2
Saudi Arabia,Bahrain,2009,2,2,4
Scotland,Netherlands,2009,0,1,1
Serbia,France,2009,1,1,2
Slovenia,Poland,2009,3,0,3
Spain,Estonia,2009,3,0,3
Trinidad and Tobago,United States,2009,0,1,1
Wales,Russia,2009,1,3,4
Uruguay,Colombia,2009,3,1,4
Paraguay,Argentina,2009,1,0,1
Brazil,Chile,2009,4,2,6
Venezuela,Peru,2009,3,1,4
Malaysia,Lesotho,2009,5,0,5
South Africa,Madagascar,2009,1,0,1
Saint Kitts and Nevis,Saint Vincent and the Grenadines,2009,1,1,2
Argentina,Ghana,2009,2,0,2
China PR,Botswana,2009,4,1,5
Mexico,Colombia,2009,1,2,3
Egypt,Mauritius,2009,4,0,4
Kuwait,Libya,2009,1,1,2
Croatia,Qatar,2009,3,2,5
Japan,Hong Kong,2009,6,0,6
Argentina,Peru,2009,2,1,3
Armenia,Spain,2009,1,2,3
Australia,Netherlands,2009,0,0,0
Austria,Lithuania,2009,2,1,3
Bahrain,New Zealand,2009,0,0,0
Belarus,Kazakhstan,2009,4,0,4
Belgium,Turkey,2009,2,0,2
Cameroon,Togo,2009,3,0,3
Colombia,Chile,2009,2,4,6
Costa Rica,Trinidad and Tobago,2009,4,0,4
Cyprus,Bulgaria,2009,4,1,5
Czech Republic,Poland,2009,2,0,2
Denmark,Sweden,2009,1,0,1
Ecuador,Uruguay,2009,1,2,3
Estonia,Bosnia and Herzegovina,2009,0,2,2
Finland,Wales,2009,2,1,3
France,Faroe Islands,2009,5,0,5
Gabon,Morocco,2009,3,1,4
Greece,Latvia,2009,5,2,7
Honduras,United States,2009,2,3,5
Republic of Ireland,Italy,2009,2,2,4
Israel,Moldova,2009,3,1,4
Japan,Scotland,2009,2,0,2
Kuwait,Jordan,2009,2,1,3
Liechtenstein,Azerbaijan,2009,0,2,2
Luxembourg,Switzerland,2009,0,3,3
Malawi,Ivory Coast,2009,1,1,2
Malta,Angola,2009,1,2,3
Mexico,El Salvador,2009,4,1,5
Montenegro,Georgia,2009,2,1,3
Norway,South Africa,2009,1,0,1
Portugal,Hungary,2009,3,0,3
Russia,Germany,2009,0,1,1
Serbia,Romania,2009,5,0,5
Slovakia,Slovenia,2009,0,2,2
Ukraine,England,2009,1,0,1
United Arab Emirates,Palestine,2009,1,1,2
Venezuela,Paraguay,2009,1,2,3
Zambia,Egypt,2009,0,1,1
Algeria,Rwanda,2009,3,1,4
Benin,Ghana,2009,1,0,1
Guinea,Burkina Faso,2009,1,2,3
North Macedonia,Qatar,2009,2,1,3
Mali,Sudan,2009,1,0,1
Nigeria,Mozambique,2009,1,0,1
Bolivia,Brazil,2009,2,1,3
Congo,North Korea,2009,0,0,0
Iceland,South Africa,2009,1,0,1
Andorra,Ukraine,2009,0,6,6
Angola,Cameroon,2009,0,0,0
Australia,Oman,2009,1,0,1
Azerbaijan,Russia,2009,1,1,2
Bosnia and Herzegovina,Spain,2009,2,5,7
Brazil,Venezuela,2009,0,0,0
Bulgaria,Georgia,2009,6,2,8
Chile,Ecuador,2009,1,0,1
Czech Republic,Northern Ireland,2009,0,0,0
Denmark,Hungary,2009,0,1,1
El Salvador,Honduras,2009,0,1,1
England,Belarus,2009,3,0,3
Estonia,Belgium,2009,2,0,2
France,Austria,2009,3,1,4
Germany,Finland,2009,1,1,2
Greece,Luxembourg,2009,2,1,3
Republic of Ireland,Montenegro,2009,0,0,0
Italy,Cyprus,2009,3,2,5
Japan,Togo,2009,5,0,5
Kazakhstan,Croatia,2009,1,2,3
South Korea,Senegal,2009,2,0,2
Latvia,Moldova,2009,3,2,5
Liechtenstein,Wales,2009,0,2,2
Lithuania,Serbia,2009,2,1,3
Paraguay,Colombia,2009,0,2,2
Peru,Bolivia,2009,1,0,1
Poland,Slovakia,2009,0,1,1
Portugal,Malta,2009,4,0,4
Qatar,DR Congo,2009,2,2,4
Romania,Faroe Islands,2009,3,1,4
San Marino,Slovenia,2009,0,3,3
Sweden,Albania,2009,4,1,5
Switzerland,Israel,2009,0,0,0
Trinidad and Tobago,Mexico,2009,2,2,4
Tunisia,Saudi Arabia,2009,0,1,1
Turkey,Armenia,2009,2,0,2
United Arab Emirates,Jordan,2009,3,1,4
Uruguay,Argentina,2009,0,1,1
United States,Costa Rica,2009,2,2,4
Zimbabwe,Mauritius,2009,3,0,3
Comoros,Botswana,2009,0,0,0
Eswatini,Seychelles,2009,2,1,3
Zimbabwe,Lesotho,2009,2,2,4
Botswana,Eswatini,2009,1,0,1
Seychelles,Comoros,2009,1,2,3
Vietnam,Turkmenistan,2009,1,0,1
Mauritius,Lesotho,2009,0,1,1
Seychelles,Botswana,2009,0,2,2
Singapore,Turkmenistan,2009,4,2,6
Eswatini,Comoros,2009,3,0,3
Vietnam,Singapore,2009,2,2,4
Malawi,Mozambique,2009,0,1,1
Namibia,Zambia,2009,0,1,1
Kuwait,Syria,2009,1,0,1
Zimbabwe,Botswana,2009,1,0,1
South Africa,Angola,2009,2,0,2
Curaçao,French Guiana,2009,1,4,5
Zimbabwe,South Africa,2009,1,1,2
Mozambique,Zambia,2009,0,2,2
Guyana,Curaçao,2009,1,0,1
Suriname,French Guiana,2009,4,0,4
South Africa,Mozambique,2009,0,1,1
French Guiana,Guyana,2009,0,1,1
Suriname,Curaçao,2009,1,1,2
Zimbabwe,Zambia,2009,3,1,4
Kenya,Kuwait,2009,0,5,5
Chile,Paraguay,2009,2,1,3
Singapore,Indonesia,2009,3,1,4
Egypt,Tanzania,2009,5,1,6
Bahrain,Togo,2009,5,1,6
Kuwait,China PR,2009,2,2,4
Thailand,Syria,2009,1,1,2
Yemen,Tanzania,2009,1,1,2
Iran,Iceland,2009,1,0,1
Yemen,Tanzania,2009,2,1,3
Paraguay,Qatar,2009,0,2,2
Angola,Congo,2009,1,1,2
Belgium,Hungary,2009,3,0,3
Brazil,England,2009,1,0,1
Burkina Faso,Malawi,2009,1,0,1
Costa Rica,Uruguay,2009,0,1,1
Croatia,Liechtenstein,2009,5,0,5
Denmark,South Korea,2009,0,0,0
Egypt,Algeria,2009,2,0,2
Estonia,Albania,2009,0,0,0
Greece,Ukraine,2009,0,0,0
Honduras,Latvia,2009,2,1,3
Iran,Jordan,2009,1,0,1
Republic of Ireland,France,2009,0,1,1
Italy,Netherlands,2009,0,0,0
Ivory Coast,Guinea,2009,3,0,3
Kenya,Nigeria,2009,2,3,5
Kuwait,Indonesia,2009,2,1,3
Lebanon,China PR,2009,0,2,2
Luxembourg,Iceland,2009,1,1,2
North Macedonia,Canada,2009,3,0,3
Morocco,Cameroon,2009,0,2,2
Mozambique,Tunisia,2009,1,0,1
New Zealand,Bahrain,2009,1,0,1
Northern Ireland,Serbia,2009,0,1,1
Oman,Australia,2009,1,2,3
Poland,Romania,2009,0,1,1
Portugal,Bosnia and Herzegovina,2009,1,0,1
Russia,Slovenia,2009,2,1,3
Rwanda,Zambia,2009,0,0,0
Saudi Arabia,Belarus,2009,1,1,2
Singapore,Thailand,2009,1,3,4
Slovakia,United States,2009,1,0,1
South Africa,Japan,2009,0,0,0
Spain,Argentina,2009,2,1,3
Sudan,Benin,2009,1,2,3
Switzerland,Norway,2009,0,1,1
Togo,Gabon,2009,1,0,1
Uzbekistan,Malaysia,2009,3,1,4
Vietnam,Syria,2009,0,1,1
Wales,Scotland,2009,3,0,3
Ghana,Mali,2009,2,2,4
Iraq,Azerbaijan,2009,1,0,1
United Arab Emirates,Czech Republic,2009,0,0,0
Belgium,Qatar,2009,2,0,2
Oman,Brazil,2009,0,2,2
Slovakia,Chile,2009,1,2,3
South Africa,Jamaica,2009,0,0,0
Algeria,Egypt,2009,1,0,1
Angola,Ghana,2009,0,0,0
Austria,Spain,2009,1,5,6
Azerbaijan,Czech Republic,2009,2,0,2
Bahrain,Yemen,2009,4,0,4
Bosnia and Herzegovina,Portugal,2009,0,1,1
Denmark,United States,2009,3,1,4
France,Republic of Ireland,2009,1,1,2
Germany,Ivory Coast,2009,2,2,4
Honduras,Peru,2009,1,2,3
Hong Kong,Japan,2009,0,4,4
Indonesia,Kuwait,2009,1,1,2
Iran,North Macedonia,2009,1,1,2
Italy,Sweden,2009,1,0,1
South Korea,Serbia,2009,0,1,1
Malaysia,Uzbekistan,2009,1,3,4
Malta,Bulgaria,2009,1,4,5
Montenegro,Belarus,2009,1,0,1
Netherlands,Paraguay,2009,0,0,0
Poland,Canada,2009,1,0,1
Slovenia,Russia,2009,1,0,1
Syria,Vietnam,2009,0,0,0
Thailand,Singapore,2009,0,1,1
Ukraine,Greece,2009,0,1,1
United Arab Emirates,Iraq,2009,0,1,1
Uruguay,Costa Rica,2009,1,1,2
Zambia,North Korea,2009,4,1,5
China PR,Lebanon,2009,1,0,1
Jordan,Iran,2009,1,0,1
Kenya,Zambia,2009,0,2,2
Burundi,Zanzibar,2009,0,4,4
Rwanda,Somalia,2009,1,0,1
Uganda,Tanzania,2009,2,0,2
Ethiopia,Djibouti,2009,5,0,5
Zanzibar,Tanzania,2009,0,1,1
Burundi,Uganda,2009,0,2,2
Ethiopia,Zambia,2009,0,1,1
Kenya,Djibouti,2009,2,0,2
Rwanda,Eritrea,2009,2,1,3
Bangladesh,Bhutan,2009,4,1,5
Djibouti,Zambia,2009,0,6,6
Sri Lanka,Pakistan,2009,1,0,1
Tanzania,Burundi,2009,1,0,1
Dominica,British Virgin Islands,2009,4,0,4
Kenya,Ethiopia,2009,2,0,2
Maldives,Nepal,2009,1,1,2
Somalia,Eritrea,2009,1,3,4
Uganda,Zanzibar,2009,0,0,0
Bangladesh,Pakistan,2009,0,0,0
Sri Lanka,Bhutan,2009,6,0,6
Kenya,Uganda,2009,0,1,1
Maldives,Afghanistan,2009,3,1,4
Zambia,Zanzibar,2009,0,0,0
Bangladesh,Sri Lanka,2009,2,1,3
Pakistan,Bhutan,2009,7,0,7
Tanzania,Eritrea,2009,4,0,4
Afghanistan,Nepal,2009,0,3,3
Zanzibar,Uganda,2009,1,2,3
Tanzania,Rwanda,2009,1,2,3
Maldives,Sri Lanka,2009,5,1,6
Uganda,Rwanda,2009,2,0,2
Zanzibar,Tanzania,2009,1,0,1
Kuwait,United Arab Emirates,2009,0,0,0
Mozambique,Malawi,2009,0,1,1
Catalonia,Argentina,2009,4,2,6
North Korea,Mali,2009,1,0,1
Qatar,Iran,2009,3,2,5
Egypt,Malawi,2009,1,1,2
Thailand,Zimbabwe,2009,3,0,3
Angola,Estonia,2009,0,1,1
China PR,Jordan,2009,2,2,4
Malaysia,Syria,2009,4,1,5
Mali,Iran,2009,2,1,3
Qatar,North Korea,2009,0,1,1
Yemen,Tajikistan,2009,2,1,3
Singapore,Oman,2009,1,4,5
Iran,North Korea,2010,1,0,1
Qatar,Mali,2010,0,0,0
Syria,Zimbabwe,2010,6,0,6
Yemen,Tajikistan,2010,0,1,1
Angola,Gambia,2010,1,1,2
Egypt,Mali,2010,1,0,1
Tanzania,Ivory Coast,2010,0,1,1
Ghana,Malawi,2010,0,0,0
Bahrain,Hong Kong,2010,4,0,4
Benin,Libya,2010,1,0,1
China PR,Syria,2010,0,0,0
Gabon,Mozambique,2010,2,0,2
Indonesia,Oman,2010,1,2,3
Kuwait,Australia,2010,2,2,4
Lebanon,Vietnam,2010,1,1,2
Singapore,Iran,2010,1,3,4
Thailand,Jordan,2010,0,0,0
United Arab Emirates,Malaysia,2010,1,0,1
Yemen,Japan,2010,2,3,5
Rwanda,Ivory Coast,2010,0,2,2
Kenya,Cameroon,2010,1,3,4
Tunisia,Gambia,2010,1,2,3
Zambia,South Korea,2010,4,2,6
Angola,Mali,2010,4,4,8
Ivory Coast,Burkina Faso,2010,0,0,0
Malawi,Algeria,2010,3,0,3
Egypt,Nigeria,2010,3,1,4
Mozambique,Benin,2010,2,2,4
Cameroon,Gabon,2010,0,1,1
Zambia,Tunisia,2010,1,1,2
Angola,Malawi,2010,2,0,2
Mali,Algeria,2010,0,1,1
Ivory Coast,Ghana,2010,3,1,4
Yemen,Kenya,2010,3,1,4
Egypt,Mozambique,2010,2,0,2
Nigeria,Benin,2010,1,0,1
Cameroon,Zambia,2010,3,2,5
Gabon,Tunisia,2010,0,0,0
Thailand,Singapore,2010,1,0,1
Vietnam,China PR,2010,1,2,3
Angola,Algeria,2010,0,0,0
Finland,South Korea,2010,0,2,2
Mali,Malawi,2010,3,1,4
Burkina Faso,Ghana,2010,0,1,1
Chile,Panama,2010,2,1,3
Egypt,Benin,2010,2,0,2
Nigeria,Mozambique,2010,3,0,3
Oman,Sweden,2010,0,1,1
Thailand,Poland,2010,1,3,4
Yemen,Bahrain,2010,3,0,3
Cameroon,Tunisia,2010,2,2,4
Gabon,Zambia,2010,1,2,3
Latvia,South Korea,2010,0,1,1
Poland,Singapore,2010,6,1,7
Syria,Sweden,2010,1,1,2
United States,Honduras,2010,1,3,4
Angola,Ghana,2010,0,1,1
Ivory Coast,Algeria,2010,2,3,5
Egypt,Cameroon,2010,3,1,4
Zambia,Nigeria,2010,0,0,0
Argentina,Costa Rica,2010,3,2,5
South Africa,Zimbabwe,2010,3,0,3
Algeria,Egypt,2010,0,4,4
Ghana,Nigeria,2010,1,0,1
Nigeria,Algeria,2010,1,0,1
Ghana,Egypt,2010,0,1,1
Jamaica,Canada,2010,1,0,1
Japan,Venezuela,2010,0,0,0
Japan,China PR,2010,0,0,0
South Korea,Hong Kong,2010,5,0,5
Argentina,Jamaica,2010,2,1,3
China PR,South Korea,2010,3,0,3
Japan,Hong Kong,2010,3,0,3
Hong Kong,China PR,2010,0,2,2
Japan,South Korea,2010,1,3,4
Sri Lanka,Myanmar,2010,0,4,4
Tajikistan,Bangladesh,2010,1,2,3
North Korea,Turkmenistan,2010,1,1,2
Bangladesh,Myanmar,2010,1,2,3
Sri Lanka,Tajikistan,2010,1,3,4
Kuwait,Syria,2010,1,1,2
Kyrgyzstan,North Korea,2010,0,4,4
Sri Lanka,Bangladesh,2010,3,0,3
Tajikistan,Myanmar,2010,3,0,3
Turkmenistan,Kyrgyzstan,2010,1,0,1
North Korea,Myanmar,2010,5,0,5
Mexico,Bolivia,2010,5,0,5
Tajikistan,Turkmenistan,2010,0,2,2
United States,El Salvador,2010,2,1,3
Jordan,Azerbaijan,2010,0,2,2
Kuwait,Bahrain,2010,4,1,5
Turkmenistan,North Korea,2010,1,1,2
Malaysia,Yemen,2010,1,0,1
Tajikistan,Myanmar,2010,1,0,1
Guadeloupe,Saint Kitts and Nevis,2010,2,1,3
Republic of Ireland,Brazil,2010,0,2,2
Albania,Northern Ireland,2010,1,0,1
Algeria,Serbia,2010,0,3,3
Angola,Latvia,2010,1,1,2
Armenia,Belarus,2010,1,3,4
Australia,Indonesia,2010,1,0,1
Austria,Denmark,2010,2,1,3
Belgium,Croatia,2010,0,1,1
Bosnia and Herzegovina,Ghana,2010,2,1,3
Cyprus,Iceland,2010,0,0,0
El Salvador,Guatemala,2010,1,2,3
England,Egypt,2010,3,1,4
France,Spain,2010,0,2,2
Georgia,Estonia,2010,2,1,3
Germany,Argentina,2010,0,1,1
Greece,Senegal,2010,0,2,2
Hong Kong,Yemen,2010,0,0,0
Hungary,Russia,2010,1,1,2
Iran,Thailand,2010,1,0,1
Italy,Cameroon,2010,0,0,0
Ivory Coast,South Korea,2010,0,2,2
Japan,Bahrain,2010,2,0,2
Jordan,Singapore,2010,2,1,3
Kazakhstan,Moldova,2010,0,1,1
Libya,Mali,2010,2,1,3
Luxembourg,Azerbaijan,2010,1,2,3
North Macedonia,Montenegro,2010,2,1,3
Malta,Finland,2010,1,2,3
Mexico,New Zealand,2010,2,0,2
Mozambique,Botswana,2010,0,1,1
Netherlands,United States,2010,2,1,3
Nigeria,DR Congo,2010,5,2,7
Oman,Kuwait,2010,0,0,0
Poland,Bulgaria,2010,2,0,2
Portugal,China PR,2010,2,0,2
Romania,Israel,2010,0,2,2
Scotland,Czech Republic,2010,1,0,1
Slovakia,Norway,2010,0,1,1
Slovenia,Qatar,2010,4,1,5
South Africa,Namibia,2010,1,1,2
Switzerland,Uruguay,2010,1,3,4
Syria,Lebanon,2010,4,0,4
Tanzania,Uganda,2010,2,3,5
Turkey,Honduras,2010,2,0,2
Uzbekistan,United Arab Emirates,2010,0,1,1
Venezuela,Panama,2010,1,2,3
Wales,Sweden,2010,0,1,1
Zimbabwe,Malawi,2010,2,1,3
Venezuela,North Korea,2010,2,1,3
Niger,Benin,2010,2,0,2
Mexico,North Korea,2010,2,1,3
Iceland,Faroe Islands,2010,2,0,2
Namibia,Botswana,2010,0,0,0
Martinique,Haiti,2010,0,0,0
Mexico,Iceland,2010,0,0,0
Chile,Venezuela,2010,0,0,0
Paraguay,South Africa,2010,1,1,2
Saint Kitts and Nevis,Guadeloupe,2010,3,0,3
Japan,Serbia,2010,0,3,3
Honduras,Venezuela,2010,0,1,1
South Africa,North Korea,2010,0,0,0
South Africa,Jamaica,2010,2,0,2
Argentina,Haiti,2010,4,0,4
Chile,Trinidad and Tobago,2010,2,0,2
Mexico,Ecuador,2010,0,0,0
Mexico,Senegal,2010,1,0,1
Yemen,Malawi,2010,1,0,1
Germany,Malta,2010,3,0,3
Mexico,Angola,2010,1,0,1
Paraguay,North Korea,2010,1,0,1
South Korea,Ecuador,2010,2,0,2
Mexico,Chile,2010,1,0,1
South Africa,Thailand,2010,4,0,4
Yemen,Oman,2010,0,1,1
Austria,Croatia,2010,0,1,1
Belgium,Bulgaria,2010,2,1,3
Gabon,Togo,2010,3,0,3
Corsica,Brittany,2010,2,0,2
Aruba,Venezuela,2010,0,3,3
DR Congo,Saudi Arabia,2010,0,2,2
Estonia,Finland,2010,2,0,2
Brittany,Togo,2010,2,1,3
Corsica,Gabon,2010,1,1,2
Turkey,Czech Republic,2010,2,1,3
Croatia,Wales,2010,2,0,2
Argentina,Canada,2010,5,0,5
Australia,New Zealand,2010,2,1,3
England,Mexico,2010,3,1,4
Japan,South Korea,2010,0,2,2
Portugal,Cape Verde,2010,0,0,0
South Africa,Bulgaria,2010,1,1,2
Armenia,Uzbekistan,2010,3,1,4
Georgia,Cameroon,2010,0,0,0
Greece,North Korea,2010,2,2,4
Republic of Ireland,Paraguay,2010,2,1,3
Montenegro,Albania,2010,0,1,1
Nigeria,Saudi Arabia,2010,0,0,0
Ukraine,Lithuania,2010,4,0,4
United States,Czech Republic,2010,2,4,6
Azerbaijan,Moldova,2010,1,1,2
Chile,Zambia,2010,3,0,3
Estonia,Croatia,2010,0,0,0
France,Costa Rica,2010,2,1,3
Netherlands,Mexico,2010,2,1,3
Northern Ireland,Turkey,2010,0,2,2
Uruguay,Israel,2010,4,1,5
Belarus,Honduras,2010,2,2,4
Denmark,Senegal,2010,2,0,2
South Africa,Colombia,2010,2,1,3
Republic of Ireland,Algeria,2010,3,0,3
Azerbaijan,North Macedonia,2010,1,3,4
Hungary,Germany,2010,0,3,3
Iceland,Andorra,2010,4,0,4
Moldova,United Arab Emirates,2010,2,3,5
New Zealand,Serbia,2010,1,0,1
Norway,Montenegro,2010,2,1,3
Poland,Finland,2010,0,0,0
Slovakia,Cameroon,2010,1,1,2
Spain,Saudi Arabia,2010,3,2,5
Sweden,Bosnia and Herzegovina,2010,4,2,6
Ukraine,Romania,2010,3,2,5
United States,Turkey,2010,2,1,3
Venezuela,Canada,2010,1,1,2
Belarus,South Korea,2010,1,0,1
Chile,Northern Ireland,2010,1,0,1
Chile,Israel,2010,3,0,3
Grenada,Martinique,2010,2,2,4
Japan,England,2010,1,2,3
Mexico,Gambia,2010,5,1,6
Nigeria,Colombia,2010,1,1,2
Paraguay,Ivory Coast,2010,2,2,4
Tunisia,France,2010,1,1,2
South Africa,Guatemala,2010,5,0,5
Gozo,Padania,2010,1,2,3
Iraqi Kurdistan,Two Sicilies,2010,4,1,5
Australia,Denmark,2010,1,0,1
Netherlands,Ghana,2010,4,1,5
Portugal,Cameroon,2010,3,1,4
Switzerland,Costa Rica,2010,0,1,1
Occitania,Padania,2010,0,1,1
Provence,Two Sicilies,2010,0,1,1
Albania,Andorra,2010,1,0,1
Azerbaijan,Honduras,2010,0,0,0
Belarus,Sweden,2010,0,1,1
Greece,Paraguay,2010,0,2,2
Norway,Ukraine,2010,0,1,1
Romania,North Macedonia,2010,0,1,1
Serbia,Poland,2010,0,0,0
Zimbabwe,Brazil,2010,0,3,3
Gozo,Occitania,2010,0,5,5
Iraqi Kurdistan,Provence,2010,3,2,5
Germany,Bosnia and Herzegovina,2010,3,1,4
Italy,Mexico,2010,1,2,3
Spain,South Korea,2010,1,0,1
France,China PR,2010,0,1,1
Japan,Ivory Coast,2010,0,2,2
Luxembourg,Faroe Islands,2010,0,0,0
Slovenia,New Zealand,2010,3,1,4
Sudan,Palestine,2010,1,1,2
Iraqi Kurdistan,Occitania,2010,2,1,3
Padania,Two Sicilies,2010,2,0,2
Gozo,Provence,2010,2,1,3
Algeria,United Arab Emirates,2010,1,0,1
Australia,United States,2010,1,3,4
Ghana,Latvia,2010,1,0,1
Netherlands,Hungary,2010,6,1,7
Romania,Honduras,2010,3,0,3
Serbia,Cameroon,2010,4,3,7
Slovakia,Costa Rica,2010,3,0,3
South Africa,Denmark,2010,1,0,1
Switzerland,Italy,2010,1,1,2
Occitania,Two Sicilies,2010,2,0,2
Iraqi Kurdistan,Padania,2010,0,1,1
Nigeria,North Korea,2010,3,1,4
Tanzania,Brazil,2010,1,5,6
Mozambique,Portugal,2010,0,3,3
Spain,Poland,2010,6,0,6
South Africa,Mexico,2010,1,1,2
Uruguay,France,2010,0,0,0
Argentina,Nigeria,2010,1,0,1
England,United States,2010,1,1,2
South Korea,Greece,2010,2,0,2
Algeria,Slovenia,2010,0,1,1
Germany,Australia,2010,4,0,4
Serbia,Ghana,2010,0,1,1
Italy,Paraguay,2010,1,1,2
Japan,Cameroon,2010,1,0,1
Netherlands,Denmark,2010,2,0,2
Brazil,North Korea,2010,2,1,3
Ivory Coast,Portugal,2010,0,0,0
New Zealand,Slovakia,2010,1,1,2
Honduras,Chile,2010,0,1,1
South Africa,Uruguay,2010,0,3,3
Spain,Switzerland,2010,0,1,1
Argentina,South Korea,2010,4,1,5
France,Mexico,2010,0,2,2
Greece,Nigeria,2010,2,1,3
England,Algeria,2010,0,0,0
Germany,Serbia,2010,0,1,1
Lithuania,Latvia,2010,0,0,0
Slovenia,United States,2010,2,2,4
Cameroon,Denmark,2010,1,2,3
Estonia,Latvia,2010,0,0,0
Ghana,Australia,2010,1,1,2
Netherlands,Japan,2010,1,0,1
Niger,Chad,2010,1,1,2
Northern Mariana Islands,Guam,2010,1,1,2
Brazil,Ivory Coast,2010,3,1,4
Italy,New Zealand,2010,1,1,2
Lithuania,Estonia,2010,2,0,2
Slovakia,Paraguay,2010,0,2,2
Sudan,Tunisia,2010,2,6,8
Chile,Switzerland,2010,1,0,1
Portugal,North Korea,2010,7,0,7
Spain,Honduras,2010,2,0,2
Greece,Argentina,2010,0,2,2
Mexico,Uruguay,2010,0,1,1
Nigeria,South Korea,2010,2,2,4
South Africa,France,2010,2,1,3
Australia,Serbia,2010,2,1,3
Ghana,Germany,2010,0,1,1
Slovenia,England,2010,0,1,1
United States,Algeria,2010,1,0,1
Cameroon,Netherlands,2010,1,2,3
Denmark,Japan,2010,1,3,4
Paraguay,New Zealand,2010,0,0,0
Slovakia,Italy,2010,3,2,5
Chile,Spain,2010,1,2,3
North Korea,Ivory Coast,2010,0,3,3
Portugal,Brazil,2010,0,0,0
Switzerland,Honduras,2010,0,0,0
China PR,Tajikistan,2010,4,0,4
Uruguay,South Korea,2010,2,1,3
United States,Ghana,2010,1,2,3
Argentina,Mexico,2010,3,1,4
Germany,England,2010,4,1,5
Brazil,Chile,2010,3,0,3
Netherlands,Slovakia,2010,2,1,3
Paraguay,Japan,2010,0,0,0
Spain,Portugal,2010,1,0,1
Chad,Togo,2010,2,2,4
Tunisia,Botswana,2010,0,1,1
Netherlands,Brazil,2010,2,1,3
Uruguay,Ghana,2010,1,1,2
Argentina,Germany,2010,0,4,4
Paraguay,Spain,2010,0,1,1
Uruguay,Netherlands,2010,2,3,5
Germany,Spain,2010,0,1,1
Botswana,Chad,2010,1,0,1
Togo,Malawi,2010,1,1,2
Uruguay,Germany,2010,2,3,5
Netherlands,Spain,2010,0,1,1
Botswana,Zimbabwe,2010,2,0,2
Anguilla,Saint Martin,2010,1,3,4
Bosnia and Herzegovina,Qatar,2010,1,1,2
Italy,Ivory Coast,2010,0,1,1
United States,Brazil,2010,0,2,2
Albania,Uzbekistan,2010,1,0,1
Algeria,Gabon,2010,1,2,3
Angola,Uruguay,2010,0,2,2
Armenia,Iran,2010,1,3,4
Austria,Switzerland,2010,0,1,1
Azerbaijan,Kuwait,2010,1,1,2
Benin,Niger,2010,0,0,0
Bolivia,Colombia,2010,1,1,2
Burkina Faso,Congo,2010,3,0,3
Chad,Tunisia,2010,1,3,4
China PR,Bahrain,2010,1,1,2
Cyprus,Andorra,2010,1,0,1
Czech Republic,Latvia,2010,4,1,5
Denmark,Germany,2010,2,2,4
Egypt,DR Congo,2010,6,3,9
England,Hungary,2010,2,1,3
Estonia,Faroe Islands,2010,2,1,3
Finland,Belgium,2010,1,0,1
Iceland,Liechtenstein,2010,1,1,2
Republic of Ireland,Argentina,2010,0,1,1
Kazakhstan,Oman,2010,3,1,4
South Korea,Nigeria,2010,2,1,3
Lithuania,Belarus,2010,0,2,2
Malawi,Botswana,2010,1,1,2
Mali,Guinea,2010,0,2,2
Malta,North Macedonia,2010,1,1,2
Mauritania,Palestine,2010,0,0,0
Mexico,Spain,2010,1,1,2
Moldova,Georgia,2010,0,0,0
Montenegro,Northern Ireland,2010,2,0,2
Morocco,Equatorial Guinea,2010,2,1,3
Mozambique,Eswatini,2010,2,1,3
Norway,France,2010,2,1,3
Panama,Venezuela,2010,3,1,4
Paraguay,Costa Rica,2010,2,0,2
Poland,Cameroon,2010,0,3,3
Russia,Bulgaria,2010,1,0,1
Saudi Arabia,Togo,2010,1,0,1
Senegal,Cape Verde,2010,1,0,1
Serbia,Greece,2010,0,1,1
Slovakia,Croatia,2010,1,1,2
Slovenia,Australia,2010,2,0,2
South Africa,Ghana,2010,1,0,1
Sweden,Scotland,2010,3,0,3
Tanzania,Kenya,2010,1,1,2
Thailand,Singapore,2010,1,0,1
Trinidad and Tobago,Jamaica,2010,1,3,4
Turkey,Romania,2010,2,0,2
Uganda,Zambia,2010,1,1,2
Ukraine,Netherlands,2010,1,1,2
Wales,Luxembourg,2010,5,1,6
Ethiopia,Kenya,2010,0,3,3
Madagascar,Mayotte,2010,0,0,0
Saint Lucia,Martinique,2010,1,3,4
Saint Kitts and Nevis,Antigua and Barbuda,2010,1,1,2
Saint Lucia,Martinique,2010,1,1,2
Ethiopia,Chad,2010,1,0,1
Madagascar,Comoros,2010,1,0,1
Israel,Malta,2010,3,1,4
Algeria,Tanzania,2010,1,1,2
Andorra,Russia,2010,0,2,2
Armenia,Republic of Ireland,2010,0,1,1
Belgium,Germany,2010,0,1,1
China PR,Iran,2010,0,2,2
England,Bulgaria,2010,4,0,4
Estonia,Italy,2010,1,2,3
Faroe Islands,Serbia,2010,0,3,3
France,Belarus,2010,0,1,1
Greece,Georgia,2010,1,1,2
Iceland,Norway,2010,1,2,3
Kazakhstan,Turkey,2010,0,3,3
Kuwait,Syria,2010,3,0,3
Latvia,Croatia,2010,0,3,3
Liechtenstein,Spain,2010,0,4,4
Lithuania,Scotland,2010,0,0,0
Luxembourg,Bosnia and Herzegovina,2010,0,3,3
Moldova,Finland,2010,2,0,2
Montenegro,Wales,2010,1,0,1
Oman,Malaysia,2010,3,0,3
Panama,Costa Rica,2010,2,2,4
Portugal,Cyprus,2010,4,4,8
Qatar,Bahrain,2010,1,1,2
Romania,Albania,2010,1,1,2
San Marino,Netherlands,2010,0,5,5
Slovakia,North Macedonia,2010,1,0,1
Slovenia,Northern Ireland,2010,0,1,1
Sweden,Hungary,2010,2,0,2
Switzerland,Australia,2010,0,0,0
Venezuela,Colombia,2010,0,2,2
Botswana,Togo,2010,2,1,3
Canada,Peru,2010,0,2,2
Cape Verde,Mali,2010,1,0,1
El Salvador,Honduras,2010,2,2,4
Guatemala,Nicaragua,2010,5,0,5
Guinea-Bissau,Kenya,2010,1,0,1
Ivory Coast,Rwanda,2010,3,0,3
Japan,Paraguay,2010,1,0,1
Mauritius,Cameroon,2010,1,3,4
Mexico,Ecuador,2010,1,2,3
Morocco,Central African Republic,2010,0,0,0
Poland,Ukraine,2010,1,1,2
South Africa,Niger,2010,2,0,2
Sudan,Congo,2010,2,0,2
Thailand,India,2010,1,0,1
Tunisia,Malawi,2010,2,2,4
Uganda,Angola,2010,3,0,3
Benin,Burundi,2010,1,1,2
DR Congo,Senegal,2010,2,4,6
Egypt,Sierra Leone,2010,1,1,2
Ethiopia,Guinea,2010,1,4,5
Jamaica,Costa Rica,2010,1,0,1
Liberia,Zimbabwe,2010,1,1,2
Mozambique,Libya,2010,0,0,0
Nigeria,Madagascar,2010,2,0,2
Eswatini,Ghana,2010,0,3,3
Burkina Faso,Gabon,2010,1,1,2
Albania,Luxembourg,2010,1,0,1
Argentina,Spain,2010,4,1,5
Austria,Kazakhstan,2010,2,0,2
Bahrain,Togo,2010,3,0,3
Belarus,Romania,2010,0,0,0
Bosnia and Herzegovina,France,2010,0,2,2
Bulgaria,Montenegro,2010,0,1,1
Canada,Honduras,2010,2,1,3
China PR,Paraguay,2010,1,1,2
Croatia,Greece,2010,0,0,0
Czech Republic,Lithuania,2010,0,1,1
Denmark,Iceland,2010,1,0,1
El Salvador,Guatemala,2010,0,2,2
Estonia,Uzbekistan,2010,3,3,6
Georgia,Israel,2010,0,0,0
Germany,Azerbaijan,2010,6,1,7
Hungary,Moldova,2010,2,1,3
Republic of Ireland,Andorra,2010,3,1,4
Italy,Faroe Islands,2010,5,0,5
Jamaica,Peru,2010,1,2,3
Japan,Guatemala,2010,2,1,3
South Korea,Iran,2010,0,1,1
North Macedonia,Armenia,2010,2,2,4
Malta,Latvia,2010,0,2,2
Mexico,Colombia,2010,1,0,1
Netherlands,Finland,2010,2,1,3
Norway,Portugal,2010,1,0,1
Panama,Trinidad and Tobago,2010,3,0,3
Poland,Australia,2010,1,2,3
Qatar,Oman,2010,1,1,2
Russia,Slovakia,2010,0,1,1
Scotland,Liechtenstein,2010,2,1,3
Serbia,Slovenia,2010,1,1,2
Sweden,San Marino,2010,6,0,6
Switzerland,England,2010,1,3,4
Turkey,Belgium,2010,3,2,5
Ukraine,Chile,2010,2,1,3
United Arab Emirates,Kuwait,2010,3,0,3
Venezuela,Ecuador,2010,1,0,1
Yemen,Syria,2010,2,1,3
India,Thailand,2010,1,2,3
Belize,Trinidad and Tobago,2010,0,0,0
Saint Lucia,Saint Vincent and the Grenadines,2010,1,5,6
French Guiana,Suriname,2010,1,2,3
India,Namibia,2010,2,0,2
Jordan,Iraq,2010,4,1,5
Anguilla,British Virgin Islands,2010,1,2,3
Yemen,Zambia,2010,0,1,1
Antigua and Barbuda,Trinidad and Tobago,2010,0,1,1
Jordan,Bahrain,2010,2,0,2
Saint Martin,British Virgin Islands,2010,3,1,4
Iraq,Oman,2010,3,2,5
Saint Lucia,Trinidad and Tobago,2010,0,3,3
French Guiana,Mayotte,2010,2,2,4
Réunion,Saint Pierre and Miquelon,2010,11,0,11
Antigua and Barbuda,Saint Lucia,2010,5,0,5
Guadeloupe,New Caledonia,2010,1,1,2
Martinique,Tahiti,2010,4,1,5
Iran,Bahrain,2010,3,0,3
Jordan,Syria,2010,1,1,2
Vietnam,North Korea,2010,0,0,0
French Guiana,Saint Pierre and Miquelon,2010,7,0,7
Iraq,Yemen,2010,2,1,3
Mayotte,Réunion,2010,1,2,3
Bahrain,Oman,2010,2,0,2
Barbados,Dominica,2010,1,3,4
Guadeloupe,Tahiti,2010,1,1,2
Guyana,Trinidad and Tobago,2010,1,1,2
New Caledonia,Martinique,2010,0,4,4
Syria,Kuwait,2010,1,2,3
Yemen,Palestine,2010,3,1,4
French Guiana,Réunion,2010,0,1,1
Jordan,Kuwait,2010,2,2,4
Mayotte,Saint Pierre and Miquelon,2010,10,0,10
Oman,Iran,2010,2,2,4
Guadeloupe,Martinique,2010,2,0,2
New Caledonia,Tahiti,2010,1,1,2
Palestine,Iraq,2010,0,3,3
Iran,Iraq,2010,2,1,3
Kuwait,Yemen,2010,1,1,2
Mayotte,Guadeloupe,2010,0,4,4
Saint Martin,Cayman Islands,2010,1,1,2
Puerto Rico,Anguilla,2010,3,1,4
Réunion,Martinique,2010,0,0,0
Iran,Kuwait,2010,1,2,3
Cayman Islands,Anguilla,2010,4,1,5
India,Hong Kong,2010,0,1,1
Puerto Rico,Saint Martin,2010,2,0,2
Anguilla,Saint Martin,2010,2,1,3
Barbados,Saint Kitts and Nevis,2010,1,1,2
Puerto Rico,Cayman Islands,2010,2,0,2
Iran,Brazil,2010,0,3,3
Albania,Bosnia and Herzegovina,2010,1,1,2
Andorra,North Macedonia,2010,0,2,2
Armenia,Slovakia,2010,3,1,4
Austria,Azerbaijan,2010,3,0,3
China PR,Syria,2010,2,1,3
Colombia,Ecuador,2010,1,0,1
Cyprus,Norway,2010,1,2,3
Czech Republic,Scotland,2010,1,0,1
Georgia,Malta,2010,1,0,1
Germany,Turkey,2010,3,0,3
Greece,Latvia,2010,1,0,1
Hungary,San Marino,2010,8,0,8
India,Vietnam,2010,3,1,4
Indonesia,Uruguay,2010,1,7,8
Republic of Ireland,Russia,2010,2,3,5
Japan,Argentina,2010,1,0,1
Kazakhstan,Belgium,2010,0,2,2
Kuwait,Bahrain,2010,1,3,4
Luxembourg,Belarus,2010,0,0,0
Moldova,Netherlands,2010,0,1,1
Montenegro,Switzerland,2010,1,0,1
Montserrat,Barbados,2010,0,5,5
Northern Ireland,Italy,2010,0,0,0
Oman,Gabon,2010,1,0,1
Panama,El Salvador,2010,1,0,1
Peru,Costa Rica,2010,2,0,2
Portugal,Denmark,2010,3,1,4
Serbia,Estonia,2010,1,3,4
Slovenia,Faroe Islands,2010,5,1,6
Spain,Lithuania,2010,3,1,4
Saint Vincent and the Grenadines,Saint Kitts and Nevis,2010,1,1,2
Ukraine,Canada,2010,2,2,4
Wales,Bulgaria,2010,0,1,1
Angola,Guinea-Bissau,2010,1,0,1
Australia,Paraguay,2010,1,0,1
Burkina Faso,Gambia,2010,3,1,4
Burundi,Ivory Coast,2010,0,1,1
Cameroon,DR Congo,2010,1,1,2
Comoros,Mozambique,2010,0,1,1
France,Romania,2010,2,0,2
Guatemala,Belize,2010,4,2,6
Israel,Croatia,2010,1,2,3
Kenya,Uganda,2010,0,0,0
Malawi,Chad,2010,6,2,8
Mali,Liberia,2010,2,1,3
New Zealand,Honduras,2010,1,1,2
Rwanda,Benin,2010,0,3,3
Saudi Arabia,Uzbekistan,2010,4,0,4
Senegal,Mauritius,2010,7,0,7
Tanzania,Morocco,2010,0,1,1
United Arab Emirates,Chile,2010,0,2,2
United States,Poland,2010,2,2,4
Central African Republic,Algeria,2010,2,0,2
Congo,Eswatini,2010,3,1,4
Ghana,Sudan,2010,0,0,0
Guinea,Nigeria,2010,1,0,1
Jamaica,Trinidad and Tobago,2010,1,0,1
Libya,Zambia,2010,1,0,1
Madagascar,Ethiopia,2010,0,1,1
Niger,Egypt,2010,1,0,1
Sierra Leone,South Africa,2010,0,0,0
Saint Kitts and Nevis,Montserrat,2010,4,0,4
Togo,Tunisia,2010,1,2,3
Zimbabwe,Cape Verde,2010,0,0,0
Brazil,Ukraine,2010,2,0,2
Armenia,Andorra,2010,4,0,4
Azerbaijan,Turkey,2010,1,0,1
Bahrain,Uzbekistan,2010,2,4,6
Belarus,Albania,2010,2,0,2
Belgium,Austria,2010,4,4,8
Bulgaria,Saudi Arabia,2010,2,0,2
China PR,Uruguay,2010,0,4,4
Costa Rica,El Salvador,2010,2,1,3
Croatia,Norway,2010,2,1,3
Denmark,Cyprus,2010,2,0,2
Ecuador,Poland,2010,2,2,4
England,Montenegro,2010,0,0,0
Equatorial Guinea,Botswana,2010,2,1,3
Estonia,Slovenia,2010,0,1,1
Faroe Islands,Northern Ireland,2010,1,1,2
Finland,Hungary,2010,1,2,3
France,Luxembourg,2010,2,0,2
Greece,Israel,2010,2,1,3
Guatemala,Honduras,2010,0,2,2
Iceland,Portugal,2010,1,3,4
Indonesia,Maldives,2010,3,0,3
Italy,Serbia,2010,3,0,3
Kazakhstan,Germany,2010,0,3,3
South Korea,Japan,2010,0,0,0
Kuwait,Vietnam,2010,3,1,4
Latvia,Georgia,2010,1,1,2
Liechtenstein,Czech Republic,2010,0,2,2
North Macedonia,Russia,2010,0,1,1
Mexico,Venezuela,2010,2,2,4
Netherlands,Sweden,2010,4,1,5
New Zealand,Paraguay,2010,0,2,2
Oman,Chile,2010,0,1,1
Panama,Peru,2010,1,0,1
Philippines,Macau,2010,5,0,5
Qatar,Iraq,2010,1,2,3
San Marino,Moldova,2010,0,2,2
Saudi Arabia,Gabon,2010,1,0,1
Scotland,Spain,2010,2,3,5
Slovakia,Republic of Ireland,2010,1,1,2
Switzerland,Wales,2010,4,1,5
United Arab Emirates,Angola,2010,0,2,2
United States,Colombia,2010,0,0,0
Guyana,Saint Lucia,2010,1,0,1
India,Yemen,2010,3,6,9
Suriname,Curaçao,2010,2,1,3
Dominican Republic,British Virgin Islands,2010,17,0,17
British Virgin Islands,Dominica,2010,0,10,10
Curaçao,Guyana,2010,2,3,5
Suriname,Saint Lucia,2010,2,1,3
Dominican Republic,Dominica,2010,0,1,1
Saint Lucia,Curaçao,2010,2,2,4
Suriname,Guyana,2010,0,2,2
Timor-Leste,Philippines,2010,0,5,5
Grenada,Puerto Rico,2010,3,1,4
Laos,Cambodia,2010,0,0,0
Saint Kitts and Nevis,Guadeloupe,2010,1,2,3
Cambodia,Timor-Leste,2010,4,2,6
Grenada,Saint Kitts and Nevis,2010,2,0,2
Guadeloupe,Puerto Rico,2010,3,2,5
Laos,Philippines,2010,2,2,4
Grenada,Guadeloupe,2010,0,3,3
Laos,Timor-Leste,2010,6,1,7
Panama,Cuba,2010,0,3,3
Philippines,Cambodia,2010,0,0,0
Puerto Rico,Saint Kitts and Nevis,2010,0,1,1
Botswana,Eswatini,2010,2,0,2
Curaçao,Aruba,2010,3,0,3
Suriname,Bonaire,2010,4,2,6
Aruba,Bonaire,2010,3,3,6
Curaçao,Suriname,2010,2,2,4
Haiti,Guyana,2010,0,0,0
Singapore,North Korea,2010,1,2,3
Trinidad and Tobago,Guyana,2010,2,1,3
Vietnam,Singapore,2010,1,1,2
Trinidad and Tobago,Haiti,2010,4,0,4
Vietnam,North Korea,2010,0,2,2
Yemen,Uganda,2010,2,2,4
Antigua and Barbuda,Suriname,2010,2,1,3
Bahrain,Uganda,2010,0,0,0
Cuba,Dominica,2010,4,2,6
Yemen,North Korea,2010,1,1,2
Iraq,India,2010,2,0,2
Antigua and Barbuda,Dominica,2010,0,0,0
Suriname,Cuba,2010,3,3,6
Antigua and Barbuda,Cuba,2010,0,0,0
Bahrain,Syria,2010,0,2,2
Dominica,Suriname,2010,0,5,5
India,Kuwait,2010,1,9,10
Cape Verde,Guinea-Bissau,2010,2,1,3
Jordan,Cyprus,2010,0,0,0
Saudi Arabia,Uganda,2010,0,0,0
Scotland,Faroe Islands,2010,3,0,3
Albania,North Macedonia,2010,0,0,0
Argentina,Brazil,2010,1,0,1
Austria,Greece,2010,1,2,3
Botswana,Tunisia,2010,1,0,1
Bulgaria,Serbia,2010,0,1,1
Burkina Faso,Guinea,2010,2,1,3
Chile,Uruguay,2010,2,0,2
China PR,Latvia,2010,1,0,1
Colombia,Peru,2010,1,1,2
Croatia,Malta,2010,3,0,3
Denmark,Czech Republic,2010,0,0,0
Ecuador,Venezuela,2010,4,1,5
Egypt,Australia,2010,3,0,3
England,France,2010,1,2,3
Estonia,Liechtenstein,2010,1,1,2
Finland,San Marino,2010,8,0,8
Gabon,Senegal,2010,1,2,3
Guatemala,Guyana,2010,3,0,3
Hong Kong,Paraguay,2010,0,7,7
Hungary,Lithuania,2010,2,0,2
Iraq,Kuwait,2010,1,1,2
Republic of Ireland,Norway,2010,1,2,3
Israel,Iceland,2010,3,2,5
Italy,Romania,2010,1,1,2
Jamaica,Costa Rica,2010,0,0,0
Libya,Niger,2010,1,1,2
Luxembourg,Algeria,2010,0,0,0
Malawi,Rwanda,2010,2,1,3
Mali,DR Congo,2010,3,1,4
Montenegro,Azerbaijan,2010,2,0,2
Mozambique,Zimbabwe,2010,1,3,4
Netherlands,Turkey,2010,1,0,1
Northern Ireland,Morocco,2010,1,1,2
Oman,Belarus,2010,0,4,4
Panama,Honduras,2010,2,0,2
Poland,Ivory Coast,2010,3,1,4
Portugal,Spain,2010,4,0,4
Russia,Belgium,2010,0,2,2
Saudi Arabia,Ghana,2010,0,0,0
Slovakia,Bosnia and Herzegovina,2010,2,3,5
Slovenia,Georgia,2010,1,2,3
South Africa,United States,2010,0,1,1
Sweden,Germany,2010,0,0,0
Switzerland,Ukraine,2010,2,2,4
Tajikistan,Afghanistan,2010,1,0,1
Togo,Chad,2010,0,0,0
Qatar,Haiti,2010,0,1,1
United Arab Emirates,India,2010,5,0,5
Indonesia,Timor-Leste,2010,6,0,6
Kuwait,Qatar,2010,1,0,1
Yemen,Saudi Arabia,2010,0,4,4
Iraq,United Arab Emirates,2010,0,0,0
Oman,Bahrain,2010,1,1,2
Tanzania,Kenya,2010,1,0,1
Indonesia,Taiwan,2010,2,0,2
Saudi Arabia,Kuwait,2010,0,0,0
Yemen,Qatar,2010,1,2,3
Bahrain,Iraq,2010,2,3,5
Martinique,Grenada,2010,1,1,2
Singapore,Laos,2010,4,0,4
Trinidad and Tobago,Cuba,2010,0,2,2
United Arab Emirates,Oman,2010,0,0,0
Guyana,Guadeloupe,2010,1,1,2
Jamaica,Antigua and Barbuda,2010,3,1,4
Tanzania,Zambia,2010,0,1,1
Burundi,Somalia,2010,2,0,2
Grenada,Trinidad and Tobago,2010,1,0,1
Martinique,Cuba,2010,0,1,1
Qatar,Saudi Arabia,2010,1,1,2
Yemen,Kuwait,2010,0,3,3
Zanzibar,Sudan,2010,2,0,2
Antigua and Barbuda,Guyana,2010,1,0,1
Guadeloupe,Jamaica,2010,0,2,2
Malawi,Kenya,2010,3,2,5
Oman,Iraq,2010,0,0,0
Uganda,Ethiopia,2010,2,1,3
United Arab Emirates,Bahrain,2010,3,1,4
Cuba,Grenada,2010,0,0,0
Martinique,Trinidad and Tobago,2010,0,1,1
Tanzania,Somalia,2010,3,0,3
Zambia,Burundi,2010,0,0,0
Guadeloupe,Antigua and Barbuda,2010,1,0,1
Guyana,Jamaica,2010,0,4,4
Indonesia,Malaysia,2010,5,1,6
Sudan,Rwanda,2010,0,0,0
Thailand,Laos,2010,2,2,4
Ethiopia,Kenya,2010,2,1,3
Kuwait,Iraq,2010,2,2,4
Malawi,Uganda,2010,1,1,2
Singapore,Philippines,2010,1,1,2
United Arab Emirates,Saudi Arabia,2010,0,1,1
Vietnam,Myanmar,2010,7,1,8
Cuba,Guadeloupe,2010,1,2,3
Jamaica,Grenada,2010,2,1,3
Rwanda,Zanzibar,2010,0,0,0
Zambia,Somalia,2010,6,0,6
Indonesia,Laos,2010,6,0,6
Thailand,Malaysia,2010,0,0,0
Grenada,Cuba,2010,0,1,1
Guadeloupe,Jamaica,2010,1,1,2
Kuwait,Saudi Arabia,2010,1,0,1
Singapore,Myanmar,2010,2,1,3
Uganda,Kenya,2010,2,0,2
Vietnam,Philippines,2010,0,2,2
Indonesia,Thailand,2010,2,1,3
Malaysia,Laos,2010,5,1,6
Zambia,Ethiopia,2010,1,2,3
Myanmar,Philippines,2010,0,0,0
Tanzania,Rwanda,2010,1,0,1
Uganda,Zanzibar,2010,2,2,4
Vietnam,Singapore,2010,1,0,1
Bosnia and Herzegovina,Poland,2010,2,2,4
Tanzania,Uganda,2010,0,0,0
Ethiopia,Uganda,2010,3,4,7
Malaysia,Vietnam,2010,2,0,2
Indonesia,Philippines,2010,1,0,1
Qatar,Egypt,2010,2,1,3
China PR,Estonia,2010,3,0,3
Honduras,Panama,2010,2,1,3
Iraq,Syria,2010,0,1,1
Vietnam,Malaysia,2010,0,0,0
Indonesia,Philippines,2010,1,0,1
China PR,North Macedonia,2010,1,0,1
Qatar,Estonia,2010,2,0,2
Syria,Iraq,2010,0,1,1
Kuwait,North Korea,2010,2,1,3
Bahrain,Uzbekistan,2010,1,1,2
Malaysia,Indonesia,2010,3,0,3
Kuwait,North Korea,2010,2,2,4
Bahrain,Jordan,2010,2,1,3
Saudi Arabia,Iraq,2010,0,1,1
Catalonia,Honduras,2010,4,0,4
Indonesia,Malaysia,2010,2,1,3
Basque Country,Venezuela,2010,3,1,4
Syria,South Korea,2010,0,1,1
Kuwait,Zambia,2010,4,0,4
Qatar,North Korea,2010,0,1,1
Iran,Angola,2011,1,0,1
Iraq,China PR,2011,2,3,5
Jordan,Uzbekistan,2011,2,2,4
United Arab Emirates,Syria,2011,2,0,2
Bahrain,North Korea,2011,0,1,1
Saudi Arabia,Angola,2011,0,0,0
Egypt,Tanzania,2011,5,1,6
Kenya,Sudan,2011,1,0,1
Uganda,Burundi,2011,3,1,4
United Arab Emirates,Australia,2011,0,0,0
Qatar,Uzbekistan,2011,0,2,2
DR Congo,Kenya,2011,1,0,1
Egypt,Uganda,2011,1,0,1
Kuwait,China PR,2011,0,2,2
Tanzania,Burundi,2011,1,1,2
Japan,Jordan,2011,1,1,2
Saudi Arabia,Syria,2011,1,2,3
India,Australia,2011,0,4,4
South Korea,Bahrain,2011,2,1,3
DR Congo,Sudan,2011,2,1,3
Egypt,Burundi,2011,3,0,3
Iraq,Iran,2011,1,2,3
North Korea,United Arab Emirates,2011,0,0,0
Uganda,Tanzania,2011,1,1,2
Qatar,China PR,2011,2,0,2
Uzbekistan,Kuwait,2011,2,1,3
Jordan,Saudi Arabia,2011,1,0,1
Syria,Japan,2011,1,2,3
Australia,South Korea,2011,1,1,2
Bahrain,India,2011,5,2,7
DR Congo,Uganda,2011,0,1,1
Costa Rica,Honduras,2011,1,1,2
Egypt,Kenya,2011,5,1,6
El Salvador,Nicaragua,2011,2,0,2
Panama,Belize,2011,2,0,2
Iran,North Korea,2011,1,0,1
United Arab Emirates,Iraq,2011,0,1,1
Belize,El Salvador,2011,2,5,7
China PR,Uzbekistan,2011,2,2,4
Guatemala,Costa Rica,2011,0,2,2
Panama,Nicaragua,2011,2,0,2
Qatar,Kuwait,2011,3,0,3
Tanzania,Sudan,2011,0,2,2
DR Congo,Kenya,2011,1,0,1
Egypt,Uganda,2011,3,1,4
Jordan,Syria,2011,2,1,3
Saudi Arabia,Japan,2011,0,5,5
Australia,Bahrain,2011,1,0,1
Honduras,Guatemala,2011,3,1,4
South Korea,India,2011,4,1,5
Nicaragua,Belize,2011,1,1,2
Panama,El Salvador,2011,2,0,2
Botswana,Sweden,2011,1,2,3
Iraq,North Korea,2011,1,0,1
United Arab Emirates,Iran,2011,0,3,3
Honduras,El Salvador,2011,2,0,2
Nicaragua,Guatemala,2011,1,2,3
Panama,Costa Rica,2011,1,1,2
Qatar,Japan,2011,2,3,5
Uzbekistan,Jordan,2011,2,1,3
Australia,Iraq,2011,1,0,1
Iran,South Korea,2011,0,1,1
United States,Chile,2011,1,1,2
Honduras,Costa Rica,2011,2,1,3
Panama,El Salvador,2011,0,0,0
Vanuatu,New Caledonia,2011,0,0,0
Japan,South Korea,2011,2,2,4
Uzbekistan,Australia,2011,0,6,6
Uzbekistan,South Korea,2011,2,3,5
Australia,Japan,2011,0,1,1
Moldova,Poland,2011,0,1,1
Cyprus,Sweden,2011,0,2,2
Ghana,Togo,2011,4,1,5
Republic of Ireland,Wales,2011,3,0,3
Mali,Ivory Coast,2011,0,1,1
Peru,Panama,2011,1,0,1
Romania,Ukraine,2011,2,2,4
Albania,Slovenia,2011,1,2,3
Andorra,Moldova,2011,1,2,3
Argentina,Portugal,2011,2,1,3
Armenia,Georgia,2011,1,2,3
Azerbaijan,Hungary,2011,0,2,2
Belarus,Kazakhstan,2011,1,1,2
Belgium,Finland,2011,1,1,2
Cambodia,Macau,2011,3,1,4
Cape Verde,Burkina Faso,2011,1,0,1
DR Congo,Gabon,2011,0,2,2
Croatia,Czech Republic,2011,4,2,6
Cyprus,Romania,2011,1,1,2
Denmark,England,2011,1,2,3
El Salvador,Haiti,2011,1,0,1
France,Brazil,2011,1,0,1
Germany,Italy,2011,1,1,2
Greece,Canada,2011,1,0,1
Guinea-Bissau,Gambia,2011,3,1,4
Honduras,Ecuador,2011,1,1,2
Iran,Russia,2011,1,0,1
Israel,Serbia,2011,0,2,2
Latvia,Bolivia,2011,2,1,3
Libya,Benin,2011,3,2,5
Luxembourg,Slovakia,2011,2,1,3
North Macedonia,Cameroon,2011,0,1,1
Malaysia,Hong Kong,2011,2,0,2
Malta,Switzerland,2011,0,0,0
Mexico,Bosnia and Herzegovina,2011,2,0,2
Morocco,Niger,2011,3,0,3
Mozambique,Botswana,2011,1,1,2
Namibia,Malawi,2011,1,2,3
Netherlands,Austria,2011,3,1,4
Nigeria,Sierra Leone,2011,2,1,3
Norway,Poland,2011,0,1,1
Philippines,Mongolia,2011,2,0,2
San Marino,Liechtenstein,2011,0,1,1
Scotland,Northern Ireland,2011,3,0,3
Senegal,Guinea,2011,4,0,4
South Africa,Kenya,2011,2,0,2
Spain,Colombia,2011,1,0,1
Eswatini,Zambia,2011,0,4,4
Sweden,Ukraine,2011,1,1,2
Tanzania,Palestine,2011,1,0,1
Turkey,South Korea,2011,0,0,0
Venezuela,Costa Rica,2011,2,2,4
Bahrain,Kuwait,2011,0,0,0
Laos,Taiwan,2011,1,1,2
Macau,Cambodia,2011,3,2,5
Gibraltar,Faroe Islands,2011,3,0,3
Mongolia,Philippines,2011,2,1,3
Argentina,Venezuela,2011,4,1,5
Botswana,Namibia,2011,1,1,2
Nepal,Bhutan,2011,1,0,1
Nepal,Bhutan,2011,2,1,3
Myanmar,Philippines,2011,1,1,2
India,Taiwan,2011,3,0,3
Maldives,Cambodia,2011,4,0,4
Palestine,Bangladesh,2011,2,0,2
Tajikistan,Kyrgyzstan,2011,1,0,1
Turkmenistan,Pakistan,2011,3,0,3
Bhutan,Afghanistan,2011,0,3,3
Myanmar,Bangladesh,2011,0,2,2
Cambodia,Tajikistan,2011,0,3,3
Maldives,Kyrgyzstan,2011,2,1,3
Pakistan,India,2011,1,3,4
Philippines,Palestine,2011,0,0,0
Cuba,El Salvador,2011,0,1,1
Afghanistan,Bhutan,2011,2,0,2
Austria,Belgium,2011,0,2,2
Bangladesh,Philippines,2011,0,3,3
Myanmar,Palestine,2011,1,3,4
Cambodia,Kyrgyzstan,2011,3,4,7
China PR,New Zealand,2011,1,1,2
Estonia,Uruguay,2011,2,0,2
Hungary,Netherlands,2011,0,4,4
Jamaica,Venezuela,2011,0,2,2
South Korea,Honduras,2011,4,0,4
Lithuania,Poland,2011,2,0,2
Luxembourg,France,2011,0,2,2
Maldives,Tajikistan,2011,0,0,0
Montenegro,Uzbekistan,2011,1,0,1
Panama,Bolivia,2011,2,0,2
Serbia,Northern Ireland,2011,2,1,3
Slovenia,Italy,2011,0,1,1
Spain,Czech Republic,2011,2,1,3
Turkmenistan,India,2011,1,1,2
Albania,Belarus,2011,1,0,1
Andorra,Slovakia,2011,0,1,1
Armenia,Russia,2011,0,0,0
Bosnia and Herzegovina,Romania,2011,2,1,3
Bulgaria,Switzerland,2011,0,0,0
Burkina Faso,Namibia,2011,4,0,4
Chad,Botswana,2011,0,1,1
Colombia,Ecuador,2011,2,0,2
Costa Rica,China PR,2011,2,2,4
Cyprus,Iceland,2011,0,0,0
Georgia,Croatia,2011,1,0,1
Germany,Kazakhstan,2011,4,0,4
Guinea-Bissau,Uganda,2011,0,1,1
Republic of Ireland,North Macedonia,2011,2,1,3
Israel,Latvia,2011,2,1,3
Jordan,Kuwait,2011,1,1,2
Kenya,Angola,2011,2,1,3
North Korea,Iraq,2011,2,0,2
Malawi,Togo,2011,1,0,1
Mali,Zimbabwe,2011,1,0,1
Malta,Greece,2011,0,1,1
Mexico,Paraguay,2011,3,1,4
Norway,Denmark,2011,1,1,2
Portugal,Chile,2011,1,1,2
Rwanda,Burundi,2011,3,1,4
Senegal,Cameroon,2011,1,0,1
South Africa,Egypt,2011,1,0,1
United States,Argentina,2011,1,1,2
Wales,England,2011,0,2,2
Algeria,Morocco,2011,1,0,1
Brazil,Scotland,2011,2,0,2
Congo,Ghana,2011,0,3,3
DR Congo,Mauritius,2011,3,0,3
Ivory Coast,Benin,2011,2,1,3
Madagascar,Guinea,2011,1,1,2
Mozambique,Zambia,2011,0,2,2
Niger,Sierra Leone,2011,3,1,4
Nigeria,Ethiopia,2011,4,0,4
Sri Lanka,Tajikistan,2011,2,2,4
Saint Kitts and Nevis,Grenada,2011,0,0,0
Sudan,Eswatini,2011,3,0,3
Guatemala,Bolivia,2011,1,1,2
Belarus,Canada,2011,0,1,1
Belgium,Azerbaijan,2011,4,1,5
China PR,Honduras,2011,3,0,3
Colombia,Chile,2011,0,2,2
Costa Rica,Argentina,2011,0,0,0
Cuba,Panama,2011,0,2,2
Cyprus,Bulgaria,2011,0,1,1
Czech Republic,Liechtenstein,2011,2,0,2
Ecuador,Peru,2011,0,0,0
El Salvador,Jamaica,2011,2,3,5
England,Ghana,2011,1,1,2
Equatorial Guinea,Gambia,2011,1,0,1
Estonia,Serbia,2011,1,1,2
France,Croatia,2011,0,0,0
Germany,Australia,2011,1,2,3
Greece,Poland,2011,0,0,0
Republic of Ireland,Uruguay,2011,2,3,5
Israel,Georgia,2011,1,0,1
Jordan,North Korea,2011,1,1,2
Kuwait,Iraq,2011,1,0,1
Lithuania,Spain,2011,1,3,4
Mexico,Venezuela,2011,1,1,2
Netherlands,Hungary,2011,5,3,8
Nigeria,Kenya,2011,3,0,3
Northern Ireland,Slovenia,2011,0,0,0
Oman,Tunisia,2011,2,1,3
Portugal,Finland,2011,2,0,2
Qatar,Russia,2011,1,1,2
Romania,Luxembourg,2011,3,1,4
Slovakia,Denmark,2011,1,2,3
Sri Lanka,Tajikistan,2011,0,2,2
Sweden,Moldova,2011,2,1,3
Turkey,Austria,2011,2,0,2
Ukraine,Italy,2011,0,2,2
United States,Paraguay,2011,0,1,1
Grenada,Saint Kitts and Nevis,2011,0,1,1
Tahiti,New Caledonia,2011,1,3,4
North Korea,Sri Lanka,2011,4,0,4
Nepal,Afghanistan,2011,1,0,1
Tahiti,New Caledonia,2011,1,0,1
Nepal,North Korea,2011,0,1,1
Sri Lanka,Afghanistan,2011,0,1,1
North Korea,Afghanistan,2011,2,0,2
Nepal,Sri Lanka,2011,0,0,0
Argentina,Ecuador,2011,2,2,4
Mozambique,Tanzania,2011,2,0,2
New Caledonia,Réunion,2011,2,4,6
Monaco,Vatican City,2011,2,1,3
New Caledonia,Réunion,2011,1,3,4
Tanzania,South Africa,2011,0,1,1
Guyana,Barbados,2011,0,1,1
Guyana,Barbados,2011,3,2,5
Republic of Ireland,Northern Ireland,2011,5,0,5
Argentina,Paraguay,2011,4,2,6
Eswatini,Botswana,2011,0,0,0
Wales,Scotland,2011,1,3,4
Estonia,Basque Country,2011,1,2,3
Cuba,Nicaragua,2011,1,1,2
Grenada,Antigua and Barbuda,2011,2,2,4
Wales,Northern Ireland,2011,2,0,2
Cuba,Nicaragua,2011,2,1,3
Mexico,Ecuador,2011,1,1,2
Barbados,Guyana,2011,1,0,1
El Salvador,Honduras,2011,2,2,4
Ethiopia,Sudan,2011,1,2,3
Germany,Uruguay,2011,2,1,3
Republic of Ireland,Scotland,2011,1,0,1
Panama,Grenada,2011,2,0,2
Eswatini,Malawi,2011,1,1,2
Tunisia,Central African Republic,2011,3,0,3
Corsica,Bulgaria,2011,1,0,1
Canada,Ecuador,2011,2,2,4
Guatemala,Venezuela,2011,0,2,2
Japan,Peru,2011,0,0,0
Mexico,New Zealand,2011,3,0,3
Nigeria,Argentina,2011,4,1,5
Ukraine,Uzbekistan,2011,2,0,2
Brittany,Equatorial Guinea,2011,0,1,1
Austria,Germany,2011,1,2,3
Belarus,France,2011,1,1,2
Belgium,Turkey,2011,1,1,2
Croatia,Georgia,2011,2,1,3
Faroe Islands,Slovenia,2011,0,2,2
Hong Kong,Malaysia,2011,1,1,2
Italy,Estonia,2011,3,0,3
Kazakhstan,Azerbaijan,2011,2,1,3
South Korea,Serbia,2011,2,1,3
Liechtenstein,Lithuania,2011,2,0,2
Luxembourg,Hungary,2011,0,1,1
Moldova,Sweden,2011,1,4,5
Romania,Bosnia and Herzegovina,2011,3,0,3
San Marino,Finland,2011,0,1,1
Bolivia,Paraguay,2011,0,2,2
Brazil,Netherlands,2011,0,0,0
Cameroon,Senegal,2011,0,0,0
Central African Republic,Tanzania,2011,2,1,3
England,Switzerland,2011,2,2,4
Greece,Malta,2011,3,1,4
Iceland,Denmark,2011,0,2,2
Latvia,Israel,2011,1,2,3
North Macedonia,Republic of Ireland,2011,0,2,2
Montenegro,Bulgaria,2011,1,1,2
Morocco,Algeria,2011,4,0,4
Peru,Czech Republic,2011,0,0,0
Portugal,Norway,2011,1,0,1
Russia,Armenia,2011,3,1,4
Sierra Leone,Niger,2011,1,0,1
Slovakia,Andorra,2011,1,0,1
Uganda,Guinea-Bissau,2011,2,0,2
United States,Spain,2011,0,4,4
Zambia,Mozambique,2011,3,0,3
Angola,Kenya,2011,1,0,1
Australia,New Zealand,2011,3,0,3
Benin,Ivory Coast,2011,2,6,8
Botswana,Malawi,2011,0,0,0
Burundi,Rwanda,2011,3,1,4
China PR,Uzbekistan,2011,1,0,1
Comoros,Libya,2011,1,1,2
Costa Rica,Cuba,2011,5,0,5
Egypt,South Africa,2011,0,0,0
Ethiopia,Nigeria,2011,2,2,4
Guinea,Madagascar,2011,4,1,5
Liberia,Cape Verde,2011,1,0,1
Mauritius,DR Congo,2011,1,2,3
Mexico,El Salvador,2011,5,0,5
Poland,Argentina,2011,2,1,3
Eswatini,Sudan,2011,1,2,3
Tunisia,Chad,2011,5,0,5
Zimbabwe,Mali,2011,2,1,3
Honduras,Guatemala,2011,0,0,0
Jamaica,Grenada,2011,4,0,4
Ukraine,France,2011,1,4,5
Australia,Serbia,2011,0,0,0
Austria,Latvia,2011,3,1,4
Azerbaijan,Germany,2011,1,3,4
Belarus,Luxembourg,2011,2,0,2
Bosnia and Herzegovina,Albania,2011,2,0,2
Brazil,Romania,2011,1,0,1
Ecuador,Greece,2011,1,1,2
Faroe Islands,Estonia,2011,2,0,2
Gabon,Gambia,2011,0,1,1
Italy,Republic of Ireland,2011,0,2,2
Japan,Czech Republic,2011,0,0,0
South Korea,Ghana,2011,2,1,3
Norway,Lithuania,2011,1,0,1
Panama,Guadeloupe,2011,3,2,5
Paraguay,Bolivia,2011,0,0,0
Russia,Cameroon,2011,0,0,0
San Marino,Hungary,2011,0,3,3
Sweden,Finland,2011,5,0,5
United States,Canada,2011,2,0,2
Venezuela,Spain,2011,0,3,3
China PR,North Korea,2011,2,0,2
Uruguay,Netherlands,2011,1,1,2
Costa Rica,El Salvador,2011,1,1,2
Cuba,Mexico,2011,0,5,5
Poland,France,2011,0,1,1
Grenada,Honduras,2011,1,7,8
Jamaica,Guatemala,2011,2,0,2
Canada,Guadeloupe,2011,1,0,1
Mexico,Venezuela,2011,0,3,3
Paraguay,Romania,2011,2,0,2
United States,Panama,2011,1,2,3
El Salvador,Cuba,2011,6,1,7
Mexico,Costa Rica,2011,4,1,5
Palestine,Vatican City,2011,9,1,10
Guatemala,Grenada,2011,4,0,4
Honduras,Jamaica,2011,0,1,1
Canada,Panama,2011,1,1,2
United States,Guadeloupe,2011,1,0,1
Montserrat,Belize,2011,2,5,7
Costa Rica,Honduras,2011,1,1,2
Malaysia,Myanmar,2011,2,0,2
Mexico,Guatemala,2011,2,1,3
Chile,Estonia,2011,4,0,4
Anguilla,United States Virgin Islands,2011,0,0,0
Panama,El Salvador,2011,1,1,2
United States,Jamaica,2011,2,0,2
Argentina,Albania,2011,4,0,4
Honduras,Mexico,2011,0,2,2
United States,Panama,2011,1,0,1
Uruguay,Estonia,2011,3,0,3
Paraguay,Chile,2011,0,0,0
Colombia,Senegal,2011,2,0,2
Kenya,Sudan,2011,1,2,3
United States,Mexico,2011,2,4,6
Rhodes,Greenland,2011,2,1,3
Jersey,Menorca,2011,2,0,2
Alderney,Gibraltar,2011,1,6,7
Isle of Wight,Ynys Môn,2011,4,0,4
Gotland,Isle of Man,2011,2,4,6
Guernsey,Falkland Islands,2011,5,0,5
Åland Islands,Saare County,2011,3,3,6
Bolivia,Mexico,2011,0,1,1
Greenland,Menorca,2011,2,3,5
Jersey,Rhodes,2011,2,0,2
Isle of Wight,Alderney,2011,4,0,4
Gibraltar,Ynys Môn,2011,6,3,9
Isle of Man,Falkland Islands,2011,6,0,6
Gotland,Guernsey,2011,2,5,7
Western Isles,Åland Islands,2011,0,2,2
Peru,Senegal,2011,1,0,1
Greenland,Jersey,2011,1,2,3
Alderney,Ynys Môn,2011,0,5,5
Isle of Wight,Gibraltar,2011,3,2,5
Guernsey,Isle of Man,2011,2,1,3
Falkland Islands,Gotland,2011,1,6,7
Saare County,Western Isles,2011,2,0,2
Afghanistan,Palestine,2011,0,2,2
Bangladesh,Pakistan,2011,3,0,3
Cambodia,Laos,2011,4,2,6
Iraq,Syria,2011,1,2,3
Malaysia,Taiwan,2011,2,1,3
Mongolia,Myanmar,2011,1,0,1
Nepal,Timor-Leste,2011,2,1,3
Sri Lanka,Philippines,2011,1,1,2
Vietnam,Macau,2011,6,0,6
Alderney,Falkland Islands,2011,0,3,3
Greenland,Western Isles,2011,1,0,1
Gotland,Ynys Môn,2011,1,2,3
Isle of Man,Menorca,2011,2,2,4
Saare County,Gibraltar,2011,0,4,4
Isle of Wight,Jersey,2011,1,0,1
Guernsey,Åland Islands,2011,3,2,5
Argentina,Bolivia,2011,1,1,2
Jersey,Åland Islands,2011,5,1,6
Isle of Wight,Guernsey,2011,4,2,6
Colombia,Costa Rica,2011,1,0,1
Lebanon,Kuwait,2011,0,6,6
Nepal,Timor-Leste,2011,5,0,5
Turks and Caicos Islands,Bahamas,2011,0,4,4
Brazil,Venezuela,2011,0,0,0
Myanmar,Mongolia,2011,2,0,2
Laos,Cambodia,2011,6,2,8
Macau,Vietnam,2011,1,7,8
Pakistan,Bangladesh,2011,0,0,0
Palestine,Afghanistan,2011,1,1,2
Paraguay,Ecuador,2011,0,0,0
Philippines,Sri Lanka,2011,4,0,4
United States Virgin Islands,British Virgin Islands,2011,2,0,2
Chile,Mexico,2011,2,1,3
Uruguay,Peru,2011,1,1,2
Jordan,Syria,2011,1,3,4
Argentina,Colombia,2011,0,0,0
Kuwait,Oman,2011,1,1,2
Malawi,Namibia,2011,0,1,1
Bolivia,Costa Rica,2011,0,2,2
Solomon Islands,Vanuatu,2011,2,1,3
Aruba,Saint Lucia,2011,4,2,6
Dominican Republic,Anguilla,2011,2,0,2
Jordan,Yemen,2011,4,0,4
Peru,Mexico,2011,1,0,1
Uruguay,Chile,2011,1,1,2
Bahamas,Turks and Caicos Islands,2011,6,0,6
Brazil,Paraguay,2011,2,2,4
Lebanon,Oman,2011,0,1,1
Solomon Islands,Vanuatu,2011,0,0,0
Venezuela,Ecuador,2011,1,0,1
British Virgin Islands,United States Virgin Islands,2011,1,2,3
Colombia,Bolivia,2011,2,0,2
Dominican Republic,Anguilla,2011,4,0,4
Maldives,India,2011,1,1,2
Argentina,Costa Rica,2011,3,0,3
Chile,Peru,2011,1,0,1
Saint Lucia,Aruba,2011,4,2,6
Uruguay,Mexico,2011,1,0,1
Brazil,Ecuador,2011,4,2,6
Iraq,Kuwait,2011,0,2,2
Jordan,Saudi Arabia,2011,1,1,2
Paraguay,Venezuela,2011,3,3,6
Thailand,Myanmar,2011,1,0,1
Fiji,Vanuatu,2011,1,2,3
Oman,Syria,2011,1,1,2
Thailand,Myanmar,2011,1,1,2
Argentina,Uruguay,2011,1,1,2
Colombia,Peru,2011,0,2,2
Jordan,Iraq,2011,1,1,2
Kuwait,Saudi Arabia,2011,1,0,1
Belize,Montserrat,2011,3,1,4
Brazil,Paraguay,2011,0,0,0
Chile,Venezuela,2011,1,2,3
Iran,Madagascar,2011,1,0,1
Qatar,India,2011,1,2,3
United Arab Emirates,Lebanon,2011,6,2,8
Singapore,Taiwan,2011,3,2,5
Peru,Uruguay,2011,0,2,2
Paraguay,Venezuela,2011,0,0,0
China PR,Laos,2011,7,2,9
Iran,Maldives,2011,4,0,4
Iraq,Yemen,2011,2,0,2
Jordan,Nepal,2011,9,0,9
Kuwait,Philippines,2011,3,0,3
Lebanon,Bangladesh,2011,4,0,4
Oman,Myanmar,2011,2,0,2
Peru,Venezuela,2011,4,1,5
Qatar,Vietnam,2011,3,0,3
Saudi Arabia,Hong Kong,2011,3,0,3
Singapore,Malaysia,2011,5,3,8
Syria,Tajikistan,2011,0,3,3
Thailand,Palestine,2011,1,0,1
Turkmenistan,Indonesia,2011,1,1,2
United Arab Emirates,India,2011,3,0,3
Uzbekistan,Kyrgyzstan,2011,4,0,4
Liberia,Gambia,2011,3,2,5
Uruguay,Paraguay,2011,3,0,3
Vanuatu,Solomon Islands,2011,0,0,0
Bangladesh,Lebanon,2011,2,0,2
Myanmar,Oman,2011,0,2,2
Hong Kong,Saudi Arabia,2011,0,5,5
India,United Arab Emirates,2011,2,2,4
Indonesia,Turkmenistan,2011,4,3,7
Kyrgyzstan,Uzbekistan,2011,0,3,3
Laos,China PR,2011,1,6,7
Malaysia,Singapore,2011,1,1,2
Maldives,Iran,2011,0,1,1
Nepal,Jordan,2011,1,1,2
Palestine,Thailand,2011,2,2,4
Philippines,Kuwait,2011,1,2,3
Tajikistan,Syria,2011,3,0,3
Vietnam,Qatar,2011,2,1,3
Yemen,Iraq,2011,0,0,0
Vanuatu,Solomon Islands,2011,2,0,2
Eswatini,Botswana,2011,0,2,2
El Salvador,Venezuela,2011,2,1,3
Albania,Montenegro,2011,3,2,5
Austria,Slovakia,2011,1,2,3
Azerbaijan,North Macedonia,2011,0,1,1
Belarus,Bulgaria,2011,1,0,1
Bolivia,Panama,2011,1,3,4
Bosnia and Herzegovina,Greece,2011,0,0,0
Botswana,Kenya,2011,1,0,1
China PR,Jamaica,2011,1,0,1
Costa Rica,Ecuador,2011,0,2,2
Cyprus,Moldova,2011,3,2,5
Equatorial Guinea,Guinea-Bissau,2011,1,4,5
France,Chile,2011,1,1,2
Gabon,Guinea,2011,1,1,2
Gambia,DR Congo,2011,3,0,3
Germany,Brazil,2011,3,2,5
Honduras,Venezuela,2011,2,0,2
Hungary,Iceland,2011,4,0,4
Republic of Ireland,Croatia,2011,0,0,0
Israel,Ivory Coast,2011,3,4,7
Italy,Spain,2011,2,1,3
Japan,South Korea,2011,3,0,3
Kazakhstan,Syria,2011,1,1,2
Kuwait,North Korea,2011,0,0,0
Latvia,Finland,2011,0,2,2
Liberia,Angola,2011,0,0,0
Liechtenstein,Switzerland,2011,1,2,3
Lithuania,Armenia,2011,3,0,3
Malta,Central African Republic,2011,2,1,3
Niger,Togo,2011,3,3,6
Northern Ireland,Faroe Islands,2011,4,0,4
Norway,Czech Republic,2011,3,0,3
Oman,Bahrain,2011,1,1,2
Poland,Georgia,2011,1,0,1
Portugal,Luxembourg,2011,5,0,5
Russia,Serbia,2011,1,0,1
San Marino,Romania,2011,0,1,1
Scotland,Denmark,2011,2,1,3
Senegal,Morocco,2011,0,2,2
Slovenia,Belgium,2011,0,0,0
South Africa,Burkina Faso,2011,3,0,3
Tunisia,Mali,2011,4,2,6
Turkey,Estonia,2011,3,0,3
Ukraine,Sweden,2011,0,1,1
United States,Mexico,2011,1,1,2
Wales,Australia,2011,1,2,3
Zimbabwe,Zambia,2011,2,0,2
Liberia,Niger,2011,0,0,0
Fiji,Samoa,2011,3,0,3
Lebanon,Syria,2011,2,3,5
Fiji,Samoa,2011,5,1,6
Eritrea,Sudan,2011,0,3,3
Qatar,Iraq,2011,0,1,1
Dominican Republic,Curaçao,2011,1,0,1
Lesotho,Eswatini,2011,0,0,0
Barbados,Saint Lucia,2011,4,0,4
Dominican Republic,Curaçao,2011,1,0,1
Trinidad and Tobago,India,2011,3,0,3
Indonesia,Palestine,2011,4,1,5
Jordan,Tunisia,2011,3,3,6
Lesotho,Eswatini,2011,0,1,1
Tuvalu,Samoa,2011,3,0,3
Guyana,India,2011,2,1,3
Thailand,Singapore,2011,0,0,0
United Arab Emirates,Qatar,2011,3,1,4
Bahrain,Sudan,2011,1,0,1
Angola,DR Congo,2011,1,2,3
Fiji,Tahiti,2011,3,0,3
Jordan,Indonesia,2011,1,0,1
New Caledonia,Vanuatu,2011,5,0,5
Oman,Kuwait,2011,1,0,1
Papua New Guinea,Cook Islands,2011,4,0,4
Solomon Islands,Guam,2011,7,0,7
Tuvalu,American Samoa,2011,4,0,4
Antigua and Barbuda,Saint Vincent and the Grenadines,2011,2,2,4
American Samoa,Solomon Islands,2011,0,4,4
Fiji,Kiribati,2011,9,0,9
New Caledonia,Guam,2011,9,0,9
Tahiti,Cook Islands,2011,7,0,7
Vanuatu,Tuvalu,2011,5,1,6
American Samoa,Guam,2011,0,2,2
Cook Islands,Kiribati,2011,3,0,3
New Caledonia,Tuvalu,2011,8,0,8
Tahiti,Papua New Guinea,2011,1,1,2
Vanuatu,Solomon Islands,2011,1,0,1
Albania,France,2011,1,2,3
Andorra,Armenia,2011,0,3,3
Antigua and Barbuda,Curaçao,2011,5,2,7
Argentina,Venezuela,2011,1,0,1
Australia,Thailand,2011,2,1,3
Azerbaijan,Belgium,2011,1,1,2
Bahrain,Qatar,2011,0,0,0
Belarus,Bosnia and Herzegovina,2011,0,2,2
Bulgaria,England,2011,0,3,3
Canada,Saint Lucia,2011,4,1,5
China PR,Singapore,2011,2,1,3
Cyprus,Portugal,2011,0,4,4
Dominica,Nicaragua,2011,0,2,2
Ecuador,Jamaica,2011,5,2,7
El Salvador,Dominican Republic,2011,3,2,5
Faroe Islands,Italy,2011,0,1,1
Finland,Moldova,2011,4,1,5
Georgia,Latvia,2011,0,1,1
Germany,Austria,2011,6,2,8
Ghana,Eswatini,2011,2,0,2
Grenada,Belize,2011,0,3,3
Guyana,Barbados,2011,2,0,2
Haiti,United States Virgin Islands,2011,6,0,6
Hungary,Sweden,2011,2,1,3
Iran,Indonesia,2011,3,0,3
Iraq,Jordan,2011,0,2,2
Republic of Ireland,Slovakia,2011,0,0,0
Israel,Greece,2011,0,1,1
Japan,North Korea,2011,1,0,1
South Korea,Lebanon,2011,6,0,6
Lithuania,Liechtenstein,2011,0,0,0
Luxembourg,Romania,2011,0,2,2
Malta,Croatia,2011,1,3,4
Netherlands,San Marino,2011,11,0,11
Northern Ireland,Serbia,2011,0,1,1
Norway,Iceland,2011,1,0,1
Oman,Saudi Arabia,2011,0,0,0
Panama,Paraguay,2011,0,2,2
Peru,Bolivia,2011,2,2,4
Poland,Mexico,2011,1,1,2
Russia,North Macedonia,2011,1,0,1
Slovenia,Estonia,2011,1,2,3
Spain,Chile,2011,3,2,5
Saint Kitts and Nevis,Puerto Rico,2011,0,0,0
Suriname,Cayman Islands,2011,1,0,1
Tajikistan,Uzbekistan,2011,0,1,1
Trinidad and Tobago,Bermuda,2011,1,0,1
Turkey,Kazakhstan,2011,2,1,3
Ukraine,Uruguay,2011,2,3,5
United Arab Emirates,Kuwait,2011,2,3,5
United States,Costa Rica,2011,0,1,1
Wales,Montenegro,2011,2,1,3
Burkina Faso,Equatorial Guinea,2011,1,0,1
Cameroon,Mauritius,2011,6,0,6
Cook Islands,Fiji,2011,1,4,5
Guam,Vanuatu,2011,1,4,5
Honduras,Colombia,2011,0,2,2
Kenya,Guinea-Bissau,2011,2,1,3
Kiribati,Papua New Guinea,2011,1,17,18
Malawi,Tunisia,2011,0,0,0
Namibia,Gambia,2011,1,0,1
New Caledonia,American Samoa,2011,8,0,8
Rwanda,Ivory Coast,2011,0,5,5
Scotland,Czech Republic,2011,2,2,4
Senegal,DR Congo,2011,2,0,2
Sierra Leone,Egypt,2011,2,1,3
Solomon Islands,Tuvalu,2011,6,1,7
Tanzania,Algeria,2011,1,1,2
Angola,Uganda,2011,2,0,2
Burundi,Benin,2011,1,1,2
Central African Republic,Morocco,2011,0,0,0
Comoros,Zambia,2011,1,2,3
Congo,Sudan,2011,0,1,1
Guinea,Ethiopia,2011,1,0,1
Madagascar,Nigeria,2011,0,2,2
Mexico,Chile,2011,1,0,1
Niger,South Africa,2011,2,1,3
Togo,Botswana,2011,1,0,1
Zimbabwe,Liberia,2011,3,0,3
American Samoa,Vanuatu,2011,0,8,8
Bolivia,Peru,2011,0,0,0
Brazil,Ghana,2011,1,0,1
Guam,Tuvalu,2011,1,1,2
Kiribati,Tahiti,2011,1,17,18
New Caledonia,Solomon Islands,2011,1,2,3
Papua New Guinea,Fiji,2011,0,2,2
Argentina,Nigeria,2011,3,1,4
Austria,Turkey,2011,0,0,0
Azerbaijan,Kazakhstan,2011,3,2,5
Barbados,Trinidad and Tobago,2011,0,2,2
Belgium,United States,2011,1,0,1
Belize,Guatemala,2011,1,2,3
Bosnia and Herzegovina,Belarus,2011,1,0,1
Cayman Islands,El Salvador,2011,1,4,5
Croatia,Israel,2011,3,1,4
Curaçao,Haiti,2011,2,4,6
Czech Republic,Ukraine,2011,4,0,4
Denmark,Norway,2011,2,0,2
Dominican Republic,Suriname,2011,1,1,2
Ecuador,Costa Rica,2011,4,0,4
England,Wales,2011,1,0,1
Estonia,Northern Ireland,2011,4,1,5
Finland,Netherlands,2011,0,2,2
Gabon,Niger,2011,1,0,1
Guyana,Bermuda,2011,2,1,3
Honduras,Paraguay,2011,0,3,3
Iceland,Cyprus,2011,1,0,1
Indonesia,Bahrain,2011,0,2,2
Italy,Slovenia,2011,1,0,1
Jamaica,Colombia,2011,0,2,2
Jordan,China PR,2011,2,1,3
North Korea,Tajikistan,2011,1,0,1
Kuwait,South Korea,2011,1,1,2
Latvia,Greece,2011,1,1,2
Lebanon,United Arab Emirates,2011,3,1,4
Luxembourg,Albania,2011,2,1,3
North Macedonia,Andorra,2011,1,0,1
Malta,Georgia,2011,1,1,2
Moldova,Hungary,2011,0,2,2
Nicaragua,Panama,2011,1,2,3
Poland,Germany,2011,2,2,4
Puerto Rico,Canada,2011,0,3,3
Qatar,Iran,2011,1,1,2
Romania,France,2011,0,0,0
Russia,Republic of Ireland,2011,0,0,0
San Marino,Sweden,2011,0,5,5
Saudi Arabia,Australia,2011,1,3,4
Scotland,Lithuania,2011,1,0,1
Serbia,Faroe Islands,2011,3,1,4
Singapore,Iraq,2011,0,2,2
Slovakia,Armenia,2011,0,4,4
Spain,Liechtenstein,2011,6,0,6
Saint Lucia,Saint Kitts and Nevis,2011,2,4,6
Switzerland,Bulgaria,2011,3,1,4
Thailand,Oman,2011,3,0,3
Uzbekistan,Japan,2011,1,1,2
Venezuela,Guinea,2011,2,1,3
United States Virgin Islands,Antigua and Barbuda,2011,1,8,9
Equatorial Guinea,Central African Republic,2011,3,0,3
New Caledonia,Tahiti,2011,3,1,4
Solomon Islands,Fiji,2011,2,1,3
New Caledonia,Solomon Islands,2011,2,0,2
Tahiti,Fiji,2011,2,1,3
Saint Vincent and the Grenadines,Dominica,2011,1,0,1
Argentina,Brazil,2011,0,0,0
Suriname,Curaçao,2011,2,0,2
Suriname,Curaçao,2011,2,2,4
Brazil,Argentina,2011,2,0,2
Antigua and Barbuda,Martinique,2011,1,0,1
Hong Kong,Philippines,2011,3,3,6
Ethiopia,Sudan,2011,1,2,3
Antigua and Barbuda,Martinique,2011,1,2,3
Hong Kong,Macau,2011,5,1,6
Ethiopia,Malawi,2011,0,0,0
Philippines,Macau,2011,2,0,2
Iran,Palestine,2011,7,0,7
China PR,United Arab Emirates,2011,2,1,3
Thailand,Jordan,2011,0,0,0
Andorra,Republic of Ireland,2011,0,2,2
Argentina,Chile,2011,4,1,5
Armenia,North Macedonia,2011,4,1,5
Australia,Malaysia,2011,5,0,5
Azerbaijan,Austria,2011,1,4,5
Barbados,Guyana,2011,0,2,2
Belgium,Kazakhstan,2011,4,1,5
Belize,Grenada,2011,1,4,5
Bermuda,Trinidad and Tobago,2011,2,1,3
Bosnia and Herzegovina,Luxembourg,2011,5,0,5
Cayman Islands,Suriname,2011,0,1,1
DR Congo,Cameroon,2011,2,3,5
Costa Rica,Brazil,2011,0,1,1
Curaçao,Antigua and Barbuda,2011,0,1,1
Cyprus,Denmark,2011,1,4,5
Czech Republic,Spain,2011,0,2,2
Dominica,Panama,2011,0,5,5
Dominican Republic,El Salvador,2011,1,2,3
Ecuador,Venezuela,2011,2,0,2
Finland,Sweden,2011,1,2,3
France,Albania,2011,3,0,3
Gabon,Equatorial Guinea,2011,2,0,2
Greece,Croatia,2011,2,0,2
Indonesia,Saudi Arabia,2011,0,0,0
Japan,Vietnam,2011,1,0,1
South Korea,Poland,2011,2,2,4
Latvia,Malta,2011,2,0,2
Montenegro,England,2011,2,2,4
Netherlands,Moldova,2011,1,0,1
Northern Ireland,Estonia,2011,1,2,3
Peru,Paraguay,2011,2,0,2
Portugal,Iceland,2011,5,3,8
Puerto Rico,Saint Kitts and Nevis,2011,1,1,2
Romania,Belarus,2011,2,2,4
Serbia,Italy,2011,1,1,2
Singapore,Philippines,2011,2,0,2
Slovakia,Russia,2011,0,1,1
Saint Lucia,Canada,2011,0,7,7
Turkey,Germany,2011,1,3,4
Ukraine,Bulgaria,2011,3,0,3
Uruguay,Bolivia,2011,4,2,6
United States Virgin Islands,Haiti,2011,0,7,7
Wales,Switzerland,2011,2,0,2
Cape Verde,Zimbabwe,2011,2,1,3
Chad,Malawi,2011,2,2,4
Egypt,Niger,2011,3,0,3
Ethiopia,Madagascar,2011,4,2,6
Gambia,Burkina Faso,2011,1,1,2
Guinea-Bissau,Angola,2011,0,2,2
Liberia,Mali,2011,1,2,3
Liechtenstein,Scotland,2011,0,1,1
Mozambique,Comoros,2011,3,0,3
Nigeria,Guinea,2011,2,2,4
South Africa,Sierra Leone,2011,0,0,0
Sudan,Ghana,2011,0,2,2
Eswatini,Congo,2011,0,1,1
Tunisia,Togo,2011,2,0,2
Uganda,Kenya,2011,0,0,0
United States,Honduras,2011,1,0,1
Zambia,Libya,2011,0,0,0
Algeria,Central African Republic,2011,2,0,2
Benin,Rwanda,2011,0,1,1
Ivory Coast,Burundi,2011,2,1,3
Mauritius,Senegal,2011,0,2,2
Morocco,Tanzania,2011,3,1,4
Albania,Romania,2011,1,1,2
Antigua and Barbuda,United States Virgin Islands,2011,10,0,10
Australia,Oman,2011,3,0,3
Belarus,Poland,2011,0,2,2
Bermuda,Guyana,2011,1,1,2
Bolivia,Colombia,2011,1,2,3
Bulgaria,Wales,2011,0,1,1
Canada,Puerto Rico,2011,0,0,0
Chile,Peru,2011,4,2,6
China PR,Iraq,2011,0,1,1
Croatia,Latvia,2011,2,0,2
Denmark,Portugal,2011,2,1,3
El Salvador,Cayman Islands,2011,4,0,4
Equatorial Guinea,Cameroon,2011,1,1,2
Estonia,Ukraine,2011,0,2,2
France,Bosnia and Herzegovina,2011,1,1,2
Georgia,Greece,2011,1,2,3
Germany,Belgium,2011,3,1,4
Ghana,Nigeria,2011,0,0,0
Guatemala,Belize,2011,3,1,4
Haiti,Curaçao,2011,2,2,4
Honduras,Jamaica,2011,2,1,3
Hungary,Finland,2011,0,0,0
Indonesia,Qatar,2011,2,3,5
Iran,Bahrain,2011,6,0,6
Republic of Ireland,Armenia,2011,2,1,3
Italy,Northern Ireland,2011,3,0,3
Japan,Tajikistan,2011,8,0,8
Kazakhstan,Austria,2011,0,0,0
North Korea,Uzbekistan,2011,0,1,1
South Korea,United Arab Emirates,2011,2,1,3
Lebanon,Kuwait,2011,2,2,4
Lithuania,Czech Republic,2011,1,4,5
North Macedonia,Slovakia,2011,1,1,2
Malta,Israel,2011,0,2,2
Mexico,Brazil,2011,1,2,3
Moldova,San Marino,2011,4,0,4
Norway,Cyprus,2011,3,1,4
Panama,Nicaragua,2011,5,1,6
Paraguay,Uruguay,2011,1,1,2
Philippines,Nepal,2011,4,0,4
Russia,Andorra,2011,6,0,6
Singapore,Jordan,2011,0,3,3
Slovenia,Serbia,2011,1,0,1
Spain,Scotland,2011,3,1,4
Saint Kitts and Nevis,Saint Lucia,2011,1,1,2
Suriname,Dominican Republic,2011,1,3,4
Sweden,Netherlands,2011,3,2,5
Switzerland,Montenegro,2011,2,0,2
Thailand,Saudi Arabia,2011,0,0,0
Trinidad and Tobago,Barbados,2011,4,0,4
Turkey,Azerbaijan,2011,1,0,1
United States,Ecuador,2011,0,1,1
Venezuela,Argentina,2011,1,0,1
Namibia,Lesotho,2011,0,0,0
Kuwait,Bahrain,2011,0,1,1
Qatar,Oman,2011,0,0,0
Antigua and Barbuda,Guadeloupe,2011,0,0,0
Iraq,Lebanon,2011,1,0,1
Lesotho,DR Congo,2011,0,3,3
Gabon,Brazil,2011,0,2,2
Albania,Azerbaijan,2011,0,1,1
Antigua and Barbuda,Haiti,2011,1,0,1
Argentina,Bolivia,2011,1,1,2
Bahrain,Iran,2011,1,1,2
Belgium,Romania,2011,2,1,3
Bermuda,Barbados,2011,2,1,3
Bosnia and Herzegovina,Portugal,2011,0,0,0
Burkina Faso,Mali,2011,1,1,2
Cameroon,Sudan,2011,3,1,4
Chad,Tanzania,2011,1,2,3
Colombia,Venezuela,2011,1,1,2
Comoros,Mozambique,2011,0,1,1
Cyprus,Scotland,2011,1,2,3
Czech Republic,Montenegro,2011,2,0,2
Denmark,Sweden,2011,2,0,2
Djibouti,Namibia,2011,0,4,4
Dominican Republic,Cayman Islands,2011,4,0,4
Equatorial Guinea,Madagascar,2011,2,0,2
Eritrea,Rwanda,2011,1,1,2
Estonia,Republic of Ireland,2011,0,4,4
France,United States,2011,1,0,1
Georgia,Moldova,2011,2,0,2
Greece,Russia,2011,1,1,2
Guatemala,Grenada,2011,3,0,3
Guinea-Bissau,Togo,2011,1,1,2
Guyana,Trinidad and Tobago,2011,2,1,3
Hungary,Liechtenstein,2011,5,0,5
Iraq,China PR,2011,1,0,1
Jordan,Singapore,2011,2,0,2
Kuwait,Lebanon,2011,0,1,1
Lesotho,Burundi,2011,1,0,1
Mexico,Serbia,2011,2,0,2
Morocco,Uganda,2011,0,1,1
Netherlands,Switzerland,2011,0,0,0
Nicaragua,Dominica,2011,1,0,1
Oman,Australia,2011,1,0,1
Panama,Costa Rica,2011,2,0,2
Paraguay,Ecuador,2011,2,1,3
Poland,Italy,2011,0,2,2
Puerto Rico,Saint Lucia,2011,4,0,4
Qatar,Indonesia,2011,4,0,4
São Tomé and Príncipe,Congo,2011,0,5,5
Saudi Arabia,Thailand,2011,3,0,3
Seychelles,Kenya,2011,0,3,3
Saint Kitts and Nevis,Canada,2011,0,0,0
Suriname,El Salvador,2011,1,3,4
Eswatini,DR Congo,2011,1,3,4
Tajikistan,Japan,2011,0,4,4
Turkey,Croatia,2011,0,3,3
Ukraine,Germany,2011,3,3,6
United Arab Emirates,South Korea,2011,0,2,2
Uruguay,Chile,2011,4,0,4
Uzbekistan,North Korea,2011,1,0,1
United States Virgin Islands,Curaçao,2011,0,3,3
Algeria,Tunisia,2011,1,0,1
England,Spain,2011,1,0,1
Nigeria,Botswana,2011,0,0,0
Somalia,Ethiopia,2011,0,0,0
South Africa,Ivory Coast,2011,1,1,2
Wales,Norway,2011,4,1,5
India,Malaysia,2011,1,1,2
Morocco,Cameroon,2011,1,1,2
Sudan,Uganda,2011,0,0,0
Bermuda,Barbados,2011,2,1,3
Brazil,Egypt,2011,2,0,2
Cayman Islands,Dominican Republic,2011,1,1,2
Honduras,Serbia,2011,2,0,2
Puerto Rico,Saint Lucia,2011,3,0,3
Belarus,Libya,2011,1,1,2
Burundi,Lesotho,2011,2,2,4
Canada,Saint Kitts and Nevis,2011,4,0,4
Chile,Paraguay,2011,2,0,2
Colombia,Argentina,2011,1,2,3
Congo,São Tomé and Príncipe,2011,1,1,2
DR Congo,Eswatini,2011,5,1,6
Costa Rica,Spain,2011,2,2,4
Croatia,Turkey,2011,0,0,0
Curaçao,United States Virgin Islands,2011,6,1,7
Denmark,Finland,2011,2,1,3
Ecuador,Peru,2011,2,0,2
El Salvador,Suriname,2011,4,0,4
England,Sweden,2011,1,0,1
France,Belgium,2011,0,0,0
Germany,Netherlands,2011,3,0,3
Ghana,Gabon,2011,2,1,3
Greece,Romania,2011,1,3,4
Grenada,Guatemala,2011,1,4,5
Guinea,Burkina Faso,2011,1,1,2
Haiti,Antigua and Barbuda,2011,2,1,3
Indonesia,Iran,2011,1,4,5
Republic of Ireland,Estonia,2011,1,1,2
Italy,Uruguay,2011,0,1,1
Jordan,Iraq,2011,1,3,4
Kenya,Seychelles,2011,4,0,4
North Korea,Japan,2011,1,0,1
Kuwait,United Arab Emirates,2011,2,1,3
Lebanon,South Korea,2011,2,1,3
Luxembourg,Switzerland,2011,0,1,1
North Macedonia,Albania,2011,0,0,0
Madagascar,Equatorial Guinea,2011,2,1,3
Montenegro,Czech Republic,2011,0,1,1
Mozambique,Comoros,2011,4,1,5
Namibia,Djibouti,2011,4,0,4
Niger,Botswana,2011,1,1,2
Nigeria,Zambia,2011,2,0,2
Panama,Dominica,2011,3,0,3
Poland,Hungary,2011,2,1,3
Portugal,Bosnia and Herzegovina,2011,6,2,8
Qatar,Bahrain,2011,0,0,0
Rwanda,Eritrea,2011,3,1,4
Saudi Arabia,Oman,2011,0,0,0
Singapore,China PR,2011,0,4,4
Slovenia,United States,2011,2,3,5
Tanzania,Chad,2011,0,1,1
Thailand,Australia,2011,0,1,1
Togo,Guinea-Bissau,2011,1,0,1
Trinidad and Tobago,Guyana,2011,2,0,2
Ukraine,Austria,2011,2,1,3
Uzbekistan,Tajikistan,2011,3,0,3
Venezuela,Bolivia,2011,1,0,1
Zimbabwe,South Africa,2011,2,1,3
Ethiopia,Somalia,2011,5,0,5
India,Malaysia,2011,3,2,5
American Samoa,Tonga,2011,2,1,3
Maldives,Seychelles,2011,3,0,3
Samoa,Cook Islands,2011,3,2,5
American Samoa,Cook Islands,2011,1,1,2
Maldives,Seychelles,2011,2,1,3
Samoa,Tonga,2011,1,1,2
Burundi,Somalia,2011,4,1,5
Uganda,Zanzibar,2011,2,1,3
Samoa,American Samoa,2011,1,0,1
Tanzania,Rwanda,2011,0,1,1
Tonga,Cook Islands,2011,2,1,3
Zanzibar,Burundi,2011,0,0,0
Zimbabwe,Djibouti,2011,2,0,2
Kenya,Malawi,2011,0,2,2
Somalia,Uganda,2011,0,4,4
Sudan,Ethiopia,2011,1,1,2
India,Zambia,2011,0,5,5
Rwanda,Zimbabwe,2011,2,0,2
Tanzania,Djibouti,2011,3,0,3
Ethiopia,Kenya,2011,0,2,2
Malawi,Sudan,2011,0,0,0
Burundi,Uganda,2011,1,0,1
Somalia,Zanzibar,2011,0,3,3
Bangladesh,Pakistan,2011,0,0,0
Curaçao,Bonaire,2011,1,3,4
Ethiopia,Malawi,2011,1,1,2
Maldives,Nepal,2011,1,1,2
Rwanda,Djibouti,2011,5,2,7
Suriname,Aruba,2011,0,0,0
India,Afghanistan,2011,1,1,2
Kenya,Sudan,2011,0,1,1
Sri Lanka,Bhutan,2011,3,0,3
Tanzania,Zimbabwe,2011,1,2,3
Bangladesh,Nepal,2011,0,1,1
Bonaire,Aruba,2011,2,2,4
Maldives,Pakistan,2011,0,0,0
Suriname,Curaçao,2011,2,0,2
Burundi,Sudan,2011,0,2,2
India,Bhutan,2011,5,0,5
Rwanda,Zanzibar,2011,2,1,3
Sri Lanka,Afghanistan,2011,1,3,4
Bahrain,Palestine,2011,0,1,1
Maldives,Bangladesh,2011,3,1,4
Pakistan,Nepal,2011,1,1,2
Tanzania,Malawi,2011,1,0,1
Uganda,Zimbabwe,2011,1,0,1
Bhutan,Afghanistan,2011,1,8,9
India,Sri Lanka,2011,3,0,3
Sudan,Rwanda,2011,1,2,3
Tanzania,Uganda,2011,1,3,4
Afghanistan,Nepal,2011,1,0,1
India,Maldives,2011,3,1,4
Rwanda,Uganda,2011,2,2,4
Tanzania,Sudan,2011,0,1,1
Cuba,Costa Rica,2011,1,1,2
India,Afghanistan,2011,4,0,4
Angola,Cameroon,2011,1,1,2
Angola,Zambia,2011,1,0,1
Chile,Paraguay,2011,3,2,5
Angola,Namibia,2011,0,0,0
Venezuela,Costa Rica,2011,0,2,2
Basque Country,Tunisia,2011,0,2,2
Catalonia,Tunisia,2011,0,0,0
Equatorial Guinea,South Africa,2012,0,0,0
Botswana,Zimbabwe,2012,0,0,0
Gabon,Burkina Faso,2012,0,0,0
Tunisia,Sudan,2012,3,0,3
Nigeria,Angola,2012,0,0,0
Senegal,Sudan,2012,1,0,1
Tunisia,Ivory Coast,2012,0,2,2
Angola,Sierra Leone,2012,3,1,4
Zambia,Namibia,2012,0,0,0
Oman,DR Congo,2012,2,2,4
São Tomé and Príncipe,Lesotho,2012,1,0,1
Gabon,Sudan,2012,0,0,0
Ivory Coast,Libya,2012,1,0,1
Kuwait,Uzbekistan,2012,1,0,1
Bahrain,Sweden,2012,0,2,2
Thailand,Norway,2012,0,1,1
Equatorial Guinea,Libya,2012,1,0,1
Senegal,Zambia,2012,1,2,3
United States,Venezuela,2012,1,0,1
Burkina Faso,Angola,2012,1,2,3
Ivory Coast,Sudan,2012,1,0,1
Lebanon,Iraq,2012,1,0,1
Lesotho,São Tomé and Príncipe,2012,0,0,0
Trinidad and Tobago,Finland,2012,2,3,5
Gabon,Niger,2012,2,0,2
Morocco,Tunisia,2012,1,2,3
Ghana,Botswana,2012,1,0,1
Mali,Guinea,2012,1,0,1
Equatorial Guinea,Senegal,2012,2,1,3
Libya,Zambia,2012,2,2,4
Mexico,Venezuela,2012,3,1,4
Panama,United States,2012,0,1,1
Ivory Coast,Burkina Faso,2012,2,0,2
Sudan,Angola,2012,2,2,4
Gabon,Morocco,2012,3,2,5
Niger,Tunisia,2012,1,2,3
Romania,Turkmenistan,2012,4,0,4
Botswana,Guinea,2012,1,6,7
Ghana,Mali,2012,2,0,2
Equatorial Guinea,Zambia,2012,0,1,1
Libya,Senegal,2012,2,1,3
United Arab Emirates,Uzbekistan,2012,1,0,1
Ivory Coast,Angola,2012,2,0,2
Sudan,Burkina Faso,2012,2,1,3
Gabon,Tunisia,2012,1,0,1
Niger,Morocco,2012,0,1,1
Botswana,Mali,2012,1,2,3
Ghana,Guinea,2012,1,1,2
Equatorial Guinea,Ivory Coast,2012,0,3,3
Zambia,Sudan,2012,3,0,3
Gabon,Mali,2012,1,1,2
Ghana,Tunisia,2012,2,1,3
Mali,Ivory Coast,2012,0,1,1
Zambia,Ghana,2012,1,0,1
Ghana,Mali,2012,0,2,2
Zambia,Ivory Coast,2012,0,0,0
Liberia,Nigeria,2012,0,2,2
Paraguay,Chile,2012,2,0,2
North Korea,Kuwait,2012,1,1,2
China PR,Kuwait,2012,2,0,2
Grenada,Guyana,2012,1,2,3
Jamaica,Cuba,2012,1,0,1
Paraguay,Guatemala,2012,2,1,3
Iran,Jordan,2012,2,2,4
Oman,India,2012,5,1,6
Tanzania,DR Congo,2012,0,0,0
Jamaica,Cuba,2012,3,0,3
Japan,Iceland,2012,3,1,4
Nicaragua,Puerto Rico,2012,1,0,1
Singapore,Azerbaijan,2012,2,2,4
Thailand,Maldives,2012,3,0,3
United Arab Emirates,Palestine,2012,3,0,3
South Korea,Uzbekistan,2012,4,2,6
Nicaragua,Puerto Rico,2012,4,1,5
Egypt,Kenya,2012,5,0,5
India,Azerbaijan,2012,0,3,3
Armenia,Serbia,2012,0,2,2
Bosnia and Herzegovina,Brazil,2012,1,2,3
Antigua and Barbuda,Trinidad and Tobago,2012,0,4,4
Armenia,Canada,2012,3,1,4
Australia,Saudi Arabia,2012,4,2,6
Austria,Finland,2012,3,1,4
Bahrain,Indonesia,2012,10,0,10
Bolivia,Cuba,2012,1,0,1
Burundi,Zimbabwe,2012,2,1,3
Chad,Malawi,2012,3,2,5
Chile,Ghana,2012,1,1,2
China PR,Jordan,2012,3,1,4
Congo,Uganda,2012,3,1,4
Croatia,Sweden,2012,1,3,4
Cyprus,Serbia,2012,0,0,0
Denmark,Russia,2012,0,2,2
Ecuador,Honduras,2012,2,0,2
Egypt,Niger,2012,1,0,1
El Salvador,Estonia,2012,0,2,2
England,Netherlands,2012,2,3,5
Ethiopia,Benin,2012,0,0,0
Gambia,Algeria,2012,1,2,3
Georgia,Albania,2012,2,1,3
Germany,France,2012,1,2,3
Greece,Belgium,2012,1,1,2
Guinea-Bissau,Cameroon,2012,0,1,1
Guyana,Guatemala,2012,0,2,2
Hong Kong,Taiwan,2012,5,1,6
Hungary,Bulgaria,2012,1,1,2
Iran,Qatar,2012,2,2,4
Iraq,Singapore,2012,7,1,8
Republic of Ireland,Czech Republic,2012,1,1,2
Israel,Ukraine,2012,2,3,5
Italy,United States,2012,0,1,1
Ivory Coast,Guinea,2012,0,0,0
Japan,Uzbekistan,2012,0,1,1
Kenya,Togo,2012,2,1,3
South Korea,Kuwait,2012,2,0,2
Latvia,Kazakhstan,2012,0,0,0
Liberia,Namibia,2012,1,0,1
Luxembourg,North Macedonia,2012,2,1,3
Madagascar,Cape Verde,2012,0,4,4
Malta,Liechtenstein,2012,2,1,3
Mexico,Colombia,2012,0,2,2
Moldova,Belarus,2012,0,0,0
Montenegro,Iceland,2012,2,1,3
Morocco,Burkina Faso,2012,2,0,2
New Zealand,Jamaica,2012,2,3,5
Northern Ireland,Norway,2012,0,3,3
Oman,Thailand,2012,2,0,2
Palestine,Azerbaijan,2012,2,0,2
Paraguay,Panama,2012,1,0,1
Philippines,Malaysia,2012,1,1,2
Poland,Portugal,2012,0,0,0
Romania,Uruguay,2012,1,1,2
Rwanda,Nigeria,2012,0,0,0
São Tomé and Príncipe,Sierra Leone,2012,2,1,3
Seychelles,DR Congo,2012,0,4,4
Slovenia,Scotland,2012,1,1,2
South Africa,Senegal,2012,0,0,0
Spain,Venezuela,2012,5,0,5
Switzerland,Argentina,2012,1,3,4
Tajikistan,North Korea,2012,1,1,2
Tanzania,Mozambique,2012,1,1,2
Tunisia,Peru,2012,1,1,2
Turkey,Slovakia,2012,1,2,3
United Arab Emirates,Lebanon,2012,4,2,6
Wales,Costa Rica,2012,0,1,1
Egypt,DR Congo,2012,0,0,0
Martinique,Guadeloupe,2012,1,2,3
Saint Kitts and Nevis,Antigua and Barbuda,2012,1,0,1
Nepal,Palestine,2012,0,2,2
Turkmenistan,Maldives,2012,3,1,4
India,Tajikistan,2012,0,2,2
North Korea,Philippines,2012,2,0,2
Nepal,Maldives,2012,0,1,1
Palestine,Turkmenistan,2012,0,0,0
Philippines,India,2012,2,0,2
Tajikistan,North Korea,2012,0,2,2
Maldives,Palestine,2012,0,2,2
Nepal,Turkmenistan,2012,0,3,3
North Korea,India,2012,4,0,4
Tajikistan,Philippines,2012,1,2,3
North Korea,Palestine,2012,2,0,2
Turkmenistan,Philippines,2012,2,1,3
Philippines,Palestine,2012,4,3,7
Turkmenistan,North Korea,2012,1,2,3
Chile,Peru,2012,3,1,4
French Guiana,Guyana,2012,1,0,1
Jamaica,Costa Rica,2012,0,0,0
French Guiana,Guyana,2012,0,2,2
Egypt,Uganda,2012,2,1,3
Egypt,Chad,2012,4,0,4
Guadeloupe,Martinique,2012,0,1,1
Costa Rica,Honduras,2012,1,1,2
Peru,Chile,2012,0,3,3
Egypt,Nigeria,2012,3,2,5
Egypt,Mauritania,2012,3,0,3
Egypt,Iraq,2012,0,0,0
Iran,Mauritania,2012,2,0,2
Guatemala,Paraguay,2012,0,1,1
Malaysia,Sri Lanka,2012,6,0,6
Iran,Mozambique,2012,3,0,3
Martinique,Guyana,2012,2,2,4
Guadeloupe,Guyana,2012,1,2,3
Lebanon,Egypt,2012,1,4,5
Angola,Zambia,2012,0,0,0
Jamaica,Guyana,2012,1,0,1
Lebanon,Jordan,2012,1,2,3
Egypt,Cameroon,2012,2,1,3
Panama,Guyana,2012,2,0,2
Albania,Qatar,2012,2,1,3
Egypt,Togo,2012,3,0,3
Latvia,Poland,2012,0,1,1
Botswana,Lesotho,2012,3,0,3
El Salvador,New Zealand,2012,2,2,4
Iraq,Sierra Leone,2012,1,0,1
Japan,Azerbaijan,2012,2,0,2
Libya,Rwanda,2012,2,0,2
Peru,Nigeria,2012,1,0,1
Venezuela,Moldova,2012,4,0,4
Georgia,Turkey,2012,1,3,4
Belgium,Montenegro,2012,2,2,4
Costa Rica,Guatemala,2012,3,2,5
Croatia,Estonia,2012,3,1,4
Morocco,Senegal,2012,0,1,1
Russia,Uruguay,2012,1,1,2
Algeria,Niger,2012,3,0,3
Burkina Faso,Benin,2012,2,2,4
Czech Republic,Israel,2012,2,1,3
Denmark,Brazil,2012,1,3,4
El Salvador,Moldova,2012,2,0,2
Finland,Turkey,2012,3,2,5
Greece,Slovenia,2012,1,1,2
Guinea,Cameroon,2012,1,2,3
Honduras,New Zealand,2012,0,1,1
Republic of Ireland,Bosnia and Herzegovina,2012,1,0,1
Jordan,Sierra Leone,2012,4,0,4
Mozambique,Namibia,2012,0,0,0
Netherlands,Bulgaria,2012,1,2,3
Norway,England,2012,0,1,1
Poland,Slovakia,2012,1,0,1
Portugal,North Macedonia,2012,0,0,0
Spain,Serbia,2012,2,0,2
Switzerland,Germany,2012,5,3,8
Tanzania,Malawi,2012,0,0,0
United States,Scotland,2012,5,1,6
Albania,Iran,2012,1,0,1
Chad,Libya,2012,0,1,1
France,Iceland,2012,3,2,5
Jamaica,Panama,2012,0,1,1
Mexico,Wales,2012,2,0,2
Oman,Lebanon,2012,1,1,2
Tunisia,Rwanda,2012,5,1,6
Iraq,Botswana,2012,1,1,2
Qatar,Palestine,2012,0,0,0
Ukraine,Estonia,2012,4,0,4
Angola,North Macedonia,2012,0,0,0
Bulgaria,Turkey,2012,0,2,2
Lithuania,Russia,2012,0,0,0
Azerbaijan,Andorra,2012,0,0,0
Chad,Rwanda,2012,1,1,2
Netherlands,Slovakia,2012,2,0,2
Spain,South Korea,2012,4,1,5
Sweden,Iceland,2012,3,2,5
Switzerland,Romania,2012,0,1,1
United States,Brazil,2012,1,4,5
Armenia,Greece,2012,0,1,1
France,Serbia,2012,2,0,2
Germany,Israel,2012,2,0,2
Mexico,Bosnia and Herzegovina,2012,2,1,3
Austria,Ukraine,2012,3,2,5
Czech Republic,Hungary,2012,1,2,3
Egypt,Mozambique,2012,2,0,2
Estonia,Finland,2012,1,2,3
Ghana,Lesotho,2012,7,0,7
Guatemala,Costa Rica,2012,1,0,1
Hong Kong,Singapore,2012,1,0,1
Italy,Russia,2012,0,3,3
Kazakhstan,Kyrgyzstan,2012,5,2,7
Latvia,Lithuania,2012,5,0,5
Malaysia,Philippines,2012,0,0,0
Panama,Jamaica,2012,2,1,3
Puerto Rico,Nicaragua,2012,3,1,4
Samoa,Tahiti,2012,1,10,11
Vanuatu,New Caledonia,2012,2,5,7
Algeria,Rwanda,2012,4,0,4
Argentina,Ecuador,2012,4,0,4
Bolivia,Chile,2012,0,2,2
Burkina Faso,Congo,2012,0,3,3
Cameroon,DR Congo,2012,1,0,1
Central African Republic,Botswana,2012,2,0,2
Denmark,Australia,2012,2,0,2
El Salvador,Honduras,2012,0,3,3
England,Belgium,2012,1,0,1
Fiji,New Zealand,2012,0,1,1
Gambia,Morocco,2012,1,1,2
Ivory Coast,Tanzania,2012,2,0,2
Kenya,Malawi,2012,0,0,0
Luxembourg,Malta,2012,0,2,2
Netherlands,Northern Ireland,2012,6,0,6
Norway,Croatia,2012,1,1,2
Poland,Andorra,2012,4,0,4
Portugal,Turkey,2012,1,3,4
Senegal,Liberia,2012,3,1,4
Sierra Leone,Cape Verde,2012,2,1,3
Solomon Islands,Papua New Guinea,2012,1,0,1
Sudan,Zambia,2012,0,3,3
Tunisia,Equatorial Guinea,2012,3,1,4
Uruguay,Venezuela,2012,1,1,2
Angola,Uganda,2012,1,1,2
Benin,Mali,2012,1,0,1
Canada,United States,2012,0,0,0
Estonia,Lithuania,2012,1,0,1
Finland,Latvia,2012,1,1,2
Japan,Oman,2012,3,0,3
Jordan,Iraq,2012,1,1,2
Lebanon,Qatar,2012,0,1,1
Mexico,Brazil,2012,2,0,2
Niger,Gabon,2012,3,0,3
Nigeria,Namibia,2012,1,0,1
Peru,Colombia,2012,0,1,1
Puerto Rico,Nicaragua,2012,1,1,2
South Africa,Ethiopia,2012,1,1,2
Spain,China PR,2012,1,0,1
Tahiti,New Caledonia,2012,4,3,7
Togo,Libya,2012,1,1,2
Uzbekistan,Iran,2012,0,1,1
Vanuatu,Samoa,2012,5,0,5
Zimbabwe,Guinea,2012,0,1,1
Hungary,Republic of Ireland,2012,0,0,0
Papua New Guinea,New Zealand,2012,1,2,3
Solomon Islands,Fiji,2012,0,0,0
Iraqi Kurdistan,Western Sahara,2012,6,0,6
Zanzibar,Raetia,2012,6,0,6
Northern Cyprus,Darfur,2012,15,0,15
Armenia,Kazakhstan,2012,3,0,3
Austria,Romania,2012,0,0,0
France,Estonia,2012,4,0,4
New Caledonia,Samoa,2012,9,0,9
Philippines,Indonesia,2012,2,2,4
Sweden,Serbia,2012,2,1,3
Tahiti,Vanuatu,2012,4,1,5
Turkey,Ukraine,2012,2,0,2
Western Sahara,Occitania,2012,2,6,8
Raetia,Tamil Eelam,2012,1,0,1
Darfur,Provence,2012,0,18,18
Papua New Guinea,Fiji,2012,1,1,2
Solomon Islands,New Zealand,2012,1,1,2
Iraqi Kurdistan,Occitania,2012,1,0,1
Tamil Eelam,Zanzibar,2012,0,3,3
Provence,Northern Cyprus,2012,2,1,3
Belarus,Lithuania,2012,1,1,2
Western Sahara,Darfur,2012,5,1,6
Occitania,Tamil Eelam,2012,7,0,7
Bahrain,Kuwait,2012,1,1,2
China PR,Vietnam,2012,3,0,3
Costa Rica,El Salvador,2012,2,2,4
Cuba,Canada,2012,0,1,1
Honduras,Panama,2012,0,2,2
Jamaica,Guatemala,2012,2,1,3
Japan,Jordan,2012,6,0,6
Lebanon,Uzbekistan,2012,1,1,2
Mexico,Guyana,2012,3,1,4
New Zealand,New Caledonia,2012,0,2,2
Oman,Australia,2012,0,0,0
Poland,Greece,2012,1,1,2
Qatar,South Korea,2012,1,4,5
Russia,Czech Republic,2012,4,1,5
Singapore,Malaysia,2012,2,2,4
Solomon Islands,Tahiti,2012,0,1,1
United States,Antigua and Barbuda,2012,3,1,4
Western Sahara,Raetia,2012,3,0,3
Iraqi Kurdistan,Provence,2012,2,1,3
Zanzibar,Northern Cyprus,2012,0,2,2
Bolivia,Paraguay,2012,3,1,4
Botswana,South Africa,2012,1,1,2
Brazil,Argentina,2012,3,4,7
Cape Verde,Tunisia,2012,1,2,3
Congo,Niger,2012,1,0,1
Equatorial Guinea,Sierra Leone,2012,2,2,4
French Guiana,Suriname,2012,2,1,3
Gabon,Burkina Faso,2012,1,0,1
Germany,Portugal,2012,1,0,1
Malawi,Nigeria,2012,1,1,2
Morocco,Ivory Coast,2012,2,2,4
Namibia,Kenya,2012,1,0,1
Netherlands,Denmark,2012,0,1,1
Uganda,Senegal,2012,1,1,2
Venezuela,Chile,2012,0,2,2
Zambia,Ghana,2012,1,0,1
Tamil Eelam,Raetia,2012,4,0,4
Occitania,Western Sahara,2012,3,1,4
Provence,Zanzibar,2012,2,7,9
Iraqi Kurdistan,Northern Cyprus,2012,2,1,3
DR Congo,Togo,2012,2,0,2
Ecuador,Colombia,2012,1,0,1
Ethiopia,Central African Republic,2012,2,0,2
Guinea,Egypt,2012,2,3,5
Hong Kong,Vietnam,2012,1,2,3
Republic of Ireland,Croatia,2012,1,3,4
Lesotho,Sudan,2012,0,0,0
Liberia,Angola,2012,0,0,0
Libya,Cameroon,2012,2,1,3
Mali,Algeria,2012,2,1,3
Mozambique,Zimbabwe,2012,0,0,0
Rwanda,Benin,2012,1,1,2
Solomon Islands,New Zealand,2012,3,4,7
Spain,Italy,2012,1,1,2
Tahiti,New Caledonia,2012,1,0,1
Tanzania,Gambia,2012,2,1,3
Uruguay,Peru,2012,4,2,6
France,England,2012,1,1,2
Ukraine,Sweden,2012,2,1,3
Antigua and Barbuda,Jamaica,2012,0,0,0
Australia,Japan,2012,1,1,2
Bahrain,Kuwait,2012,0,1,1
Canada,Honduras,2012,0,0,0
El Salvador,Mexico,2012,1,2,3
Greece,Czech Republic,2012,1,2,3
Guatemala,United States,2012,1,1,2
Guyana,Costa Rica,2012,0,4,4
Iran,Qatar,2012,0,0,0
Iraq,Oman,2012,1,1,2
South Korea,Lebanon,2012,3,0,3
Malaysia,Singapore,2012,2,0,2
Panama,Cuba,2012,1,0,1
Philippines,Guam,2012,3,0,3
Poland,Russia,2012,1,1,2
Denmark,Portugal,2012,2,3,5
Netherlands,Germany,2012,1,2,3
Italy,Croatia,2012,1,1,2
Spain,Republic of Ireland,2012,4,0,4
Algeria,Gambia,2012,4,1,5
Egypt,Central African Republic,2012,2,3,5
South Africa,Gabon,2012,3,0,3
Sweden,England,2012,2,3,5
Ukraine,France,2012,0,2,2
Cameroon,Guinea-Bissau,2012,1,0,1
Cape Verde,Madagascar,2012,3,1,4
Greece,Russia,2012,1,0,1
Malawi,Chad,2012,2,0,2
Namibia,Liberia,2012,0,0,0
Nigeria,Rwanda,2012,2,0,2
Poland,Czech Republic,2012,0,1,1
Sierra Leone,São Tomé and Príncipe,2012,4,2,6
Uganda,Congo,2012,4,0,4
Benin,Ethiopia,2012,1,1,2
DR Congo,Seychelles,2012,3,0,3
Denmark,Germany,2012,1,2,3
Portugal,Netherlands,2012,2,1,3
Togo,Kenya,2012,1,0,1
Zimbabwe,Burundi,2012,1,0,1
Croatia,Spain,2012,0,1,1
Italy,Republic of Ireland,2012,2,0,2
Saudi Arabia,Morocco,2012,4,0,4
Yemen,Palestine,2012,1,2,3
Sweden,France,2012,2,0,2
Ukraine,England,2012,0,1,1
Czech Republic,Portugal,2012,0,1,1
Germany,Greece,2012,4,2,6
Saudi Arabia,Kuwait,2012,4,0,4
Libya,Yemen,2012,3,1,4
Spain,France,2012,2,0,2
England,Italy,2012,0,0,0
Iraq,Lebanon,2012,1,0,1
Kuwait,Palestine,2012,2,0,2
Bahrain,Yemen,2012,0,2,2
Lebanon,Sudan,2012,0,2,2
Portugal,Spain,2012,0,0,0
Germany,Italy,2012,1,2,3
Saudi Arabia,Palestine,2012,2,2,4
Libya,Bahrain,2012,2,1,3
Central African Republic,Egypt,2012,1,1,2
Sudan,Iraq,2012,1,1,2
Spain,Italy,2012,4,0,4
Saudi Arabia,Libya,2012,0,2,2
Saudi Arabia,Iraq,2012,0,1,1
Malawi,Zambia,2012,1,0,1
British Virgin Islands,Anguilla,2012,1,0,1
South Sudan,Uganda,2012,2,2,4
Kenya,Botswana,2012,3,1,4
Aruba,Curaçao,2012,3,2,5
Suriname,Bonaire,2012,8,0,8
Aruba,Suriname,2012,1,0,1
Bonaire,Curaçao,2012,2,9,11
Botswana,Zimbabwe,2012,1,0,1
Zimbabwe,Lesotho,2012,5,3,8
Botswana,Lesotho,2012,0,0,0
Guam,Northern Mariana Islands,2012,3,1,4
Northern Mariana Islands,Macau,2012,1,5,6
Guam,Macau,2012,3,0,3
Zambia,Zimbabwe,2012,2,1,3
El Salvador,Guatemala,2012,1,0,1
Jordan,Uzbekistan,2012,0,1,1
Burkina Faso,Togo,2012,3,0,3
Liechtenstein,Andorra,2012,1,0,1
San Marino,Malta,2012,2,3,5
Albania,Moldova,2012,0,0,0
Angola,Mozambique,2012,2,0,2
Armenia,Belarus,2012,1,2,3
Austria,Turkey,2012,2,0,2
Azerbaijan,Bahrain,2012,3,0,3
Belgium,Netherlands,2012,4,2,6
Bolivia,Guyana,2012,2,0,2
Botswana,Tanzania,2012,3,3,6
Bulgaria,Cyprus,2012,1,0,1
Canada,Trinidad and Tobago,2012,2,0,2
China PR,Ghana,2012,1,1,2
Costa Rica,Peru,2012,0,1,1
Croatia,Switzerland,2012,2,4,6
Denmark,Slovakia,2012,1,3,4
Ecuador,Chile,2012,3,0,3
El Salvador,Jamaica,2012,0,2,2
England,Italy,2012,2,1,3
Equatorial Guinea,Liberia,2012,1,0,1
Estonia,Poland,2012,1,0,1
France,Uruguay,2012,0,0,0
Germany,Argentina,2012,1,3,4
Guatemala,Paraguay,2012,3,3,6
Hungary,Israel,2012,1,1,2
Iceland,Faroe Islands,2012,2,0,2
Iran,Tunisia,2012,2,2,4
Japan,Venezuela,2012,1,1,2
Jordan,Uzbekistan,2012,2,0,2
South Korea,Zambia,2012,2,1,3
Luxembourg,Georgia,2012,1,2,3
North Macedonia,Lithuania,2012,1,0,1
Mexico,United States,2012,0,1,1
Montenegro,Latvia,2012,2,0,2
Morocco,Guinea,2012,1,2,3
Niger,Nigeria,2012,0,0,0
Northern Ireland,Finland,2012,3,3,6
Norway,Greece,2012,2,3,5
Oman,Egypt,2012,1,1,2
Portugal,Panama,2012,2,0,2
Puerto Rico,Spain,2012,1,2,3
Russia,Ivory Coast,2012,1,1,2
Scotland,Australia,2012,3,1,4
Serbia,Republic of Ireland,2012,0,0,0
Singapore,Hong Kong,2012,2,0,2
Slovenia,Romania,2012,4,3,7
Sweden,Brazil,2012,0,3,3
Ukraine,Czech Republic,2012,0,0,0
Wales,Bosnia and Herzegovina,2012,0,2,2
India,Syria,2012,2,1,3
Maldives,Nepal,2012,2,1,3
Syria,Cameroon,2012,2,2,4
India,Maldives,2012,3,0,3
Botswana,Uganda,2012,0,0,0
Libya,Sudan,2012,3,0,3
Nepal,Cameroon,2012,0,5,5
Maldives,Syria,2012,2,1,3
India,Nepal,2012,0,0,0
Cameroon,Maldives,2012,3,1,4
Syria,Nepal,2012,2,0,2
India,Cameroon,2012,0,1,1
India,Cameroon,2012,2,2,4
Liberia,Malawi,2012,1,0,1
Cambodia,Philippines,2012,0,0,0
Jordan,Iran,2012,0,0,0
Martinique,British Virgin Islands,2012,16,0,16
Montserrat,Suriname,2012,1,7,8
Japan,United Arab Emirates,2012,1,0,1
Lebanon,Australia,2012,0,3,3
Qatar,Tajikistan,2012,1,2,3
Sweden,China PR,2012,1,0,1
Albania,Cyprus,2012,3,1,4
Andorra,Hungary,2012,0,5,5
Argentina,Paraguay,2012,3,1,4
Azerbaijan,Israel,2012,1,1,2
Bermuda,Puerto Rico,2012,1,2,3
Brazil,South Africa,2012,1,0,1
British Virgin Islands,Suriname,2012,0,4,4
Bulgaria,Italy,2012,2,2,4
Canada,Panama,2012,1,0,1
Colombia,Uruguay,2012,4,0,4
Costa Rica,Mexico,2012,0,2,2
Croatia,North Macedonia,2012,1,0,1
Cuba,Honduras,2012,0,3,3
Ecuador,Bolivia,2012,1,0,1
El Salvador,Guyana,2012,2,2,4
Estonia,Romania,2012,0,2,2
Finland,France,2012,0,1,1
Georgia,Belarus,2012,1,0,1
Germany,Faroe Islands,2012,3,0,3
Guatemala,Antigua and Barbuda,2012,3,1,4
Haiti,Saint Martin,2012,7,0,7
Iceland,Norway,2012,2,0,2
Jamaica,United States,2012,2,1,3
Kazakhstan,Republic of Ireland,2012,1,2,3
Latvia,Greece,2012,1,2,3
Liechtenstein,Bosnia and Herzegovina,2012,1,8,9
Lithuania,Slovakia,2012,1,1,2
Luxembourg,Portugal,2012,1,2,3
Malta,Armenia,2012,0,1,1
Martinique,Montserrat,2012,5,0,5
Moldova,England,2012,0,5,5
Montenegro,Poland,2012,2,2,4
Netherlands,Turkey,2012,2,0,2
New Caledonia,New Zealand,2012,0,2,2
Peru,Venezuela,2012,2,1,3
Russia,Northern Ireland,2012,2,0,2
Singapore,Philippines,2012,0,2,2
Slovenia,Switzerland,2012,0,2,2
Solomon Islands,Tahiti,2012,2,0,2
Spain,Saudi Arabia,2012,5,0,5
Uzbekistan,Kuwait,2012,3,0,3
Wales,Belgium,2012,0,2,2
Cape Verde,Cameroon,2012,2,0,2
Central African Republic,Burkina Faso,2012,1,0,1
DR Congo,Equatorial Guinea,2012,4,0,4
Denmark,Czech Republic,2012,0,0,0
Gabon,Togo,2012,1,1,2
Ghana,Malawi,2012,2,0,2
Ivory Coast,Senegal,2012,4,2,6
Liberia,Nigeria,2012,2,2,4
Mali,Botswana,2012,3,0,3
Scotland,Serbia,2012,0,0,0
Sierra Leone,Tunisia,2012,2,2,4
Sudan,Ethiopia,2012,5,3,8
Zambia,Uganda,2012,1,0,1
British Virgin Islands,Montserrat,2012,0,7,7
Guinea,Niger,2012,1,0,1
Haiti,Bermuda,2012,3,1,4
Libya,Algeria,2012,0,1,1
Martinique,Suriname,2012,2,2,4
Mozambique,Morocco,2012,2,0,2
Puerto Rico,Saint Martin,2012,9,0,9
Zimbabwe,Angola,2012,3,1,4
Brazil,China PR,2012,8,0,8
Indonesia,North Korea,2012,0,2,2
Laos,Philippines,2012,2,1,3
Antigua and Barbuda,Guatemala,2012,0,1,1
Austria,Germany,2012,1,2,3
Belgium,Croatia,2012,1,1,2
Bosnia and Herzegovina,Latvia,2012,4,1,5
Bulgaria,Armenia,2012,1,0,1
Myanmar,Singapore,2012,1,1,2
Chile,Colombia,2012,1,3,4
Cyprus,Iceland,2012,1,0,1
Czech Republic,Finland,2012,0,1,1
England,Ukraine,2012,1,1,2
France,Belarus,2012,3,1,4
Gabon,Saudi Arabia,2012,1,0,1
Georgia,Spain,2012,0,1,1
Greece,Lithuania,2012,2,0,2
Guyana,El Salvador,2012,2,3,5
Haiti,Puerto Rico,2012,2,1,3
Honduras,Cuba,2012,1,0,1
Hungary,Netherlands,2012,1,4,5
Republic of Ireland,Oman,2012,4,1,5
Israel,Russia,2012,0,4,4
Italy,Malta,2012,2,0,2
Japan,Iraq,2012,1,0,1
Jordan,Australia,2012,2,1,3
Lebanon,Iran,2012,1,0,1
Liberia,Ghana,2012,2,0,2
Malaysia,Vietnam,2012,0,2,2
Mexico,Costa Rica,2012,1,0,1
New Zealand,Solomon Islands,2012,6,1,7
Northern Ireland,Luxembourg,2012,1,1,2
Norway,Slovenia,2012,2,1,3
Panama,Canada,2012,2,0,2
Paraguay,Venezuela,2012,0,2,2
Peru,Argentina,2012,1,1,2
Poland,Moldova,2012,2,0,2
Portugal,Azerbaijan,2012,3,0,3
Romania,Andorra,2012,4,0,4
San Marino,Montenegro,2012,0,6,6
Scotland,North Macedonia,2012,1,1,2
Serbia,Wales,2012,6,1,7
Slovakia,Liechtenstein,2012,2,0,2
South Africa,Mozambique,2012,2,0,2
Saint Martin,Bermuda,2012,0,8,8
Sweden,Kazakhstan,2012,2,0,2
Switzerland,Albania,2012,2,0,2
Tahiti,New Caledonia,2012,0,4,4
Turkey,Estonia,2012,3,0,3
United Arab Emirates,Kuwait,2012,3,0,3
Uruguay,Ecuador,2012,1,1,2
United States,Jamaica,2012,1,0,1
Uzbekistan,South Korea,2012,2,2,4
Thailand,Laos,2012,2,1,3
Senegal,Ivory Coast,2012,0,2,2
Uganda,Zambia,2012,1,0,1
Equatorial Guinea,DR Congo,2012,2,1,3
French Guiana,Haiti,2012,1,2,3
Brazil,Argentina,2012,2,1,3
Nepal,Bangladesh,2012,1,1,2
Guadeloupe,Saint Pierre and Miquelon,2012,13,0,13
Martinique,New Caledonia,2012,2,0,2
Réunion,French Guiana,2012,2,0,2
Tahiti,Mayotte,2012,1,3,4
Aruba,Dominican Republic,2012,2,2,4
Barbados,Dominica,2012,1,0,1
Guadeloupe,French Guiana,2012,4,2,6
Martinique,Tahiti,2012,2,3,5
New Caledonia,Mayotte,2012,0,2,2
Réunion,Saint Pierre and Miquelon,2012,10,0,10
Barbados,Dominican Republic,2012,0,1,1
Dominica,Aruba,2012,3,2,5
Philippines,Guam,2012,1,0,1
Abkhazia,Artsakh,2012,1,1,2
French Guiana,Saint Pierre and Miquelon,2012,11,1,12
Martinique,Mayotte,2012,3,0,3
New Caledonia,Tahiti,2012,0,1,1
Réunion,Guadeloupe,2012,2,1,3
Barbados,Aruba,2012,2,1,3
Dominican Republic,Dominica,2012,2,1,3
Philippines,Macau,2012,5,0,5
French Guiana,Tahiti,2012,2,1,3
Oman,Yemen,2012,2,1,3
Saint Pierre and Miquelon,New Caledonia,2012,1,16,17
Guadeloupe,Mayotte,2012,1,0,1
Macau,Guam,2012,0,3,3
Philippines,Taiwan,2012,3,1,4
Réunion,Martinique,2012,2,2,4
Myanmar,Brunei,2012,1,0,1
Cambodia,Timor-Leste,2012,1,5,6
Myanmar,Timor-Leste,2012,2,1,3
Laos,Cambodia,2012,1,0,1
Cambodia,Brunei,2012,2,3,5
Timor-Leste,Laos,2012,3,1,4
French Guiana,Trinidad and Tobago,2012,1,4,5
Brazil,Iraq,2012,6,0,6
Brunei,Laos,2012,1,3,4
Myanmar,Cambodia,2012,3,0,3
Kuwait,Syria,2012,1,1,2
Albania,Iceland,2012,1,2,3
Antigua and Barbuda,United States,2012,1,2,3
Argentina,Uruguay,2012,3,0,3
Armenia,Italy,2012,1,3,4
Bahrain,Philippines,2012,0,0,0
Belarus,Spain,2012,0,4,4
Bolivia,Peru,2012,1,1,2
Bulgaria,Denmark,2012,1,1,2
Canada,Cuba,2012,3,0,3
Colombia,Paraguay,2012,2,0,2
Czech Republic,Malta,2012,3,1,4
Ecuador,Chile,2012,3,1,4
Egypt,Congo,2012,3,0,3
El Salvador,Costa Rica,2012,0,1,1
England,San Marino,2012,5,0,5
Estonia,Hungary,2012,0,1,1
Faroe Islands,Sweden,2012,1,2,3
Finland,Georgia,2012,1,1,2
France,Japan,2012,0,1,1
French Guiana,Anguilla,2012,4,1,5
Greece,Bosnia and Herzegovina,2012,0,0,0
Guatemala,Jamaica,2012,2,1,3
Guyana,Mexico,2012,0,5,5
Republic of Ireland,Germany,2012,1,6,7
Kazakhstan,Austria,2012,0,0,0
Lesotho,Eswatini,2012,2,1,3
Liechtenstein,Lithuania,2012,0,2,2
Luxembourg,Israel,2012,0,6,6
North Macedonia,Croatia,2012,1,2,3
Moldova,Ukraine,2012,0,0,0
Netherlands,Andorra,2012,3,0,3
Panama,Honduras,2012,0,0,0
Poland,South Africa,2012,1,0,1
Russia,Portugal,2012,1,0,1
Serbia,Belgium,2012,0,3,3
Slovakia,Latvia,2012,2,1,3
Slovenia,Cyprus,2012,2,1,3
Solomon Islands,New Caledonia,2012,2,6,8
Switzerland,Norway,2012,1,1,2
Tahiti,New Zealand,2012,0,2,2
Turkey,Romania,2012,0,1,1
United Arab Emirates,Uzbekistan,2012,2,2,4
Wales,Scotland,2012,2,1,3
Brunei,Timor-Leste,2012,2,1,3
Myanmar,Laos,2012,0,0,0
Namibia,Rwanda,2012,0,0,0
Lesotho,Eswatini,2012,0,1,1
Saudi Arabia,Congo,2012,3,2,5
Saint Kitts and Nevis,French Guiana,2012,0,3,3
Trinidad and Tobago,Anguilla,2012,10,0,10
Albania,Slovenia,2012,1,0,1
Andorra,Estonia,2012,0,1,1
Austria,Kazakhstan,2012,4,0,4
Belarus,Georgia,2012,2,0,2
Belgium,Scotland,2012,2,0,2
Bolivia,Uruguay,2012,4,1,5
Bosnia and Herzegovina,Lithuania,2012,3,0,3
Chile,Argentina,2012,1,2,3
Colombia,Cameroon,2012,3,0,3
Costa Rica,Guyana,2012,7,0,7
Croatia,Wales,2012,2,0,2
Cuba,Panama,2012,1,1,2
Cyprus,Norway,2012,1,3,4
Czech Republic,Bulgaria,2012,0,0,0
Egypt,Tunisia,2012,0,1,1
Faroe Islands,Republic of Ireland,2012,1,4,5
Germany,Sweden,2012,4,4,8
Honduras,Canada,2012,8,1,9
Hong Kong,Malaysia,2012,0,3,3
Hungary,Turkey,2012,3,1,4
Iceland,Switzerland,2012,0,2,2
Iran,South Korea,2012,1,0,1
Iraq,Australia,2012,1,2,3
Israel,Luxembourg,2012,3,0,3
Italy,Denmark,2012,3,1,4
Jamaica,Antigua and Barbuda,2012,4,1,5
Japan,Brazil,2012,0,4,4
Kenya,South Africa,2012,1,2,3
Kuwait,Philippines,2012,2,1,3
Latvia,Liechtenstein,2012,2,0,2
Lebanon,Yemen,2012,2,1,3
North Macedonia,Serbia,2012,1,0,1
Mexico,El Salvador,2012,2,0,2
New Caledonia,Solomon Islands,2012,5,0,5
New Zealand,Tahiti,2012,3,0,3
Oman,Jordan,2012,2,1,3
Paraguay,Peru,2012,1,0,1
Portugal,Northern Ireland,2012,1,1,2
Qatar,Uzbekistan,2012,0,1,1
Romania,Netherlands,2012,1,4,5
Russia,Azerbaijan,2012,1,0,1
San Marino,Moldova,2012,0,2,2
Singapore,India,2012,2,0,2
Slovakia,Greece,2012,0,1,1
Spain,France,2012,1,1,2
Ukraine,Montenegro,2012,0,1,1
United Arab Emirates,Bahrain,2012,6,2,8
United States,Guatemala,2012,3,1,4
Venezuela,Ecuador,2012,0,0,0
Vietnam,Indonesia,2012,0,0,0
Poland,England,2012,1,1,2
Saint Lucia,Curaçao,2012,5,1,6
Artsakh,Abkhazia,2012,3,0,3
Curaçao,Guyana,2012,1,2,3
Guadeloupe,Dominican Republic,2012,0,2,2
Martinique,Puerto Rico,2012,2,1,3
Vietnam,Turkmenistan,2012,0,1,1
Dominican Republic,Martinique,2012,1,1,2
Guadeloupe,Puerto Rico,2012,4,1,5
Saint Vincent and the Grenadines,Curaçao,2012,4,0,4
Vietnam,Laos,2012,4,0,4
Guadeloupe,Martinique,2012,3,3,6
Puerto Rico,Dominican Republic,2012,1,3,4
Laos,Turkmenistan,2012,2,4,6
Vietnam,Malaysia,2012,1,0,1
Iran,Tajikistan,2012,6,1,7
Thailand,Malaysia,2012,2,0,2
Bahrain,Jordan,2012,3,0,3
Oman,Estonia,2012,1,2,3
Eswatini,Lesotho,2012,0,0,0
Albania,Cameroon,2012,0,0,0
Algeria,Bosnia and Herzegovina,2012,0,1,1
Andorra,Iceland,2012,0,2,2
Angola,Congo,2012,1,1,2
Armenia,Lithuania,2012,4,2,6
Austria,Ivory Coast,2012,0,3,3
Bolivia,Costa Rica,2012,1,1,2
Brazil,Colombia,2012,1,1,2
Bulgaria,Ukraine,2012,0,1,1
Cape Verde,Ghana,2012,0,1,1
China PR,New Zealand,2012,1,1,2
DR Congo,Burkina Faso,2012,0,1,1
Cuba,Suriname,2012,5,0,5
Cyprus,Finland,2012,0,3,3
Czech Republic,Slovakia,2012,3,0,3
Gabon,Portugal,2012,2,2,4
Georgia,Egypt,2012,0,0,0
Grenada,French Guiana,2012,1,1,2
Haiti,Guyana,2012,1,0,1
Honduras,Peru,2012,0,0,0
Hungary,Norway,2012,0,2,2
Indonesia,Timor-Leste,2012,1,0,1
Iran,Uzbekistan,2012,0,1,1
Iraq,Jordan,2012,1,0,1
Republic of Ireland,Greece,2012,0,1,1
Israel,Belarus,2012,1,2,3
Italy,France,2012,1,2,3
South Korea,Australia,2012,1,2,3
Kuwait,Bahrain,2012,1,1,2
Liechtenstein,Malta,2012,0,1,1
Luxembourg,Scotland,2012,1,2,3
North Macedonia,Slovenia,2012,3,2,5
Malaysia,Hong Kong,2012,1,1,2
Montenegro,San Marino,2012,3,0,3
Morocco,Togo,2012,0,1,1
Netherlands,Germany,2012,0,0,0
Niger,Senegal,2012,1,1,2
Northern Ireland,Azerbaijan,2012,1,1,2
Oman,Japan,2012,1,2,3
Panama,Spain,2012,1,5,6
Paraguay,Guatemala,2012,3,1,4
Poland,Uruguay,2012,1,3,4
Qatar,Lebanon,2012,1,0,1
Romania,Belgium,2012,2,1,3
Russia,United States,2012,2,2,4
Rwanda,Namibia,2012,2,2,4
Saudi Arabia,Argentina,2012,0,0,0
Serbia,Chile,2012,3,1,4
South Africa,Zambia,2012,0,1,1
Sweden,England,2012,4,2,6
Tanzania,Kenya,2012,1,0,1
Thailand,Bhutan,2012,5,0,5
Tunisia,Switzerland,2012,1,2,3
Turkey,Denmark,2012,1,1,2
United Arab Emirates,Estonia,2012,2,1,3
Venezuela,Nigeria,2012,1,3,4
Philippines,Singapore,2012,1,0,1
French Guiana,Haiti,2012,1,0,1
Trinidad and Tobago,Suriname,2012,3,0,3
Indonesia,Cameroon,2012,0,0,0
Palestine,Syria,2012,1,1,2
Thailand,Bangladesh,2012,5,0,5
Guyana,French Guiana,2012,4,3,7
Singapore,Pakistan,2012,4,0,4
Malaysia,Bangladesh,2012,1,1,2
Palestine,Syria,2012,2,1,3
Argentina,Brazil,2012,2,1,3
Ethiopia,South Sudan,2012,1,0,1
Guam,Northern Mariana Islands,2012,8,0,8
Thailand,Philippines,2012,2,1,3
Uganda,Kenya,2012,1,0,1
Vietnam,Myanmar,2012,1,1,2
Burundi,Somalia,2012,5,1,6
Indonesia,Laos,2012,2,2,4
Malaysia,Singapore,2012,0,3,3
Tanzania,Sudan,2012,2,0,2
Rwanda,Malawi,2012,2,0,2
Zanzibar,Eritrea,2012,0,0,0
South Sudan,Kenya,2012,0,2,2
Thailand,Myanmar,2012,4,0,4
Uganda,Ethiopia,2012,1,0,1
Vietnam,Philippines,2012,0,1,1
Indonesia,Singapore,2012,1,0,1
Malaysia,Laos,2012,4,1,5
Somalia,Sudan,2012,0,1,1
Tanzania,Burundi,2012,0,1,1
Malawi,Eritrea,2012,3,2,5
Palestine,Bahrain,2012,0,2,2
Rwanda,Zanzibar,2012,1,2,3
Kenya,Ethiopia,2012,3,1,4
Philippines,Myanmar,2012,2,0,2
Thailand,Vietnam,2012,3,1,4
Uganda,South Sudan,2012,4,0,4
Burkina Faso,Togo,2012,2,1,3
Eritrea,Rwanda,2012,0,2,2
Hong Kong,Guam,2012,2,1,3
Malawi,Zanzibar,2012,2,0,2
Malaysia,Indonesia,2012,2,0,2
Mauritius,Comoros,2012,2,0,2
Singapore,Laos,2012,4,3,7
Somalia,Tanzania,2012,0,7,7
Sudan,Burundi,2012,0,1,1
Guinea,Sierra Leone,2012,0,0,0
Liberia,Mauritania,2012,0,1,1
Mozambique,Seychelles,2012,4,0,4
Burundi,Zanzibar,2012,0,0,0
Hong Kong,Australia,2012,0,1,1
North Korea,Guam,2012,5,0,5
Rwanda,Tanzania,2012,0,2,2
Kenya,Malawi,2012,1,0,1
Uganda,Ethiopia,2012,2,0,2
North Korea,Australia,2012,1,1,2
Uganda,Tanzania,2012,3,0,3
Zanzibar,Kenya,2012,2,2,4
Antigua and Barbuda,Dominican Republic,2012,1,2,3
Guam,Australia,2012,0,9,9
Haiti,Trinidad and Tobago,2012,0,0,0
Hong Kong,Taiwan,2012,2,0,2
Jamaica,French Guiana,2012,1,2,3
Kuwait,Palestine,2012,2,1,3
Martinique,Cuba,2012,1,0,1
Oman,Lebanon,2012,0,1,1
Philippines,Singapore,2012,0,0,0
Tanzania,Zanzibar,2012,1,1,2
Uganda,Kenya,2012,2,1,3
Antigua and Barbuda,Trinidad and Tobago,2012,2,0,2
Australia,Taiwan,2012,8,0,8
Bahrain,Yemen,2012,1,0,1
Dominican Republic,Haiti,2012,1,2,3
Hong Kong,North Korea,2012,0,4,4
Iran,Saudi Arabia,2012,0,0,0
Malaysia,Thailand,2012,1,1,2
Cuba,French Guiana,2012,2,1,3
Iraq,Jordan,2012,1,0,1
Jamaica,Martinique,2012,0,0,0
Antigua and Barbuda,Haiti,2012,0,1,1
Kuwait,Oman,2012,0,2,2
Lebanon,Palestine,2012,0,1,1
Trinidad and Tobago,Dominican Republic,2012,2,1,3
French Guiana,Martinique,2012,1,3,4
Iran,Bahrain,2012,0,0,0
Jamaica,Cuba,2012,0,1,1
Singapore,Philippines,2012,1,0,1
Yemen,Saudi Arabia,2012,0,1,1
Iraq,Syria,2012,1,1,2
Thailand,Malaysia,2012,2,0,2
Haiti,Cuba,2012,0,1,1
Kuwait,Lebanon,2012,2,1,3
North Macedonia,Poland,2012,1,4,5
Martinique,Trinidad and Tobago,2012,1,1,2
Oman,Palestine,2012,2,1,3
Angola,Gambia,2012,1,1,2
Bahrain,Saudi Arabia,2012,1,0,1
Comoros,Mauritius,2012,0,0,0
Iran,Yemen,2012,2,1,3
Mauritania,Liberia,2012,2,1,3
Seychelles,Mozambique,2012,1,2,3
Sierra Leone,Guinea,2012,1,1,2
Burundi,Kenya,2012,1,0,1
Cuba,Trinidad and Tobago,2012,1,0,1
Haiti,Martinique,2012,1,0,1
Syria,Jordan,2012,2,1,3
Togo,Burkina Faso,2012,0,1,1
Bahrain,Syria,2012,1,1,2
Oman,Iraq,2012,0,2,2
Oman,Benin,2012,2,0,2
Singapore,Thailand,2012,3,1,4
Iraq,Syria,2012,0,1,1
Oman,Bahrain,2012,1,0,1
Angola,Rwanda,2012,1,0,1
South Africa,Malawi,2012,3,1,4
Tanzania,Zambia,2012,1,0,1
Thailand,Singapore,2012,1,0,1
United Arab Emirates,Yemen,2012,2,0,2
Bahrain,Burkina Faso,2012,0,0,0
Qatar,Egypt,2012,0,2,2
Bahrain,Guinea,2012,3,0,3
Oman,Togo,2012,0,1,1
United Arab Emirates,Yemen,2012,3,1,4
Basque Country,Bolivia,2012,6,1,7
Ethiopia,Niger,2012,1,0,1
Iraq,Tunisia,2012,1,2,3
Catalonia,Nigeria,2013,1,1,2
Bahrain,Oman,2013,0,0,0
Niger,Togo,2013,3,1,4
Qatar,United Arab Emirates,2013,1,3,4
Zambia,Angola,2013,0,2,2
Kenya,Burundi,2013,0,0,0
Kuwait,Yemen,2013,2,0,2
Saudi Arabia,Iraq,2013,0,2,2
Tunisia,Ethiopia,2013,1,1,2
Bahrain,United Arab Emirates,2013,1,2,3
Qatar,Oman,2013,2,1,3
South Africa,Norway,2013,0,1,1
Zambia,Morocco,2013,0,0,0
Cape Verde,Nigeria,2013,0,0,0
Iraq,Kuwait,2013,1,0,1
Yemen,Saudi Arabia,2013,0,2,2
Gabon,Tunisia,2013,1,1,2
Ghana,Egypt,2013,3,0,3
Panama,Guatemala,2013,3,0,3
Bahrain,Qatar,2013,1,0,1
Ethiopia,Tanzania,2013,2,1,3
United Arab Emirates,Oman,2013,2,0,2
Iraq,Yemen,2013,2,0,2
Kuwait,Saudi Arabia,2013,1,0,1
Namibia,Morocco,2013,1,2,3
South Africa,Algeria,2013,0,0,0
Zambia,Norway,2013,0,0,0
Angola,Botswana,2013,2,0,2
Ghana,Tunisia,2013,4,2,6
Panama,Guatemala,2013,2,0,2
Togo,Niger,2013,2,1,3
Ivory Coast,Egypt,2013,4,2,6
Bahrain,Iraq,2013,1,1,2
Lebanon,Gabon,2013,0,0,0
United Arab Emirates,Kuwait,2013,1,0,1
Eswatini,Burkina Faso,2013,0,3,3
Bahrain,Kuwait,2013,1,6,7
Costa Rica,Belize,2013,1,0,1
Guatemala,Nicaragua,2013,1,1,2
Honduras,El Salvador,2013,1,1,2
United Arab Emirates,Iraq,2013,2,1,3
Angola,Morocco,2013,0,0,0
Chile,Haiti,2013,3,0,3
South Africa,Cape Verde,2013,0,0,0
Belize,Guatemala,2013,0,0,0
Costa Rica,Nicaragua,2013,2,0,2
El Salvador,Panama,2013,0,0,0
Ghana,DR Congo,2013,2,2,4
Mali,Niger,2013,1,0,1
Nigeria,Burkina Faso,2013,1,1,2
Zambia,Ethiopia,2013,1,1,2
Costa Rica,Guatemala,2013,1,1,2
Ivory Coast,Togo,2013,2,1,3
Nicaragua,Belize,2013,1,2,3
Panama,Honduras,2013,1,1,2
Tunisia,Algeria,2013,1,0,1
Morocco,Cape Verde,2013,1,1,2
South Africa,Angola,2013,2,0,2
Sweden,North Korea,2013,1,1,2
Thailand,Finland,2013,1,3,4
Ghana,Mali,2013,1,0,1
Niger,DR Congo,2013,0,0,0
Burkina Faso,Ethiopia,2013,4,0,4
Costa Rica,El Salvador,2013,1,0,1
Guatemala,Panama,2013,1,3,4
Honduras,Belize,2013,1,0,1
Zambia,Nigeria,2013,1,1,2
Algeria,Togo,2013,0,2,2
Ivory Coast,Tunisia,2013,3,0,3
Sweden,Finland,2013,3,0,3
Thailand,North Korea,2013,2,2,4
Cape Verde,Angola,2013,2,1,3
Costa Rica,Honduras,2013,1,0,1
El Salvador,Belize,2013,1,0,1
South Africa,Morocco,2013,2,2,4
DR Congo,Mali,2013,1,1,2
Niger,Ghana,2013,0,3,3
Burkina Faso,Zambia,2013,0,0,0
Ethiopia,Nigeria,2013,0,2,2
United States,Canada,2013,0,0,0
Algeria,Ivory Coast,2013,2,2,4
Oman,China PR,2013,1,0,1
Togo,Tunisia,2013,1,1,2
Jordan,Indonesia,2013,5,0,5
Qatar,Lebanon,2013,1,0,1
Uzbekistan,Azerbaijan,2013,0,0,0
Ghana,Cape Verde,2013,2,0,2
Romania,Poland,2013,1,4,5
South Africa,Mali,2013,1,1,2
Burkina Faso,Togo,2013,1,0,1
Ivory Coast,Nigeria,2013,1,2,3
Armenia,Luxembourg,2013,1,1,2
Albania,Georgia,2013,1,2,3
Azerbaijan,Liechtenstein,2013,1,0,1
Belgium,Slovakia,2013,2,1,3
Burkina Faso,Ghana,2013,1,1,2
Myanmar,Philippines,2013,0,1,1
Chile,Egypt,2013,2,1,3
Croatia,South Korea,2013,4,0,4
Cyprus,Serbia,2013,1,3,4
England,Brazil,2013,2,1,3
France,Germany,2013,1,2,3
Greece,Switzerland,2013,0,0,0
Honduras,United States,2013,2,1,3
Hungary,Belarus,2013,1,1,2
Iceland,Russia,2013,0,2,2
India,Palestine,2013,2,4,6
Iran,Lebanon,2013,5,0,5
Iraq,Indonesia,2013,1,0,1
Republic of Ireland,Poland,2013,2,0,2
Israel,Finland,2013,2,1,3
Japan,Latvia,2013,3,0,3
Jordan,Singapore,2013,4,0,4
Kenya,Libya,2013,3,0,3
North Korea,Laos,2013,1,0,1
North Macedonia,Denmark,2013,3,0,3
Mali,Nigeria,2013,1,4,5
Malta,Northern Ireland,2013,0,0,0
Mexico,Jamaica,2013,0,0,0
Moldova,Kazakhstan,2013,1,3,4
Nepal,Pakistan,2013,0,1,1
Netherlands,Italy,2013,1,1,2
Norway,Ukraine,2013,0,2,2
Oman,Syria,2013,1,0,1
Panama,Costa Rica,2013,2,2,4
Portugal,Ecuador,2013,2,3,5
Qatar,Malaysia,2013,2,0,2
Romania,Australia,2013,3,2,5
Rwanda,Uganda,2013,2,2,4
Saudi Arabia,China PR,2013,2,1,3
Scotland,Estonia,2013,1,0,1
Slovenia,Bosnia and Herzegovina,2013,0,3,3
Spain,Uruguay,2013,3,1,4
Sweden,Argentina,2013,2,3,5
Tanzania,Cameroon,2013,1,0,1
Thailand,Kuwait,2013,1,3,4
Turkey,Czech Republic,2013,0,2,2
Uzbekistan,Hong Kong,2013,0,0,0
Vietnam,United Arab Emirates,2013,1,2,3
Wales,Austria,2013,2,1,3
Yemen,Bahrain,2013,0,2,2
Zimbabwe,Botswana,2013,2,1,3
Mali,Ghana,2013,3,1,4
Nepal,Pakistan,2013,0,1,1
Nigeria,Burkina Faso,2013,1,0,1
Maldives,Pakistan,2013,1,1,2
Maldives,Pakistan,2013,3,0,3
Gambia,Mauritania,2013,0,2,2
Afghanistan,Sri Lanka,2013,1,0,1
Myanmar,Guam,2013,5,0,5
Gambia,Mauritania,2013,0,0,0
India,Taiwan,2013,2,1,3
Laos,Mongolia,2013,1,1,2
Nepal,Northern Mariana Islands,2013,6,0,6
Palestine,Bangladesh,2013,1,0,1
Guam,India,2013,0,4,4
Laos,Sri Lanka,2013,4,2,6
Mongolia,Afghanistan,2013,0,1,1
Nepal,Bangladesh,2013,0,2,2
Northern Mariana Islands,Palestine,2013,0,9,9
Bangladesh,Northern Mariana Islands,2013,4,0,4
Myanmar,India,2013,1,0,1
Laos,Afghanistan,2013,1,1,2
Nepal,Palestine,2013,0,0,0
Sri Lanka,Mongolia,2013,3,0,3
Qatar,Egypt,2013,3,1,4
Senegal,Libya,2013,0,4,4
Bahrain,Lebanon,2013,0,0,0
Kyrgyzstan,Macau,2013,1,0,1
Malaysia,Saudi Arabia,2013,1,4,5
Qatar,Thailand,2013,1,0,1
Tajikistan,Pakistan,2013,1,0,1
Botswana,Malawi,2013,1,0,1
Kyrgyzstan,Pakistan,2013,1,0,1
Macau,Tajikistan,2013,0,3,3
Oman,Haiti,2013,3,0,3
Rwanda,Libya,2013,0,1,1
Ecuador,El Salvador,2013,5,0,5
Italy,Brazil,2013,2,2,4
Jordan,Belarus,2013,1,0,1
Kuwait,Palestine,2013,2,1,3
Kyrgyzstan,Tajikistan,2013,1,0,1
Pakistan,Macau,2013,2,0,2
Andorra,Turkey,2013,0,2,2
Argentina,Venezuela,2013,3,0,3
Austria,Faroe Islands,2013,6,0,6
Bahrain,Qatar,2013,1,0,1
Bosnia and Herzegovina,Greece,2013,3,1,4
Bulgaria,Malta,2013,6,0,6
China PR,Iraq,2013,1,0,1
Colombia,Bolivia,2013,5,0,5
Croatia,Serbia,2013,2,0,2
Czech Republic,Denmark,2013,0,3,3
Egypt,Eswatini,2013,10,0,10
France,Georgia,2013,3,1,4
Honduras,Mexico,2013,2,2,4
Hong Kong,Vietnam,2013,1,0,1
Hungary,Romania,2013,2,2,4
Israel,Portugal,2013,3,3,6
Jamaica,Panama,2013,1,1,2
Japan,Canada,2013,2,1,3
Kazakhstan,Germany,2013,0,3,3
Lebanon,Thailand,2013,5,2,7
Liechtenstein,Latvia,2013,1,1,2
Luxembourg,Azerbaijan,2013,0,0,0
North Macedonia,Belgium,2013,0,2,2
Malaysia,Yemen,2013,2,1,3
Moldova,Montenegro,2013,0,1,1
Netherlands,Estonia,2013,3,0,3
New Zealand,New Caledonia,2013,2,1,3
Norway,Albania,2013,0,1,1
Peru,Chile,2013,1,0,1
Poland,Ukraine,2013,1,3,4
San Marino,England,2013,0,8,8
Scotland,Wales,2013,1,2,3
Slovakia,Lithuania,2013,1,1,2
Slovenia,Iceland,2013,1,2,3
Spain,Finland,2013,1,1,2
Sweden,Republic of Ireland,2013,0,0,0
Tahiti,Solomon Islands,2013,2,0,2
Turkmenistan,Cambodia,2013,7,0,7
United Arab Emirates,Uzbekistan,2013,2,1,3
Uruguay,Paraguay,2013,1,1,2
United States,Costa Rica,2013,1,0,1
Belize,Trinidad and Tobago,2013,0,0,0
Burkina Faso,Niger,2013,4,0,4
Cameroon,Togo,2013,2,1,3
Congo,Gabon,2013,1,0,1
Cyprus,Switzerland,2013,0,0,0
Indonesia,Saudi Arabia,2013,1,2,3
Ivory Coast,Gambia,2013,3,0,3
Namibia,Malawi,2013,0,1,1
Nigeria,Kenya,2013,1,1,2
Senegal,Angola,2013,1,1,2
South Africa,Central African Republic,2013,2,0,2
Tunisia,Sierra Leone,2013,2,1,3
DR Congo,Libya,2013,0,0,0
Dominican Republic,Haiti,2013,3,1,4
Equatorial Guinea,Cape Verde,2013,0,3,3
Ethiopia,Botswana,2013,1,0,1
Ghana,Sudan,2013,4,0,4
Lesotho,Zambia,2013,1,1,2
Liberia,Uganda,2013,2,0,2
Mozambique,Guinea,2013,0,0,0
Philippines,Cambodia,2013,8,0,8
Rwanda,Mali,2013,1,2,3
Tanzania,Morocco,2013,3,1,4
Canada,Belarus,2013,0,2,2
Russia,Brazil,2013,1,1,2
Albania,Lithuania,2013,4,1,5
Algeria,Benin,2013,3,1,4
Armenia,Czech Republic,2013,0,3,3
Australia,Oman,2013,2,2,4
Azerbaijan,Portugal,2013,0,2,2
Belgium,North Macedonia,2013,1,0,1
Bolivia,Argentina,2013,1,1,2
Chile,Uruguay,2013,2,0,2
Costa Rica,Jamaica,2013,2,0,2
Denmark,Bulgaria,2013,1,1,2
Ecuador,Paraguay,2013,4,1,5
Egypt,Zimbabwe,2013,2,1,3
Estonia,Andorra,2013,2,0,2
France,Spain,2013,0,1,1
Germany,Kazakhstan,2013,4,1,5
Iraq,Syria,2013,2,1,3
Republic of Ireland,Austria,2013,2,2,4
Jordan,Japan,2013,2,1,3
South Korea,Qatar,2013,2,1,3
Kuwait,Iran,2013,1,1,2
Luxembourg,Finland,2013,0,3,3
Malaysia,Palestine,2013,0,2,2
Malta,Italy,2013,0,2,2
Mexico,United States,2013,0,0,0
Montenegro,England,2013,1,1,2
Netherlands,Romania,2013,4,0,4
New Caledonia,Tahiti,2013,1,0,1
Northern Ireland,Israel,2013,0,2,2
Panama,Honduras,2013,2,0,2
Peru,Trinidad and Tobago,2013,3,0,3
Philippines,Turkmenistan,2013,1,0,1
Poland,San Marino,2013,5,0,5
Serbia,Scotland,2013,2,0,2
Slovakia,Sweden,2013,0,0,0
Solomon Islands,New Zealand,2013,0,2,2
Turkey,Hungary,2013,1,1,2
Ukraine,Moldova,2013,2,1,3
Uzbekistan,Lebanon,2013,1,0,1
Venezuela,Colombia,2013,1,0,1
Wales,Croatia,2013,1,2,3
Bolivia,Brazil,2013,0,4,4
Mexico,Peru,2013,0,0,0
Qatar,Palestine,2013,2,0,2
Saint Vincent and the Grenadines,Saint Lucia,2013,0,2,2
Brazil,Chile,2013,2,2,4
Zambia,Zimbabwe,2013,2,0,2
Libya,Mauritania,2013,2,0,2
Oman,Iran,2013,3,1,4
Venezuela,El Salvador,2013,2,1,3
Qatar,Latvia,2013,3,1,4
Algeria,Mauritania,2013,1,0,1
Ethiopia,Sudan,2013,2,0,2
Malawi,Zimbabwe,2013,1,1,2
Namibia,Zambia,2013,0,0,0
Iraq,Liberia,2013,0,1,1
Jordan,Libya,2013,1,0,1
Canada,Costa Rica,2013,0,1,1
Turkey,Latvia,2013,3,3,6
Brittany,Mali,2013,1,0,1
Ecuador,Germany,2013,2,4,6
England,Republic of Ireland,2013,1,1,2
Oman,Lebanon,2013,1,1,2
Qatar,Azerbaijan,2013,1,1,2
United States,Belgium,2013,2,4,6
Japan,Bulgaria,2013,0,2,2
Italy,San Marino,2013,4,0,4
Mexico,Nigeria,2013,2,2,4
Turkey,Slovenia,2013,0,2,2
Libya,Uganda,2013,3,0,3
Panama,Peru,2013,1,2,3
Algeria,Burkina Faso,2013,2,0,2
Brazil,England,2013,2,2,4
Honduras,Israel,2013,0,2,2
Republic of Ireland,Georgia,2013,4,0,4
Lesotho,South Africa,2013,0,2,2
Sudan,Tanzania,2013,0,0,0
Ukraine,Cameroon,2013,0,0,0
United States,Germany,2013,4,3,7
Estonia,Belarus,2013,0,2,2
Sweden,North Macedonia,2013,1,0,1
Myanmar,Singapore,2013,0,2,2
Egypt,Botswana,2013,1,1,2
Hong Kong,Philippines,2013,0,1,1
Jamaica,Mexico,2013,0,1,1
Japan,Australia,2013,1,1,2
Kazakhstan,Bulgaria,2013,1,2,3
Lebanon,South Korea,2013,1,1,2
Oman,Iraq,2013,1,0,1
Poland,Liechtenstein,2013,2,0,2
Qatar,Iran,2013,0,1,1
Romania,Trinidad and Tobago,2013,4,0,4
Tajikistan,Afghanistan,2013,3,2,5
Denmark,Georgia,2013,2,1,3
Kenya,Nigeria,2013,0,1,1
Malawi,Namibia,2013,0,0,0
Uruguay,France,2013,1,0,1
China PR,Uzbekistan,2013,1,2,3
Hungary,Kuwait,2013,1,0,1
Albania,Norway,2013,1,1,2
Argentina,Colombia,2013,0,0,0
Armenia,Malta,2013,0,1,1
Austria,Sweden,2013,2,1,3
Azerbaijan,Luxembourg,2013,1,1,2
Belgium,Serbia,2013,2,1,3
Bolivia,Venezuela,2013,1,1,2
Costa Rica,Honduras,2013,1,0,1
Croatia,Scotland,2013,0,1,1
Czech Republic,Italy,2013,0,0,0
Estonia,Trinidad and Tobago,2013,1,0,1
Finland,Belarus,2013,1,0,1
Iceland,Slovenia,2013,2,4,6
Indonesia,Netherlands,2013,0,3,3
Republic of Ireland,Faroe Islands,2013,3,0,3
Jamaica,United States,2013,1,2,3
Laos,Singapore,2013,2,5,7
Latvia,Bosnia and Herzegovina,2013,0,5,5
Libya,DR Congo,2013,0,0,0
Liechtenstein,Slovakia,2013,1,1,2
Lithuania,Greece,2013,0,1,1
Moldova,Poland,2013,1,1,2
Montenegro,Ukraine,2013,0,4,4
Panama,Mexico,2013,0,0,0
Paraguay,Chile,2013,1,2,3
Peru,Ecuador,2013,1,0,1
Portugal,Russia,2013,1,0,1
Sudan,Ghana,2013,1,3,4
Madrid,Andalusia,2013,1,2,3
Angola,Senegal,2013,1,1,2
Botswana,Ethiopia,2013,3,0,3
Cape Verde,Equatorial Guinea,2013,3,0,3
Central African Republic,South Africa,2013,0,3,3
Gabon,Congo,2013,0,0,0
Gambia,Ivory Coast,2013,0,3,3
Haiti,Spain,2013,1,2,3
Morocco,Tanzania,2013,2,1,3
Sierra Leone,Tunisia,2013,2,2,4
Switzerland,Cyprus,2013,1,0,1
Uganda,Liberia,2013,1,0,1
Zambia,Lesotho,2013,4,0,4
Benin,Algeria,2013,1,3,4
Brazil,France,2013,3,0,3
Guinea,Mozambique,2013,6,1,7
Mali,Rwanda,2013,1,1,2
Niger,Burkina Faso,2013,0,1,1
Togo,Cameroon,2013,0,3,3
Zimbabwe,Egypt,2013,2,4,6
Croatia,Portugal,2013,0,1,1
Australia,Jordan,2013,4,0,4
Belarus,Finland,2013,1,1,2
Chile,Bolivia,2013,3,1,4
China PR,Netherlands,2013,0,2,2
Colombia,Peru,2013,2,0,2
Denmark,Armenia,2013,0,4,4
Ecuador,Argentina,2013,1,1,2
Estonia,Kyrgyzstan,2013,1,1,2
Guatemala,Belize,2013,0,0,0
Honduras,Jamaica,2013,2,0,2
Iran,Lebanon,2013,4,0,4
Iraq,Japan,2013,0,1,1
Italy,Haiti,2013,2,2,4
South Korea,Uzbekistan,2013,1,0,1
Mexico,Costa Rica,2013,0,0,0
Norway,North Macedonia,2013,2,0,2
Qatar,North Korea,2013,0,0,0
Spain,Republic of Ireland,2013,2,0,2
Sweden,Faroe Islands,2013,2,0,2
United States,Panama,2013,2,0,2
Venezuela,Uruguay,2013,0,1,1
Ghana,Ivory Coast,2013,2,1,3
Malawi,Kenya,2013,2,2,4
Namibia,Nigeria,2013,1,1,2
Ghana,Ivory Coast,2013,1,1,2
Guatemala,Argentina,2013,0,4,4
Libya,Togo,2013,2,0,2
Moldova,Kyrgyzstan,2013,2,1,3
Botswana,Central African Republic,2013,3,2,5
Brazil,Japan,2013,3,0,3
Cape Verde,Sierra Leone,2013,1,0,1
China PR,Thailand,2013,1,5,6
Congo,Burkina Faso,2013,0,1,1
Gabon,Niger,2013,4,1,5
Morocco,Gambia,2013,2,0,2
Uganda,Angola,2013,2,1,3
Zambia,Sudan,2013,1,1,2
DR Congo,Cameroon,2013,0,0,0
Equatorial Guinea,Tunisia,2013,1,1,2
Ethiopia,South Africa,2013,2,1,3
Guinea,Zimbabwe,2013,2,0,2
Lesotho,Ghana,2013,0,2,2
Liberia,Senegal,2013,0,2,2
Mali,Benin,2013,2,2,4
Mexico,Italy,2013,1,2,3
Mozambique,Egypt,2013,0,1,1
Rwanda,Algeria,2013,0,1,1
Spain,Uruguay,2013,2,1,3
Tanzania,Ivory Coast,2013,2,4,6
Tahiti,Nigeria,2013,1,6,7
Australia,Iraq,2013,1,0,1
Costa Rica,Panama,2013,2,0,2
Jordan,Oman,2013,1,0,1
South Korea,Iran,2013,0,1,1
United States,Honduras,2013,1,0,1
Uzbekistan,Qatar,2013,5,1,6
Brazil,Mexico,2013,2,0,2
Italy,Japan,2013,4,3,7
Nigeria,Uruguay,2013,1,2,3
Spain,Tahiti,2013,10,0,10
Brazil,Italy,2013,4,2,6
Japan,Mexico,2013,1,2,3
Monaco,Vatican City,2013,2,0,2
Nigeria,Spain,2013,0,3,3
Eswatini,Angola,2013,0,1,1
Uruguay,Tahiti,2013,8,0,8
Brazil,Uruguay,2013,2,1,3
Spain,Italy,2013,0,0,0
Angola,Eswatini,2013,1,0,1
Libya,Burkina Faso,2013,2,1,3
Brazil,Spain,2013,3,0,3
Uruguay,Italy,2013,2,2,4
Mali,Guinea,2013,3,1,4
Nigeria,Ivory Coast,2013,4,1,5
Namibia,Mauritius,2013,2,1,3
Botswana,Eswatini,2013,0,0,0
Canada,Martinique,2013,0,1,1
DR Congo,Congo,2013,2,1,3
Mexico,Panama,2013,1,2,3
El Salvador,Trinidad and Tobago,2013,2,2,4
Haiti,Honduras,2013,0,2,2
Kenya,Lesotho,2013,2,2,4
Namibia,Seychelles,2013,4,2,6
Costa Rica,Cuba,2013,3,0,3
Kenya,Eswatini,2013,2,0,2
Lesotho,Botswana,2013,3,3,6
United States,Belize,2013,6,1,7
Mauritius,Seychelles,2013,4,0,4
Kenya,Botswana,2013,1,2,3
Lesotho,Eswatini,2013,2,0,2
Mexico,Canada,2013,2,0,2
Panama,Martinique,2013,1,0,1
Honduras,El Salvador,2013,1,0,1
Trinidad and Tobago,Haiti,2013,0,2,2
Costa Rica,Belize,2013,1,0,1
Morocco,Tunisia,2013,0,0,0
South Africa,Namibia,2013,2,1,3
United States,Cuba,2013,4,1,5
Zimbabwe,Malawi,2013,1,1,2
Martinique,Mexico,2013,1,3,4
Panama,Canada,2013,0,0,0
Zambia,Mozambique,2013,3,1,4
Angola,Lesotho,2013,1,1,2
Bermuda,Greenland,2013,3,0,3
Frøya,Falkland Islands,2013,1,2,3
El Salvador,Haiti,2013,1,0,1
Honduras,Trinidad and Tobago,2013,0,2,2
Bermuda,Falkland Islands,2013,8,0,8
Greenland,Frøya,2013,12,0,12
Cuba,Belize,2013,4,0,4
Namibia,Mozambique,2013,0,1,1
Malawi,Angola,2013,2,3,5
United States,Costa Rica,2013,1,0,1
Zambia,South Africa,2013,0,0,0
Zimbabwe,Lesotho,2013,2,1,3
Falkland Islands,Greenland,2013,0,9,9
Bermuda,Frøya,2013,8,0,8
Falkland Islands,Frøya,2013,6,0,6
Bermuda,Greenland,2013,1,0,1
Angola,Mozambique,2013,0,1,1
South Korea,Australia,2013,0,0,0
Lesotho,South Africa,2013,1,2,3
Mauritania,Senegal,2013,2,0,2
Mexico,Trinidad and Tobago,2013,1,0,1
Panama,Cuba,2013,6,1,7
Zambia,Zimbabwe,2013,2,0,2
Honduras,Costa Rica,2013,1,0,1
Japan,China PR,2013,3,3,6
United States,El Salvador,2013,5,1,6
South Korea,China PR,2013,0,0,0
Panama,Mexico,2013,2,1,3
United States,Honduras,2013,3,1,4
Japan,Australia,2013,3,2,5
Ivory Coast,Nigeria,2013,2,0,2
Niger,Burkina Faso,2013,1,0,1
Rwanda,Ethiopia,2013,1,0,1
Uganda,Tanzania,2013,3,1,4
Australia,China PR,2013,3,4,7
Cameroon,Gabon,2013,1,0,1
Congo,DR Congo,2013,1,0,1
Guinea,Mali,2013,1,0,1
South Korea,Japan,2013,1,2,3
Mauritius,Zimbabwe,2013,0,3,3
Mozambique,Namibia,2013,3,0,3
Sudan,Burundi,2013,1,1,2
United States,Panama,2013,1,0,1
Namibia,Mozambique,2013,3,0,3
Zimbabwe,Mauritius,2013,1,0,1
Gabon,Cameroon,2013,1,0,1
Jordan,Libya,2013,2,1,3
Albania,Armenia,2013,2,0,2
Algeria,Guinea,2013,2,2,4
Austria,Greece,2013,0,2,2
Azerbaijan,Malta,2013,3,0,3
Belarus,Montenegro,2013,1,1,2
Belgium,France,2013,0,0,0
Bosnia and Herzegovina,United States,2013,3,4,7
Chile,Iraq,2013,6,0,6
Colombia,Serbia,2013,1,0,1
Dominican Republic,Costa Rica,2013,0,4,4
Ecuador,Spain,2013,0,2,2
Egypt,Uganda,2013,3,0,3
England,Scotland,2013,3,2,5
Estonia,Latvia,2013,1,1,2
Finland,Slovenia,2013,2,0,2
Gabon,Cape Verde,2013,1,1,2
Germany,Paraguay,2013,3,3,6
Hungary,Czech Republic,2013,1,1,2
Iceland,Faroe Islands,2013,1,0,1
Indonesia,Philippines,2013,2,0,2
Italy,Argentina,2013,1,2,3
Japan,Uruguay,2013,2,4,6
Kazakhstan,Georgia,2013,1,0,1
South Korea,Peru,2013,0,0,0
Libya,Central African Republic,2013,0,0,0
Liechtenstein,Croatia,2013,2,3,5
Luxembourg,Lithuania,2013,2,1,3
North Macedonia,Bulgaria,2013,2,0,2
Mexico,Ivory Coast,2013,4,1,5
Moldova,Andorra,2013,1,1,2
Morocco,Burkina Faso,2013,1,2,3
Northern Ireland,Russia,2013,1,0,1
Poland,Denmark,2013,3,2,5
Portugal,Netherlands,2013,1,1,2
Romania,Slovakia,2013,1,1,2
Rwanda,Malawi,2013,0,1,1
Singapore,Oman,2013,0,2,2
South Africa,Nigeria,2013,0,2,2
Sweden,Norway,2013,4,2,6
Switzerland,Brazil,2013,1,0,1
Tajikistan,India,2013,3,0,3
Tunisia,Congo,2013,3,0,3
Turkey,Ghana,2013,2,2,4
Ukraine,Israel,2013,2,0,2
Venezuela,Bolivia,2013,2,2,4
Wales,Republic of Ireland,2013,0,0,0
Zambia,Senegal,2013,1,1,2
Syria,Jordan,2013,1,1,2
South Africa,Burkina Faso,2013,2,0,2
Zimbabwe,Zambia,2013,0,0,0
Afghanistan,Pakistan,2013,3,0,3
Zambia,Zimbabwe,2013,0,1,1
Mozambique,Angola,2013,0,0,0
Cameroon,DR Congo,2013,0,1,1
Libya,Mali,2013,1,0,1
Botswana,Uganda,2013,1,3,4
DR Congo,Cameroon,2013,1,1,2
Libya,Ghana,2013,1,0,1
Angola,Mozambique,2013,1,1,2
Nepal,Bangladesh,2013,2,0,2
India,Pakistan,2013,1,0,1
Afghanistan,Bhutan,2013,3,0,3
Maldives,Sri Lanka,2013,10,0,10
Bangladesh,India,2013,1,1,2
Botswana,Malawi,2013,1,0,1
Nepal,Pakistan,2013,1,1,2
Bhutan,Maldives,2013,2,8,10
Equatorial Guinea,Libya,2013,1,1,2
Sri Lanka,Afghanistan,2013,1,3,4
Bangladesh,Pakistan,2013,1,2,3
Nepal,India,2013,2,1,3
Qatar,Mauritius,2013,3,0,3
Saudi Arabia,New Zealand,2013,0,1,1
United Arab Emirates,Trinidad and Tobago,2013,3,3,6
Afghanistan,Maldives,2013,0,0,0
Belarus,Kyrgyzstan,2013,3,1,4
Bosnia and Herzegovina,Slovakia,2013,0,1,1
Myanmar,Hong Kong,2013,0,0,0
Chile,Venezuela,2013,3,0,3
China PR,Singapore,2013,6,1,7
Colombia,Ecuador,2013,1,0,1
Costa Rica,United States,2013,3,1,4
Czech Republic,Armenia,2013,1,2,3
England,Moldova,2013,4,0,4
Estonia,Netherlands,2013,2,2,4
Finland,Spain,2013,0,2,2
Georgia,France,2013,0,0,0
Germany,Austria,2013,3,0,3
Ghana,Zambia,2013,2,1,3
Republic of Ireland,Sweden,2013,1,2,3
Italy,Bulgaria,2013,1,0,1
Japan,Guatemala,2013,3,0,3
Jordan,Uzbekistan,2013,1,1,2
Kazakhstan,Faroe Islands,2013,2,1,3
South Korea,Haiti,2013,4,1,5
Kuwait,North Korea,2013,2,1,3
Latvia,Lithuania,2013,2,1,3
Lebanon,Syria,2013,2,0,2
Liechtenstein,Greece,2013,0,1,1
North Macedonia,Wales,2013,2,1,3
Malta,Denmark,2013,1,2,3
Mexico,Honduras,2013,1,2,3
Northern Ireland,Portugal,2013,2,4,6
Norway,Cyprus,2013,2,0,2
Panama,Jamaica,2013,0,0,0
Paraguay,Bolivia,2013,4,0,4
Peru,Uruguay,2013,1,2,3
Poland,Montenegro,2013,1,1,2
Romania,Hungary,2013,3,0,3
Russia,Luxembourg,2013,4,1,5
Scotland,Belgium,2013,0,2,2
Serbia,Croatia,2013,1,1,2
Slovenia,Albania,2013,1,0,1
Sri Lanka,Bhutan,2013,5,2,7
Switzerland,Iceland,2013,4,4,8
Turkey,Andorra,2013,5,0,5
Ukraine,San Marino,2013,9,0,9
Angola,Liberia,2013,4,1,5
Brazil,Australia,2013,6,0,6
Burkina Faso,Gabon,2013,1,0,1
Central African Republic,Ethiopia,2013,1,2,3
Gambia,Tanzania,2013,2,0,2
Israel,Azerbaijan,2013,1,1,2
Ivory Coast,Morocco,2013,1,1,2
Niger,Congo,2013,2,2,4
Nigeria,Malawi,2013,2,0,2
Senegal,Uganda,2013,1,0,1
Sierra Leone,Equatorial Guinea,2013,3,2,5
South Africa,Botswana,2013,4,1,5
Tunisia,Cape Verde,2013,3,0,3
Benin,Rwanda,2013,2,0,2
Cameroon,Libya,2013,1,0,1
Canada,Mauritania,2013,0,0,0
Kenya,Namibia,2013,1,0,1
Nepal,Afghanistan,2013,0,1,1
Sudan,Lesotho,2013,1,3,4
Togo,DR Congo,2013,2,1,3
Zimbabwe,Mozambique,2013,1,1,2
Kuwait,Bahrain,2013,2,1,3
Maldives,India,2013,0,1,1
Qatar,Lebanon,2013,1,1,2
Saudi Arabia,Trinidad and Tobago,2013,1,3,4
United Arab Emirates,New Zealand,2013,2,0,2
Algeria,Mali,2013,1,0,1
Andorra,Netherlands,2013,0,2,2
Armenia,Denmark,2013,0,1,1
Austria,Republic of Ireland,2013,1,0,1
Belarus,France,2013,2,4,6
Bolivia,Ecuador,2013,1,1,2
Brazil,Portugal,2013,3,1,4
Canada,Mauritania,2013,0,1,1
China PR,Malaysia,2013,2,0,2
Cyprus,Slovenia,2013,0,2,2
Egypt,Guinea,2013,4,2,6
Faroe Islands,Germany,2013,0,3,3
Georgia,Finland,2013,0,1,1
Greece,Latvia,2013,1,0,1
Honduras,Panama,2013,2,2,4
Hong Kong,Singapore,2013,1,0,1
Hungary,Estonia,2013,5,1,6
Iceland,Albania,2013,2,1,3
Italy,Czech Republic,2013,2,1,3
Jamaica,Costa Rica,2013,1,1,2
Japan,Ghana,2013,3,1,4
Kazakhstan,Sweden,2013,0,1,1
South Korea,Croatia,2013,1,2,3
Lithuania,Liechtenstein,2013,2,0,2
Luxembourg,Northern Ireland,2013,3,2,5
North Macedonia,Scotland,2013,1,2,3
Malta,Bulgaria,2013,1,2,3
Nigeria,Burkina Faso,2013,4,1,5
Norway,Switzerland,2013,0,2,2
Paraguay,Argentina,2013,2,5,7
Romania,Turkey,2013,0,2,2
Russia,Israel,2013,3,1,4
San Marino,Poland,2013,1,5,6
Slovakia,Bosnia and Herzegovina,2013,1,2,3
South Africa,Zimbabwe,2013,1,2,3
Spain,Chile,2013,2,2,4
Ukraine,England,2013,0,0,0
Uruguay,Colombia,2013,2,0,2
United States,Mexico,2013,2,0,2
Uzbekistan,Jordan,2013,1,1,2
Venezuela,Peru,2013,3,2,5
Wales,Serbia,2013,0,3,3
Botswana,Burkina Faso,2013,1,0,1
Egypt,Uganda,2013,2,0,2
Iraq,Yemen,2013,3,2,5
Lebanon,Iraq,2013,1,1,2
Jordan,Kuwait,2013,1,1,2
Oman,Mauritania,2013,0,0,0
Qatar,Vietnam,2013,1,2,3
Singapore,Laos,2013,1,0,1
Thailand,Bahrain,2013,1,0,1
Albania,Switzerland,2013,1,2,3
Andorra,Romania,2013,0,4,4
Argentina,Peru,2013,3,1,4
Armenia,Bulgaria,2013,2,1,3
Azerbaijan,Northern Ireland,2013,2,0,2
Bosnia and Herzegovina,Liechtenstein,2013,4,1,5
Colombia,Chile,2013,3,3,6
Croatia,Belgium,2013,1,2,3
Denmark,Italy,2013,2,2,4
Ecuador,Uruguay,2013,1,0,1
England,Montenegro,2013,4,1,5
Estonia,Turkey,2013,0,2,2
Faroe Islands,Kazakhstan,2013,1,1,2
France,Australia,2013,6,0,6
Germany,Republic of Ireland,2013,3,0,3
Greece,Slovakia,2013,1,0,1
Honduras,Costa Rica,2013,1,0,1
Iceland,Cyprus,2013,2,0,2
Lithuania,Latvia,2013,2,0,2
Luxembourg,Russia,2013,0,4,4
Malta,Czech Republic,2013,1,4,5
Mexico,Panama,2013,2,1,3
Moldova,San Marino,2013,3,0,3
Morocco,South Africa,2013,1,1,2
Netherlands,Hungary,2013,8,1,9
Philippines,Taiwan,2013,1,2,3
Portugal,Israel,2013,1,1,2
Serbia,Japan,2013,2,0,2
Slovenia,Norway,2013,3,0,3
Spain,Belarus,2013,2,1,3
Sweden,Austria,2013,2,1,3
Ukraine,Poland,2013,1,0,1
United States,Jamaica,2013,2,0,2
Venezuela,Paraguay,2013,1,1,2
Wales,North Macedonia,2013,1,0,1
Burkina Faso,Algeria,2013,3,2,5
Ivory Coast,Senegal,2013,3,1,4
South Korea,Brazil,2013,0,2,2
Ethiopia,Nigeria,2013,1,2,3
Qatar,Yemen,2013,6,0,6
Tunisia,Cameroon,2013,0,0,0
Australia,Canada,2013,3,0,3
Azerbaijan,Russia,2013,1,1,2
Belarus,Japan,2013,1,0,1
Belgium,Wales,2013,1,1,2
Brazil,Zambia,2013,2,0,2
Bulgaria,Czech Republic,2013,0,1,1
Chile,Ecuador,2013,2,1,3
Costa Rica,Mexico,2013,2,1,3
Cyprus,Albania,2013,0,0,0
Denmark,Malta,2013,6,0,6
England,Poland,2013,2,0,2
Faroe Islands,Austria,2013,0,3,3
France,Finland,2013,3,0,3
Ghana,Egypt,2013,6,1,7
Greece,Liechtenstein,2013,2,0,2
Hong Kong,United Arab Emirates,2013,0,4,4
Hungary,Andorra,2013,2,0,2
Indonesia,China PR,2013,1,1,2
Iran,Thailand,2013,2,1,3
Iraq,Saudi Arabia,2013,0,2,2
Republic of Ireland,Kazakhstan,2013,3,1,4
Israel,Northern Ireland,2013,1,1,2
Italy,Armenia,2013,2,2,4
Jamaica,Honduras,2013,2,2,4
Jordan,Oman,2013,0,0,0
South Korea,Mali,2013,3,1,4
Kyrgyzstan,Tajikistan,2013,1,4,5
Latvia,Slovakia,2013,2,2,4
Lebanon,Kuwait,2013,1,1,2
Lithuania,Bosnia and Herzegovina,2013,0,1,1
Malaysia,Bahrain,2013,1,1,2
Montenegro,Moldova,2013,2,5,7
Norway,Iceland,2013,1,1,2
Panama,United States,2013,2,3,5
Paraguay,Colombia,2013,1,2,3
Peru,Bolivia,2013,1,1,2
Philippines,Pakistan,2013,3,1,4
Portugal,Luxembourg,2013,3,0,3
Romania,Estonia,2013,2,0,2
San Marino,Ukraine,2013,0,8,8
Scotland,Croatia,2013,2,0,2
Serbia,North Macedonia,2013,5,1,6
Singapore,Syria,2013,2,1,3
Spain,Georgia,2013,2,0,2
Sweden,Germany,2013,3,5,8
Switzerland,Slovenia,2013,1,0,1
Trinidad and Tobago,New Zealand,2013,0,0,0
Turkey,Netherlands,2013,0,2,2
Uruguay,Argentina,2013,3,2,5
Uzbekistan,Vietnam,2013,3,1,4
Jordan,Nigeria,2013,1,0,1
Indonesia,Kyrgyzstan,2013,4,0,4
Jordan,Zambia,2013,1,0,1
Kuwait,Malaysia,2013,3,0,3
Bahrain,Lebanon,2013,1,0,1
United Arab Emirates,Philippines,2013,4,0,4
Jordan,Uruguay,2013,0,5,5
Belgium,Colombia,2013,0,2,2
Bonaire,Suriname,2013,0,2,2
Curaçao,Aruba,2013,2,0,2
Egypt,Zambia,2013,2,0,2
Argentina,Ecuador,2013,0,0,0
Bahrain,Malaysia,2013,1,0,1
Belarus,Albania,2013,0,0,0
China PR,Indonesia,2013,1,0,1
Czech Republic,Canada,2013,2,0,2
Denmark,Norway,2013,2,1,3
England,Chile,2013,0,2,2
Estonia,Azerbaijan,2013,2,1,3
Greece,Romania,2013,3,1,4
Iceland,Croatia,2013,0,0,0
India,Philippines,2013,1,1,2
Republic of Ireland,Latvia,2013,3,0,3
Italy,Germany,2013,1,1,2
Jamaica,Trinidad and Tobago,2013,0,1,1
South Korea,Switzerland,2013,2,1,3
Kuwait,Lebanon,2013,0,0,0
Libya,Niger,2013,1,1,2
Poland,Slovakia,2013,0,2,2
Portugal,Sweden,2013,1,0,1
Russia,Serbia,2013,1,1,2
Saudi Arabia,Iraq,2013,2,1,3
Scotland,United States,2013,0,0,0
Eswatini,South Africa,2013,0,3,3
Syria,Singapore,2013,4,0,4
Thailand,Iran,2013,0,3,3
Turkey,Northern Ireland,2013,1,0,1
Ukraine,France,2013,2,0,2
United Arab Emirates,Hong Kong,2013,4,0,4
Vietnam,Uzbekistan,2013,0,3,3
Yemen,Qatar,2013,1,4,5
Aruba,Bonaire,2013,1,2,3
Curaçao,Suriname,2013,1,3,4
Equatorial Guinea,Spain,2013,1,2,3
Honduras,Brazil,2013,0,5,5
Netherlands,Japan,2013,2,2,4
Nigeria,Ethiopia,2013,2,0,2
Senegal,Ivory Coast,2013,1,1,2
Uganda,Rwanda,2013,0,0,0
Wales,Finland,2013,1,1,2
Cameroon,Tunisia,2013,4,1,5
Luxembourg,Montenegro,2013,1,4,5
Argentina,Bosnia and Herzegovina,2013,2,0,2
Italy,Nigeria,2013,2,2,4
Moldova,Lithuania,2013,1,1,2
Algeria,Burkina Faso,2013,1,0,1
Australia,Costa Rica,2013,1,0,1
Austria,United States,2013,1,0,1
Bahrain,Yemen,2013,2,0,2
Belgium,Japan,2013,2,3,5
Brazil,Chile,2013,2,1,3
Cambodia,Guam,2013,0,2,2
China PR,Saudi Arabia,2013,0,0,0
Croatia,Iceland,2013,2,0,2
Egypt,Ghana,2013,2,1,3
England,Germany,2013,0,1,1
France,Ukraine,2013,3,0,3
Gibraltar,Slovakia,2013,0,0,0
Honduras,Ecuador,2013,2,2,4
Hong Kong,Uzbekistan,2013,0,2,2
India,Nepal,2013,2,0,2
Indonesia,Iraq,2013,0,2,2
Kuwait,Thailand,2013,3,1,4
Kyrgyzstan,Azerbaijan,2013,0,0,0
Lebanon,Iran,2013,1,4,5
Liechtenstein,Estonia,2013,0,3,3
Malaysia,Qatar,2013,0,1,1
Malta,Faroe Islands,2013,3,2,5
Namibia,Mozambique,2013,0,0,0
Netherlands,Colombia,2013,0,0,0
Norway,Scotland,2013,0,1,1
Poland,Republic of Ireland,2013,0,0,0
Romania,Greece,2013,1,1,2
Russia,South Korea,2013,2,1,3
Slovenia,Canada,2013,1,0,1
South Africa,Spain,2013,1,0,1
Sweden,Portugal,2013,2,3,5
Syria,Oman,2013,0,1,1
Tanzania,Zimbabwe,2013,0,0,0
Trinidad and Tobago,Jamaica,2013,2,0,2
Turkey,Belarus,2013,2,1,3
United Arab Emirates,Vietnam,2013,5,0,5
New Zealand,Mexico,2013,2,4,6
Uruguay,Jordan,2013,0,0,0
Singapore,Cambodia,2013,1,0,1
Kenya,Ethiopia,2013,0,0,0
Seychelles,Maldives,2013,3,1,4
Zanzibar,South Sudan,2013,2,1,3
Burundi,Somalia,2013,2,0,2
Tanzania,Zambia,2013,1,1,2
Seychelles,Maldives,2013,2,1,3
Sudan,Eritrea,2013,3,0,3
Uganda,Rwanda,2013,1,0,1
Dominica,Saint Lucia,2013,0,1,1
Ethiopia,Zanzibar,2013,3,1,4
Kenya,South Sudan,2013,3,1,4
Dominica,Saint Lucia,2013,1,0,1
Somalia,Tanzania,2013,0,1,1
Zambia,Burundi,2013,1,0,1
Eritrea,Uganda,2013,0,3,3
Sudan,Rwanda,2013,1,0,1
Kenya,Zanzibar,2013,2,0,2
South Sudan,Ethiopia,2013,0,2,2
Somalia,Zambia,2013,0,4,4
Tanzania,Burundi,2013,1,0,1
Rwanda,Eritrea,2013,1,0,1
Uganda,Sudan,2013,1,0,1
Kenya,Rwanda,2013,1,0,1
Uganda,Tanzania,2013,2,2,4
Ethiopia,Sudan,2013,0,2,2
Zambia,Burundi,2013,4,3,7
Kenya,Tanzania,2013,1,0,1
Zambia,Sudan,2013,1,2,3
Kenya,Sudan,2013,2,0,2
Tanzania,Zambia,2013,1,1,2
Libya,Mali,2013,1,0,1
Qatar,Bahrain,2013,1,1,2
Oman,Bahrain,2013,0,0,0
Qatar,Palestine,2013,1,0,1
Jordan,Lebanon,2013,0,0,0
Bahrain,Iraq,2013,0,0,0
Palestine,Saudi Arabia,2013,0,0,0
Basque Country,Peru,2013,6,0,6
Lebanon,Kuwait,2013,0,2,2
Catalonia,Cape Verde,2013,4,1,5
Iraq,Oman,2013,0,0,0
Qatar,Saudi Arabia,2013,4,1,5
Kuwait,Jordan,2014,1,2,3
Bahrain,Jordan,2014,0,1,1
Namibia,Ghana,2014,0,1,1
Nigeria,Ethiopia,2014,2,1,3
Qatar,Kuwait,2014,3,0,3
Bahrain,Kuwait,2014,0,0,0
Qatar,Jordan,2014,2,0,2
Zimbabwe,Gabon,2014,2,0,2
Mali,Nigeria,2014,2,1,3
South Africa,Mozambique,2014,3,1,4
Uganda,Burkina Faso,2014,2,1,3
Zimbabwe,Morocco,2014,0,0,0
Ghana,Congo,2014,1,0,1
Libya,Ethiopia,2014,2,0,2
DR Congo,Mauritania,2014,1,0,1
Gabon,Burundi,2014,0,0,0
Moldova,Norway,2014,1,2,3
Nigeria,Mozambique,2014,4,2,6
South Africa,Mali,2014,1,1,2
Burkina Faso,Morocco,2014,1,1,2
Zimbabwe,Uganda,2014,0,0,0
Ethiopia,Congo,2014,0,1,1
Ghana,Libya,2014,1,1,2
Moldova,Sweden,2014,1,2,3
Burundi,Mauritania,2014,3,2,5
DR Congo,Gabon,2014,0,1,1
Norway,Poland,2014,0,3,3
Mozambique,Mali,2014,1,2,3
South Africa,Nigeria,2014,1,3,4
Burkina Faso,Zimbabwe,2014,0,1,1
Moldova,Poland,2014,0,1,1
Morocco,Uganda,2014,3,1,4
Congo,Libya,2014,2,2,4
Ethiopia,Ghana,2014,0,1,1
Iceland,Sweden,2014,0,2,2
Burundi,DR Congo,2014,1,2,3
Chile,Costa Rica,2014,4,0,4
Mauritania,Gabon,2014,2,4,6
Oman,Finland,2014,0,0,0
Costa Rica,South Korea,2014,0,1,1
Mali,Zimbabwe,2014,1,2,3
Morocco,Nigeria,2014,3,4,7
Gabon,Libya,2014,1,1,2
Ghana,DR Congo,2014,1,0,1
Mexico,South Korea,2014,4,0,4
Nigeria,Ghana,2014,0,0,0
Zimbabwe,Libya,2014,0,0,0
Oman,Jordan,2014,0,0,0
Libya,Ghana,2014,0,0,0
United States,South Korea,2014,2,0,2
Zimbabwe,Nigeria,2014,0,1,1
Singapore,Jordan,2014,1,3,4
Lebanon,Pakistan,2014,3,1,4
Iraq,North Korea,2014,2,0,2
Gibraltar,Faroe Islands,2014,1,4,5
Malaysia,Philippines,2014,0,0,0
Iran,Kuwait,2014,3,2,5
Albania,Malta,2014,2,0,2
Algeria,Slovenia,2014,2,0,2
Andorra,Moldova,2014,0,3,3
Australia,Ecuador,2014,3,4,7
Austria,Uruguay,2014,1,1,2
Belgium,Ivory Coast,2014,2,2,4
Bosnia and Herzegovina,Egypt,2014,0,2,2
Botswana,South Sudan,2014,3,0,3
Bulgaria,Belarus,2014,2,1,3
Burkina Faso,Comoros,2014,1,1,2
Burundi,Rwanda,2014,1,1,2
Colombia,Tunisia,2014,1,1,2
Cyprus,Northern Ireland,2014,0,0,0
Czech Republic,Norway,2014,2,2,4
England,Denmark,2014,1,0,1
France,Netherlands,2014,2,0,2
Georgia,Liechtenstein,2014,2,0,2
Germany,Chile,2014,1,0,1
Gibraltar,Estonia,2014,0,2,2
Greece,South Korea,2014,0,2,2
Hungary,Finland,2014,1,2,3
India,Bangladesh,2014,2,2,4
Iran,Guinea,2014,1,2,3
Iraq,China PR,2014,3,1,4
Republic of Ireland,Serbia,2014,1,2,3
Israel,Slovakia,2014,1,3,4
Japan,New Zealand,2014,4,2,6
Jordan,Syria,2014,2,1,3
Kazakhstan,Lithuania,2014,1,1,2
Kosovo,Haiti,2014,0,0,0
Luxembourg,Cape Verde,2014,0,0,0
North Macedonia,Latvia,2014,2,1,3
Malawi,Zimbabwe,2014,1,4,5
Mali,Senegal,2014,1,1,2
Mauritania,Niger,2014,1,1,2
Montenegro,Ghana,2014,1,0,1
Morocco,Gabon,2014,1,1,2
Mozambique,Angola,2014,1,1,2
Namibia,Tanzania,2014,1,1,2
Oman,Singapore,2014,3,1,4
Philippines,Azerbaijan,2014,0,1,1
Poland,Scotland,2014,0,1,1
Portugal,Cameroon,2014,5,1,6
Qatar,Bahrain,2014,0,0,0
Romania,Argentina,2014,0,0,0
Russia,Armenia,2014,2,0,2
Saudi Arabia,Indonesia,2014,1,0,1
South Africa,Brazil,2014,0,5,5
Spain,Italy,2014,1,0,1
Saint Lucia,Jamaica,2014,0,5,5
Switzerland,Croatia,2014,2,2,4
Thailand,Lebanon,2014,2,5,7
Turkey,Sweden,2014,2,1,3
Ukraine,United States,2014,2,0,2
Uzbekistan,United Arab Emirates,2014,1,1,2
Vietnam,Hong Kong,2014,3,1,4
Wales,Iceland,2014,3,1,4
Yemen,Malaysia,2014,1,2,3
Zambia,Uganda,2014,2,1,3
Lesotho,Eswatini,2014,0,1,1
Lesotho,Eswatini,2014,0,0,0
Saint Lucia,Martinique,2014,0,0,0
Yemen,Nepal,2014,2,0,2
Andorra,Indonesia,2014,0,1,1
Aruba,Guam,2014,2,2,4
Cuba,Indonesia,2014,1,0,1
Aruba,Guam,2014,2,0,2
Mauritania,Mauritius,2014,1,0,1
Afghanistan,Kyrgyzstan,2014,0,0,0
Yemen,Chad,2014,0,0,0
Guadeloupe,French Guiana,2014,3,2,5
Mauritius,Mauritania,2014,0,2,2
Tanzania,Burundi,2014,0,3,3
Philippines,Malaysia,2014,0,0,0
Grenada,Saint Lucia,2014,0,1,1
Dominica,Grenada,2014,3,5,8
Vatican City,Monaco,2014,0,2,2
Afghanistan,Kyrgyzstan,2014,1,0,1
Germany,Poland,2014,0,0,0
Kuwait,Afghanistan,2014,3,2,5
Kuwait,Kyrgyzstan,2014,2,2,4
Malawi,Chad,2014,2,0,2
Mauritania,Equatorial Guinea,2014,1,0,1
Namibia,Congo,2014,1,0,1
Netherlands,Ecuador,2014,1,1,2
São Tomé and Príncipe,Benin,2014,0,2,2
Belarus,Iran,2014,0,0,0
Burundi,Botswana,2014,0,0,0
Central African Republic,Guinea-Bissau,2014,0,0,0
Liberia,Lesotho,2014,1,0,1
Libya,Rwanda,2014,0,0,0
Tanzania,Zimbabwe,2014,1,0,1
Maldives,Myanmar,2014,2,3,5
Palestine,Kyrgyzstan,2014,1,0,1
French Guiana,Suriname,2014,0,0,0
Philippines,Afghanistan,2014,0,0,0
Turkmenistan,Laos,2014,5,1,6
Burkina Faso,Senegal,2014,1,1,2
Myanmar,Palestine,2014,0,2,2
Finland,Czech Republic,2014,2,2,4
Kosovo,Turkey,2014,1,6,7
Liechtenstein,Belarus,2014,1,5,6
Maldives,Kyrgyzstan,2014,2,0,2
Afghanistan,Turkmenistan,2014,3,1,4
Hungary,Denmark,2014,2,2,4
Laos,Philippines,2014,0,2,2
Ukraine,Niger,2014,2,1,3
Bulgaria,Canada,2014,1,1,2
Kyrgyzstan,Myanmar,2014,1,0,1
Maldives,Palestine,2014,0,0,0
Slovakia,Montenegro,2014,2,0,2
Afghanistan,Laos,2014,0,0,0
Moldova,Saudi Arabia,2014,4,0,4
Turkmenistan,Philippines,2014,0,2,2
Republic of Ireland,Turkey,2014,1,2,3
Kosovo,Senegal,2014,1,3,4
Mali,Guinea,2014,1,2,3
Thailand,Kuwait,2014,1,1,2
Australia,South Africa,2014,1,1,2
Belgium,Luxembourg,2014,5,1,6
Estonia,Gibraltar,2014,1,1,2
Jamaica,Serbia,2014,1,2,3
North Macedonia,Cameroon,2014,0,2,2
Montenegro,Iran,2014,0,0,0
Russia,Slovakia,2014,1,0,1
Armenia,United Arab Emirates,2014,4,3,7
France,Norway,2014,4,0,4
Japan,Cyprus,2014,1,0,1
Maldives,Philippines,2014,2,3,5
Moldova,Canada,2014,1,1,2
Palestine,Afghanistan,2014,2,0,2
Suriname,French Guiana,2014,1,0,1
Tanzania,Malawi,2014,1,0,1
Uzbekistan,Oman,2014,0,1,1
Angola,Morocco,2014,2,0,2
Denmark,Sweden,2014,1,0,1
South Korea,Tunisia,2014,0,1,1
Nigeria,Scotland,2014,2,2,4
Cameroon,Paraguay,2014,1,2,3
Finland,Lithuania,2014,0,1,1
Georgia,Saudi Arabia,2014,2,0,2
Latvia,Estonia,2014,0,0,0
Maldives,Afghanistan,2014,1,1,2
Uzbekistan,Oman,2014,0,1,1
Angola,Iran,2014,1,1,2
Aruba,Turks and Caicos Islands,2014,1,0,1
Austria,Iceland,2014,1,1,2
Bosnia and Herzegovina,Ivory Coast,2014,2,1,3
Comoros,Kenya,2014,1,1,2
England,Peru,2014,3,0,3
French Guiana,British Virgin Islands,2014,6,0,6
North Macedonia,Qatar,2014,0,0,0
Montserrat,United States Virgin Islands,2014,1,0,1
New Zealand,South Africa,2014,0,0,0
Palestine,Philippines,2014,1,0,1
South Sudan,Mozambique,2014,0,0,0
Spain,Bolivia,2014,2,0,2
Switzerland,Jamaica,2014,1,0,1
Uruguay,Northern Ireland,2014,1,0,1
Albania,Romania,2014,0,1,1
Armenia,Algeria,2014,1,3,4
Chad,Malawi,2014,3,1,4
Colombia,Senegal,2014,2,2,4
Croatia,Mali,2014,2,1,3
Finland,Estonia,2014,2,0,2
Guinea-Bissau,Central African Republic,2014,3,1,4
Italy,Republic of Ireland,2014,0,0,0
Latvia,Lithuania,2014,1,0,1
Mexico,Ecuador,2014,3,1,4
Netherlands,Ghana,2014,1,0,1
Norway,Russia,2014,1,1,2
Portugal,Greece,2014,0,0,0
Rwanda,Libya,2014,3,0,3
Sierra Leone,Eswatini,2014,1,0,1
Uganda,Madagascar,2014,1,0,1
Aruba,British Virgin Islands,2014,7,0,7
Benin,São Tomé and Príncipe,2014,2,0,2
Botswana,Burundi,2014,1,0,1
Congo,Namibia,2014,3,0,3
Equatorial Guinea,Mauritania,2014,3,0,3
France,Paraguay,2014,1,1,2
Germany,Cameroon,2014,2,2,4
Honduras,Israel,2014,2,4,6
Lesotho,Liberia,2014,2,0,2
Sweden,Belgium,2014,0,2,2
Turks and Caicos Islands,French Guiana,2014,0,6,6
United States,Turkey,2014,2,1,3
United States Virgin Islands,Bonaire,2014,1,2,3
Zimbabwe,Tanzania,2014,2,2,4
Iraqi Kurdistan,Arameans Suryoye,2014,1,2,3
Abkhazia,Occitania,2014,1,1,2
Darfur,Padania,2014,0,20,20
Ellan Vannin,Artsakh,2014,3,2,5
Costa Rica,Japan,2014,1,3,4
Tamil Eelam,Arameans Suryoye,2014,0,2,2
Sápmi,Abkhazia,2014,1,2,3
Darfur,South Ossetia,2014,0,19,19
Ellan Vannin,County of Nice,2014,4,2,6
Aruba,French Guiana,2014,0,2,2
Brazil,Panama,2014,4,0,4
British Virgin Islands,Turks and Caicos Islands,2014,0,2,2
Czech Republic,Austria,2014,1,2,3
Georgia,United Arab Emirates,2014,0,1,1
Greece,Nigeria,2014,0,0,0
Mexico,Bosnia and Herzegovina,2014,0,1,1
Switzerland,Peru,2014,2,0,2
Tamil Eelam,Iraqi Kurdistan,2014,0,9,9
Sápmi,Occitania,2014,0,1,1
South Ossetia,Padania,2014,1,3,4
Artsakh,County of Nice,2014,0,1,1
Argentina,Trinidad and Tobago,2014,3,0,3
Ecuador,England,2014,2,2,4
El Salvador,Ivory Coast,2014,1,2,3
Gibraltar,Malta,2014,1,0,1
Hungary,Albania,2014,1,0,1
Iceland,Estonia,2014,1,0,1
Italy,Luxembourg,2014,1,1,2
Jamaica,Egypt,2014,2,2,4
Netherlands,Wales,2014,2,0,2
Romania,Algeria,2014,1,2,3
Padania,County of Nice,2014,1,2,3
Abkhazia,South Ossetia,2014,0,0,0
Arameans Suryoye,Occitania,2014,0,0,0
Ellan Vannin,Iraqi Kurdistan,2014,1,1,2
Sápmi,Tamil Eelam,2014,4,2,6
Darfur,Artsakh,2014,0,12,12
Padania,Abkhazia,2014,3,3,6
Occitania,Iraqi Kurdistan,2014,2,2,4
Bolivia,Greece,2014,1,2,3
Brazil,Serbia,2014,1,0,1
Colombia,Jordan,2014,3,0,3
Costa Rica,Republic of Ireland,2014,1,1,2
Croatia,Australia,2014,1,0,1
Germany,Armenia,2014,6,1,7
Japan,Zambia,2014,4,3,7
Mexico,Portugal,2014,0,1,1
Poland,Lithuania,2014,2,1,3
Russia,Morocco,2014,2,0,2
County of Nice,South Ossetia,2014,3,0,3
Arameans Suryoye,Ellan Vannin,2014,1,4,5
Argentina,Slovenia,2014,2,0,2
Belgium,Tunisia,2014,1,0,1
Cameroon,Moldova,2014,1,0,1
El Salvador,Spain,2014,0,2,2
Estonia,Tajikistan,2014,2,1,3
Honduras,England,2014,0,0,0
Hungary,Kazakhstan,2014,3,0,3
United States,Nigeria,2014,2,1,3
Sápmi,Artsakh,2014,1,5,6
Tamil Eelam,Darfur,2014,10,0,10
Abkhazia,Occitania,2014,0,1,1
Padania,Iraqi Kurdistan,2014,1,1,2
France,Jamaica,2014,8,0,8
Iran,Trinidad and Tobago,2014,2,0,2
San Marino,Albania,2014,0,3,3
South Ossetia,Arameans Suryoye,2014,1,4,5
County of Nice,Ellan Vannin,2014,0,0,0
Ghana,South Korea,2014,4,0,4
Republic of Ireland,Portugal,2014,1,5,6
Brazil,Croatia,2014,3,1,4
Chile,Australia,2014,3,1,4
Mexico,Cameroon,2014,1,0,1
Spain,Netherlands,2014,1,5,6
Colombia,Greece,2014,3,0,3
England,Italy,2014,1,2,3
Ivory Coast,Japan,2014,2,1,3
Uruguay,Costa Rica,2014,1,3,4
Argentina,Bosnia and Herzegovina,2014,2,1,3
France,Honduras,2014,3,0,3
Switzerland,Ecuador,2014,2,1,3
Germany,Portugal,2014,4,0,4
Ghana,United States,2014,1,2,3
Iran,Nigeria,2014,0,0,0
Belgium,Algeria,2014,2,1,3
Brazil,Mexico,2014,0,0,0
Russia,South Korea,2014,1,1,2
Australia,Netherlands,2014,2,3,5
Cameroon,Croatia,2014,0,4,4
China PR,North Macedonia,2014,2,0,2
Spain,Chile,2014,0,2,2
Colombia,Ivory Coast,2014,2,1,3
Japan,Greece,2014,0,0,0
Uruguay,England,2014,2,1,3
Honduras,Ecuador,2014,1,2,3
Italy,Costa Rica,2014,0,1,1
Switzerland,France,2014,2,5,7
Argentina,Iran,2014,1,0,1
Germany,Ghana,2014,2,2,4
Indonesia,Pakistan,2014,4,0,4
Nigeria,Bosnia and Herzegovina,2014,1,0,1
Belgium,Russia,2014,1,0,1
China PR,North Macedonia,2014,0,0,0
South Korea,Algeria,2014,2,4,6
United States,Portugal,2014,2,2,4
Australia,Spain,2014,0,3,3
Brazil,Cameroon,2014,4,1,5
Croatia,Mexico,2014,1,3,4
Netherlands,Chile,2014,2,0,2
Costa Rica,England,2014,0,0,0
Greece,Ivory Coast,2014,2,1,3
Italy,Uruguay,2014,0,1,1
Japan,Colombia,2014,1,4,5
Bosnia and Herzegovina,Iran,2014,3,1,4
Ecuador,France,2014,0,0,0
Honduras,Switzerland,2014,0,3,3
Indonesia,Nepal,2014,2,0,2
Nigeria,Argentina,2014,2,3,5
Algeria,Russia,2014,1,1,2
South Korea,Belgium,2014,0,1,1
Portugal,Ghana,2014,2,1,3
United States,Germany,2014,0,1,1
Brazil,Chile,2014,1,1,2
Colombia,Uruguay,2014,2,0,2
China PR,Mali,2014,1,3,4
Costa Rica,Greece,2014,1,1,2
Netherlands,Mexico,2014,2,1,3
France,Nigeria,2014,2,0,2
Germany,Algeria,2014,2,1,3
Argentina,Switzerland,2014,1,0,1
Belgium,United States,2014,2,1,3
Vietnam,Myanmar,2014,6,0,6
Brazil,Colombia,2014,2,1,3
France,Germany,2014,0,1,1
Argentina,Belgium,2014,1,0,1
Netherlands,Costa Rica,2014,0,0,0
Malawi,Mozambique,2014,1,1,2
Brazil,Germany,2014,1,7,8
Netherlands,Argentina,2014,0,0,0
Uganda,Seychelles,2014,1,0,1
Brazil,Netherlands,2014,0,3,3
Rwanda,Gabon,2014,1,0,1
Germany,Argentina,2014,1,0,1
Botswana,Lesotho,2014,2,0,2
Qatar,Indonesia,2014,2,2,4
Kenya,Burundi,2014,0,0,0
Uganda,Malawi,2014,0,0,0
Botswana,Guinea-Bissau,2014,2,0,2
Sierra Leone,Seychelles,2014,2,0,2
Uganda,Mauritania,2014,2,0,2
Benin,Malawi,2014,1,0,1
Congo,Rwanda,2014,2,0,2
Lesotho,Kenya,2014,1,0,1
Tanzania,Mozambique,2014,2,2,4
Guam,Macau,2014,0,0,0
Mongolia,Northern Mariana Islands,2014,4,0,4
Guam,Mongolia,2014,2,0,2
Northern Mariana Islands,Macau,2014,2,1,3
Guam,Northern Mariana Islands,2014,5,0,5
Macau,Mongolia,2014,3,2,5
Gabon,Rwanda,2014,0,1,1
Guinea-Bissau,Botswana,2014,1,1,2
Malawi,Benin,2014,1,0,1
Rwanda,Congo,2014,2,0,2
Kenya,Lesotho,2014,0,0,0
Mauritania,Uganda,2014,0,1,1
Mozambique,Tanzania,2014,2,1,3
Tajikistan,Malaysia,2014,4,1,5
Kazakhstan,Tajikistan,2014,2,1,3
Angola,Botswana,2014,0,0,0
Guatemala,Nicaragua,2014,3,0,3
British Virgin Islands,Saint Martin,2014,2,4,6
Azerbaijan,Uzbekistan,2014,0,0,0
Panama,Cuba,2014,4,0,4
Guatemala,Cuba,2014,1,0,1
French Guiana,Suriname,2014,0,1,1
Seychelles,Sri Lanka,2014,1,2,3
Saint Lucia,Martinique,2014,0,2,2
Norway,United Arab Emirates,2014,0,0,0
Seychelles,Sri Lanka,2014,3,0,3
Saint Lucia,Martinique,2014,0,1,1
Egypt,Kenya,2014,1,0,1
El Salvador,Dominican Republic,2014,2,0,2
Zambia,Sudan,2014,3,1,4
Niger,Uganda,2014,2,0,2
Myanmar,Palestine,2014,4,1,5
Costa Rica,Nicaragua,2014,3,0,3
Czech Republic,United States,2014,0,1,1
Denmark,Turkey,2014,1,2,3
England,Norway,2014,1,0,1
Germany,Argentina,2014,2,4,6
Grenada,French Guiana,2014,1,1,2
Guyana,Dominica,2014,0,0,0
Republic of Ireland,Oman,2014,2,0,2
Latvia,Armenia,2014,2,0,2
Lithuania,United Arab Emirates,2014,1,1,2
Morocco,Qatar,2014,0,0,0
Philippines,Taiwan,2014,5,1,6
Puerto Rico,Curaçao,2014,2,2,4
Russia,Azerbaijan,2014,4,0,4
Ukraine,Moldova,2014,1,0,1
Belarus,Tajikistan,2014,6,1,7
Belgium,Australia,2014,2,0,2
Bosnia and Herzegovina,Liechtenstein,2014,3,0,3
China PR,Kuwait,2014,3,1,4
Croatia,Cyprus,2014,2,0,2
France,Spain,2014,1,0,1
Iraq,Peru,2014,0,2,2
Italy,Netherlands,2014,2,0,2
Slovakia,Malta,2014,1,0,1
Sweden,Estonia,2014,2,0,2
Uzbekistan,Jordan,2014,2,0,2
Curaçao,Grenada,2014,2,1,3
Guinea,Togo,2014,2,1,3
Japan,Uruguay,2014,0,2,2
Kazakhstan,Kyrgyzstan,2014,7,1,8
South Korea,Venezuela,2014,3,1,4
Puerto Rico,French Guiana,2014,1,2,3
Senegal,Egypt,2014,2,0,2
Saint Kitts and Nevis,Dominica,2014,5,0,5
Saint Lucia,Guyana,2014,2,0,2
Saint Vincent and the Grenadines,Anguilla,2014,4,0,4
Sudan,South Africa,2014,0,3,3
Suriname,Bonaire,2014,2,3,5
Burkina Faso,Lesotho,2014,2,0,2
DR Congo,Cameroon,2014,0,2,2
Ethiopia,Algeria,2014,1,2,3
Gabon,Angola,2014,1,0,1
Ghana,Uganda,2014,1,1,2
Ivory Coast,Sierra Leone,2014,2,1,3
Mexico,Chile,2014,0,0,0
Niger,Cape Verde,2014,1,3,4
Nigeria,Congo,2014,2,3,5
Palestine,Taiwan,2014,7,3,10
Philippines,Myanmar,2014,2,3,5
Singapore,Papua New Guinea,2014,2,1,3
Tunisia,Botswana,2014,2,1,3
Vietnam,Hong Kong,2014,3,1,4
Zambia,Mozambique,2014,0,0,0
Bonaire,Barbados,2014,1,4,5
Burundi,Tanzania,2014,2,0,2
Costa Rica,Panama,2014,2,2,4
Denmark,Armenia,2014,2,1,3
Dominica,Saint Lucia,2014,1,2,3
Faroe Islands,Finland,2014,1,3,4
French Guiana,Curaçao,2014,0,0,0
Georgia,Republic of Ireland,2014,1,2,3
Germany,Scotland,2014,2,1,3
Gibraltar,Poland,2014,0,7,7
Greece,Romania,2014,0,1,1
Hungary,Northern Ireland,2014,1,2,3
Kosovo,Oman,2014,1,0,1
Mali,Malawi,2014,2,0,2
Morocco,Libya,2014,3,0,3
Paraguay,United Arab Emirates,2014,0,0,0
Portugal,Albania,2014,0,1,1
Puerto Rico,Grenada,2014,2,2,4
Serbia,France,2014,1,1,2
Australia,Saudi Arabia,2014,3,2,5
Austria,Sweden,2014,1,1,2
Estonia,Slovenia,2014,1,0,1
South Korea,Uruguay,2014,0,1,1
Luxembourg,Belarus,2014,1,1,2
Montenegro,Moldova,2014,2,0,2
Russia,Liechtenstein,2014,4,0,4
San Marino,Lithuania,2014,0,2,2
Spain,North Macedonia,2014,5,1,6
Switzerland,England,2014,0,2,2
Ukraine,Slovakia,2014,0,1,1
Uzbekistan,New Zealand,2014,3,1,4
Andorra,Wales,2014,1,2,3
Azerbaijan,Bulgaria,2014,1,2,3
Bosnia and Herzegovina,Cyprus,2014,1,2,3
China PR,Jordan,2014,1,1,2
Croatia,Malta,2014,2,0,2
Czech Republic,Netherlands,2014,2,1,3
Haiti,Chile,2014,0,1,1
Iceland,Turkey,2014,3,0,3
Indonesia,Yemen,2014,0,0,0
Japan,Venezuela,2014,2,2,4
Kazakhstan,Latvia,2014,0,0,0
Kuwait,Bahrain,2014,0,1,1
Mexico,Bolivia,2014,1,0,1
Norway,Italy,2014,0,2,2
Qatar,Peru,2014,0,2,2
Singapore,Hong Kong,2014,0,0,0
Algeria,Mali,2014,1,0,1
Angola,Burkina Faso,2014,0,3,3
Botswana,Senegal,2014,0,2,2
Cameroon,Ivory Coast,2014,4,1,5
Cape Verde,Zambia,2014,2,1,3
Congo,Sudan,2014,2,0,2
DR Congo,Sierra Leone,2014,2,0,2
Egypt,Tunisia,2014,0,1,1
Lesotho,Gabon,2014,1,1,2
Malawi,Ethiopia,2014,3,2,5
Mozambique,Niger,2014,1,1,2
South Africa,Nigeria,2014,0,0,0
Togo,Ghana,2014,2,3,5
Uganda,Guinea,2014,2,0,2
Indonesia,Malaysia,2014,2,0,2
Malaysia,Cambodia,2014,4,1,5
Indonesia,Cambodia,2014,1,0,1
Botswana,Zimbabwe,2014,1,0,1
India,Palestine,2014,2,3,5
Qatar,Uzbekistan,2014,3,0,3
Antigua and Barbuda,Saint Lucia,2014,2,1,3
Curaçao,Martinique,2014,1,1,2
Haiti,French Guiana,2014,2,2,4
Saint Kitts and Nevis,Barbados,2014,2,3,5
Trinidad and Tobago,Dominican Republic,2014,6,1,7
Belarus,Ukraine,2014,0,2,2
England,San Marino,2014,5,0,5
Liechtenstein,Montenegro,2014,0,0,0
Lithuania,Estonia,2014,1,0,1
North Macedonia,Luxembourg,2014,3,2,5
Moldova,Austria,2014,1,2,3
Morocco,Central African Republic,2014,4,0,4
Qatar,Lebanon,2014,5,0,5
Slovakia,Spain,2014,2,1,3
Slovenia,Switzerland,2014,1,0,1
Sweden,Russia,2014,1,1,2
Belgium,Andorra,2014,6,0,6
Botswana,Egypt,2014,0,2,2
Bulgaria,Croatia,2014,0,1,1
China PR,Thailand,2014,3,0,3
Cyprus,Israel,2014,1,2,3
French Guiana,Saint Kitts and Nevis,2014,1,2,3
Hong Kong,Singapore,2014,2,1,3
Italy,Azerbaijan,2014,2,1,3
Japan,Jamaica,2014,1,0,1
Jordan,Kuwait,2014,0,1,1
South Korea,Paraguay,2014,2,0,2
Latvia,Iceland,2014,0,3,3
Lesotho,Angola,2014,0,0,0
Malta,Norway,2014,0,3,3
Netherlands,Kazakhstan,2014,3,1,4
Oman,Costa Rica,2014,3,4,7
Saudi Arabia,Uruguay,2014,1,1,2
Senegal,Tunisia,2014,0,0,0
Saint Vincent and the Grenadines,Curaçao,2014,1,0,1
Trinidad and Tobago,Saint Lucia,2014,2,0,2
Turkey,Czech Republic,2014,1,2,3
United Arab Emirates,Australia,2014,0,0,0
Uzbekistan,Bahrain,2014,0,0,0
Wales,Bosnia and Herzegovina,2014,0,0,0
Yemen,Iraq,2014,1,1,2
Albania,Denmark,2014,1,1,2
Argentina,Brazil,2014,0,2,2
Armenia,Serbia,2014,1,1,2
Cameroon,Sierra Leone,2014,0,0,0
Congo,South Africa,2014,0,2,2
DR Congo,Ivory Coast,2014,1,2,3
Ethiopia,Mali,2014,0,2,2
Finland,Greece,2014,1,1,2
France,Portugal,2014,2,1,3
Gabon,Burkina Faso,2014,2,0,2
Guinea,Ghana,2014,1,1,2
Republic of Ireland,Gibraltar,2014,7,0,7
Malawi,Algeria,2014,0,2,2
Mozambique,Cape Verde,2014,2,0,2
Niger,Zambia,2014,0,0,0
Northern Ireland,Faroe Islands,2014,2,0,2
Poland,Germany,2014,2,0,2
Romania,Hungary,2014,1,1,2
Scotland,Georgia,2014,1,0,1
Sudan,Nigeria,2014,1,0,1
Uganda,Togo,2014,0,1,1
Austria,Montenegro,2014,1,0,1
Barbados,French Guiana,2014,0,2,2
Belarus,Slovakia,2014,1,3,4
Timor-Leste,Brunei,2014,4,2,6
Estonia,England,2014,0,1,1
Guadeloupe,Curaçao,2014,0,1,1
Haiti,Saint Kitts and Nevis,2014,0,0,0
Laos,Cambodia,2014,3,2,5
Lithuania,Slovenia,2014,0,2,2
Luxembourg,Spain,2014,0,4,4
Mexico,Panama,2014,1,0,1
Pakistan,Palestine,2014,0,2,2
Philippines,Papua New Guinea,2014,5,0,5
Russia,Moldova,2014,1,1,2
Saint Lucia,Dominican Republic,2014,2,3,5
Sweden,Liechtenstein,2014,2,0,2
Tanzania,Benin,2014,4,1,5
Trinidad and Tobago,Antigua and Barbuda,2014,1,0,1
Ukraine,North Macedonia,2014,1,0,1
Andorra,Israel,2014,1,4,5
Bosnia and Herzegovina,Belgium,2014,1,1,2
Croatia,Azerbaijan,2014,6,0,6
Iceland,Netherlands,2014,2,0,2
Jordan,Kuwait,2014,1,1,2
Kazakhstan,Czech Republic,2014,2,4,6
Latvia,Turkey,2014,1,1,2
Malta,Italy,2014,0,1,1
Morocco,Kenya,2014,3,0,3
Norway,Bulgaria,2014,2,1,3
Oman,Uruguay,2014,0,3,3
Wales,Cyprus,2014,2,1,3
Armenia,France,2014,0,3,3
Bahrain,Iraq,2014,0,0,0
Myanmar,Timor-Leste,2014,0,0,0
China PR,Paraguay,2014,2,1,3
Denmark,Portugal,2014,0,1,1
Faroe Islands,Hungary,2014,0,1,1
Finland,Romania,2014,0,2,2
Germany,Republic of Ireland,2014,1,1,2
Gibraltar,Georgia,2014,0,3,3
Greece,Northern Ireland,2014,0,2,2
Hong Kong,Argentina,2014,0,7,7
Japan,Brazil,2014,0,4,4
South Korea,Costa Rica,2014,1,3,4
Laos,Brunei,2014,4,2,6
Macau,Singapore,2014,2,2,4
Poland,Scotland,2014,2,2,4
Qatar,Australia,2014,1,0,1
San Marino,Switzerland,2014,0,4,4
Saudi Arabia,Lebanon,2014,1,1,2
Serbia,Albania,2014,0,3,3
United Arab Emirates,Uzbekistan,2014,0,4,4
United States,Honduras,2014,1,1,2
Algeria,Malawi,2014,3,0,3
Angola,Lesotho,2014,4,0,4
Burkina Faso,Gabon,2014,1,1,2
Cameroon,Sierra Leone,2014,2,0,2
Cape Verde,Mozambique,2014,1,0,1
Egypt,Botswana,2014,2,0,2
Ghana,Guinea,2014,3,1,4
Ivory Coast,DR Congo,2014,3,4,7
Mali,Ethiopia,2014,2,3,5
Nigeria,Sudan,2014,3,1,4
South Africa,Congo,2014,0,0,0
Eswatini,Zimbabwe,2014,0,2,2
Togo,Uganda,2014,1,0,1
Tunisia,Senegal,2014,1,0,1
Zambia,Niger,2014,3,0,3
Brunei,Myanmar,2014,1,3,4
Timor-Leste,Cambodia,2014,2,3,5
Cambodia,Myanmar,2014,0,1,1
Laos,Timor-Leste,2014,2,0,2
Cambodia,Brunei,2014,1,0,1
Laos,Myanmar,2014,1,2,3
Bangladesh,Sri Lanka,2014,1,1,2
Zambia,Ivory Coast,2014,1,1,2
Bangladesh,Sri Lanka,2014,1,0,1
North Korea,Kuwait,2014,0,1,1
Philippines,Nepal,2014,3,0,3
Bahrain,North Korea,2014,2,2,4
Kuwait,Yemen,2014,1,1,2
Qatar,North Korea,2014,3,1,4
Saudi Arabia,Palestine,2014,2,0,2
United Arab Emirates,Lebanon,2014,3,2,5
Bahrain,Singapore,2014,2,0,2
Oman,Yemen,2014,2,0,2
Thailand,Philippines,2014,3,0,3
Uganda,Ethiopia,2014,3,0,3
Vietnam,Palestine,2014,1,3,4
Cuba,French Guiana,2014,1,1,2
Curaçao,Trinidad and Tobago,2014,2,3,5
Argentina,Croatia,2014,2,1,3
Belgium,Iceland,2014,3,1,4
Haiti,Antigua and Barbuda,2014,2,2,4
Netherlands,Mexico,2014,2,3,5
Norway,Estonia,2014,0,1,1
Turkey,Brazil,2014,0,4,4
Curaçao,Cuba,2014,2,3,5
North Korea,Hong Kong,2014,2,1,3
Morocco,Benin,2014,6,1,7
Saudi Arabia,Qatar,2014,1,1,2
Singapore,Laos,2014,2,0,2
Trinidad and Tobago,French Guiana,2014,4,2,6
Uruguay,Costa Rica,2014,3,3,6
Yemen,Bahrain,2014,0,0,0
Botswana,Tunisia,2014,0,0,0
China PR,New Zealand,2014,1,1,2
France,Albania,2014,1,1,2
Georgia,Poland,2014,0,4,4
Germany,Gibraltar,2014,4,0,4
Greece,Faroe Islands,2014,0,1,1
Hungary,Finland,2014,1,0,1
Iraq,Kuwait,2014,0,1,1
Ivory Coast,Sierra Leone,2014,5,1,6
Japan,Honduras,2014,6,0,6
Jordan,South Korea,2014,0,1,1
Martinique,Haiti,2014,0,3,3
Paraguay,Peru,2014,2,1,3
Philippines,Cambodia,2014,3,0,3
Portugal,Armenia,2014,1,0,1
Romania,Northern Ireland,2014,2,0,2
Scotland,Republic of Ireland,2014,1,0,1
Serbia,Denmark,2014,1,3,4
United Arab Emirates,Oman,2014,0,0,0
United States,Colombia,2014,1,2,3
Algeria,Ethiopia,2014,3,1,4
Angola,Gabon,2014,0,0,0
Austria,Russia,2014,1,0,1
Cameroon,DR Congo,2014,1,0,1
Cape Verde,Niger,2014,3,1,4
Congo,Nigeria,2014,0,2,2
Egypt,Senegal,2014,0,1,1
England,Slovenia,2014,3,1,4
French Guiana,Curaçao,2014,4,1,5
Indonesia,Syria,2014,0,2,2
Lesotho,Burkina Faso,2014,0,1,1
Luxembourg,Ukraine,2014,0,3,3
North Macedonia,Slovakia,2014,0,2,2
Malawi,Mali,2014,2,0,2
Moldova,Liechtenstein,2014,0,1,1
Montenegro,Sweden,2014,1,1,2
Mozambique,Zambia,2014,0,1,1
San Marino,Estonia,2014,0,0,0
South Africa,Sudan,2014,2,1,3
Spain,Belarus,2014,3,0,3
Switzerland,Lithuania,2014,4,0,4
Togo,Guinea,2014,1,4,5
Uganda,Ghana,2014,1,0,1
Antigua and Barbuda,Martinique,2014,0,2,2
Azerbaijan,Norway,2014,0,1,1
Belgium,Wales,2014,0,0,0
Bulgaria,Malta,2014,1,1,2
Cyprus,Andorra,2014,5,0,5
Czech Republic,Iceland,2014,2,1,3
Guam,North Korea,2014,1,5,6
Israel,Bosnia and Herzegovina,2014,3,0,3
Italy,Croatia,2014,1,1,2
Morocco,Zimbabwe,2014,2,1,3
Netherlands,Latvia,2014,6,0,6
Saudi Arabia,Bahrain,2014,3,0,3
Eswatini,Tanzania,2014,1,1,2
Turkey,Kazakhstan,2014,3,1,4
Vietnam,Malaysia,2014,3,1,4
Yemen,Qatar,2014,0,0,0
Iraq,Oman,2014,1,1,2
Singapore,Cambodia,2014,4,2,6
United Arab Emirates,Kuwait,2014,2,2,4
Austria,Brazil,2014,1,2,3
Belarus,Mexico,2014,3,2,5
Bolivia,Venezuela,2014,3,2,5
Chile,Uruguay,2014,1,2,3
China PR,Honduras,2014,0,0,0
Cuba,Haiti,2014,1,2,3
Estonia,Jordan,2014,1,0,1
France,Sweden,2014,1,0,1
Greece,Serbia,2014,0,2,2
Hungary,Russia,2014,1,2,3
Iran,South Korea,2014,1,0,1
Republic of Ireland,United States,2014,4,1,5
Italy,Albania,2014,1,0,1
Jamaica,Trinidad and Tobago,2014,0,0,0
Japan,Australia,2014,2,1,3
Nicaragua,El Salvador,2014,0,2,2
Panama,Canada,2014,0,0,0
Peru,Paraguay,2014,2,1,3
Portugal,Argentina,2014,1,0,1
Romania,Denmark,2014,2,0,2
Scotland,England,2014,1,3,4
Slovakia,Finland,2014,2,1,3
Slovenia,Colombia,2014,0,1,1
Spain,Germany,2014,0,1,1
Thailand,New Zealand,2014,2,0,2
Ukraine,Lithuania,2014,0,0,0
Bahrain,Qatar,2014,0,0,0
Burkina Faso,Angola,2014,1,1,2
DR Congo,Sierra Leone,2014,3,1,4
Ethiopia,Malawi,2014,0,0,0
Gabon,Lesotho,2014,4,2,6
Ghana,Togo,2014,3,1,4
Guam,Hong Kong,2014,0,0,0
Guinea,Uganda,2014,2,0,2
Ivory Coast,Cameroon,2014,0,0,0
Mali,Algeria,2014,2,0,2
Niger,Mozambique,2014,1,1,2
Nigeria,South Africa,2014,2,2,4
Saudi Arabia,Yemen,2014,1,0,1
Senegal,Botswana,2014,3,0,3
Sudan,Congo,2014,0,1,1
Tunisia,Egypt,2014,2,1,3
Zambia,Cape Verde,2014,1,0,1
Kuwait,Oman,2014,0,5,5
United Arab Emirates,Iraq,2014,2,0,2
Philippines,Laos,2014,4,1,5
Vietnam,Indonesia,2014,2,2,4
Malaysia,Myanmar,2014,0,0,0
Oman,Qatar,2014,1,3,4
Saudi Arabia,United Arab Emirates,2014,3,2,5
Singapore,Thailand,2014,1,2,3
Philippines,Indonesia,2014,4,0,4
Vietnam,Laos,2014,3,0,3
United Arab Emirates,Oman,2014,1,0,1
Malaysia,Thailand,2014,2,3,5
Saudi Arabia,Qatar,2014,1,2,3
Singapore,Myanmar,2014,4,2,6
Indonesia,Laos,2014,5,1,6
Vietnam,Philippines,2014,3,1,4
Singapore,Malaysia,2014,1,3,4
Thailand,Myanmar,2014,2,0,2
South Africa,Ivory Coast,2014,2,0,2
Philippines,Thailand,2014,0,0,0
Malaysia,Vietnam,2014,1,2,3
Thailand,Philippines,2014,3,0,3
Vietnam,Malaysia,2014,2,4,6
Uzbekistan,Palestine,2014,1,0,1
Thailand,Malaysia,2014,2,0,2
Malaysia,Thailand,2014,3,2,5
China PR,Palestine,2014,0,0,0
Uzbekistan,Jordan,2014,2,1,3
Iraq,Kuwait,2014,1,1,2
Uzbekistan,Iraq,2014,0,1,1
Qatar,Estonia,2014,3,0,3
Uzbekistan,Iraq,2014,0,0,0
Basque Country,Catalonia,2014,1,1,2
Bahrain,Saudi Arabia,2014,4,1,5
United Arab Emirates,Jordan,2014,1,0,1
Qatar,Oman,2014,2,2,4
Bahrain,Jordan,2015,1,0,1
Iran,Iraq,2015,1,0,1
South Korea,Saudi Arabia,2015,2,0,2
South Africa,Zambia,2015,1,0,1
China PR,Oman,2015,4,1,5
Cameroon,DR Congo,2015,1,1,2
Australia,Kuwait,2015,4,1,5
Senegal,Gabon,2015,1,0,1
Burkina Faso,Eswatini,2015,5,1,6
Cameroon,South Africa,2015,1,1,2
Cape Verde,Congo,2015,3,2,5
South Korea,Oman,2015,1,0,1
Saudi Arabia,China PR,2015,0,1,1
Uzbekistan,North Korea,2015,1,0,1
Iran,Bahrain,2015,2,0,2
Nigeria,Ivory Coast,2015,0,1,1
Tunisia,Algeria,2015,1,1,2
United Arab Emirates,Qatar,2015,4,1,5
Japan,Palestine,2015,4,0,4
Jordan,Iraq,2015,0,1,1
Australia,Oman,2015,4,0,4
Botswana,Burkina Faso,2015,0,2,2
Kuwait,South Korea,2015,0,1,1
Senegal,Guinea,2015,5,2,7
China PR,Uzbekistan,2015,2,1,3
North Korea,Saudi Arabia,2015,1,4,5
Mali,South Africa,2015,0,3,3
Bahrain,United Arab Emirates,2015,1,2,3
Qatar,Iran,2015,0,1,1
Sweden,Ivory Coast,2015,2,0,2
Canada,Iceland,2015,1,2,3
Iraq,Japan,2015,0,1,1
Palestine,Jordan,2015,1,5,6
Australia,South Korea,2015,0,1,1
Burkina Faso,Gabon,2015,0,2,2
Equatorial Guinea,Congo,2015,1,1,2
Oman,Kuwait,2015,1,0,1
Yemen,Nigeria,2015,0,2,2
China PR,North Korea,2015,2,1,3
Tunisia,Cape Verde,2015,1,1,2
Uzbekistan,Saudi Arabia,2015,3,1,4
Zambia,DR Congo,2015,1,1,2
Algeria,South Africa,2015,3,1,4
Canada,Iceland,2015,1,1,2
Finland,Sweden,2015,1,0,1
Ghana,Senegal,2015,1,2,3
Iran,United Arab Emirates,2015,1,0,1
Qatar,Bahrain,2015,1,2,3
Iraq,Palestine,2015,2,0,2
Ivory Coast,Guinea,2015,1,1,2
Japan,Jordan,2015,2,0,2
Mali,Cameroon,2015,1,1,2
Equatorial Guinea,Burkina Faso,2015,0,0,0
Gabon,Congo,2015,0,1,1
Australia,China PR,2015,2,0,2
Cape Verde,DR Congo,2015,0,0,0
South Korea,Uzbekistan,2015,2,0,2
Yemen,Finland,2015,0,0,0
Zambia,Tunisia,2015,1,2,3
Ghana,Algeria,2015,1,0,1
Iran,Iraq,2015,3,3,6
Japan,United Arab Emirates,2015,1,1,2
South Africa,Senegal,2015,1,1,2
Cameroon,Guinea,2015,1,1,2
Ivory Coast,Mali,2015,1,1,2
Congo,Burkina Faso,2015,2,1,3
Equatorial Guinea,Gabon,2015,2,0,2
Cape Verde,Zambia,2015,0,0,0
DR Congo,Tunisia,2015,1,1,2
South Korea,Iraq,2015,2,0,2
Australia,United Arab Emirates,2015,2,0,2
Senegal,Algeria,2015,0,2,2
South Africa,Ghana,2015,1,2,3
Cameroon,Ivory Coast,2015,0,1,1
Chile,United States,2015,3,2,5
Guinea,Mali,2015,1,1,2
Curaçao,Aruba,2015,0,0,0
Iraq,United Arab Emirates,2015,2,3,5
Suriname,Bonaire,2015,3,0,3
Australia,South Korea,2015,2,1,3
Congo,DR Congo,2015,2,4,6
Equatorial Guinea,Tunisia,2015,2,1,3
Curaçao,Bonaire,2015,4,1,5
Ghana,Guinea,2015,3,0,3
Ivory Coast,Algeria,2015,3,1,4
Suriname,Aruba,2015,1,0,1
Bangladesh,Sri Lanka,2015,1,0,1
DR Congo,Ivory Coast,2015,1,3,4
Honduras,Venezuela,2015,2,3,5
Equatorial Guinea,Ghana,2015,0,3,3
Pakistan,Afghanistan,2015,2,1,3
Equatorial Guinea,DR Congo,2015,0,0,0
Ivory Coast,Ghana,2015,0,0,0
United States,Panama,2015,2,0,2
Kazakhstan,Moldova,2015,1,1,2
Antigua and Barbuda,United States Virgin Islands,2015,2,0,2
Bermuda,Grenada,2015,2,0,2
Cambodia,Macau,2015,3,0,3
Timor-Leste,Mongolia,2015,0,3,3
India,Nepal,2015,2,0,2
Sri Lanka,Bhutan,2015,0,1,1
Yemen,Pakistan,2015,3,1,4
Antigua and Barbuda,Dominica,2015,1,0,1
Bhutan,Sri Lanka,2015,2,1,3
Brunei,Taiwan,2015,0,2,2
Macau,Cambodia,2015,1,1,2
Mongolia,Timor-Leste,2015,3,0,3
Nepal,India,2015,0,0,0
Antigua and Barbuda,British Virgin Islands,2015,1,0,1
Barbados,United States Virgin Islands,2015,0,1,1
Pakistan,Yemen,2015,0,0,0
Botswana,Lesotho,2015,2,0,2
Denmark,United States,2015,3,2,5
Dominican Republic,Cuba,2015,0,3,3
French Guiana,Honduras,2015,3,1,4
Gabon,Mali,2015,4,3,7
Georgia,Malta,2015,2,0,2
Germany,Australia,2015,2,2,4
Indonesia,Cameroon,2015,0,1,1
Mauritius,Burundi,2015,2,2,4
Nigeria,Uganda,2015,0,1,1
Scotland,Northern Ireland,2015,1,0,1
Eswatini,South Africa,2015,1,3,4
Bahrain,Colombia,2015,0,6,6
Chile,Iran,2015,0,2,2
Egypt,Equatorial Guinea,2015,2,0,2
France,Brazil,2015,1,3,4
Ivory Coast,Angola,2015,2,0,2
Jordan,Syria,2015,0,1,1
Maldives,Tajikistan,2015,0,2,2
Oman,Malaysia,2015,6,0,6
Qatar,Algeria,2015,1,0,1
Thailand,Singapore,2015,2,0,2
United States Virgin Islands,Barbados,2015,0,4,4
Canada,Guatemala,2015,1,0,1
China PR,Haiti,2015,2,2,4
Curaçao,Montserrat,2015,2,1,3
England,Lithuania,2015,4,0,4
Gambia,Mauritania,2015,1,0,1
Japan,Tunisia,2015,2,0,2
South Korea,Uzbekistan,2015,1,1,2
Liechtenstein,Austria,2015,0,5,5
North Macedonia,Belarus,2015,1,2,3
Moldova,Sweden,2015,0,2,2
Slovakia,Luxembourg,2015,3,0,3
Slovenia,San Marino,2015,6,0,6
Spain,Ukraine,2015,1,0,1
Switzerland,Estonia,2015,3,0,3
Trinidad and Tobago,Panama,2015,0,1,1
Andorra,Bosnia and Herzegovina,2015,0,3,3
Azerbaijan,Malta,2015,2,0,2
Belgium,Cyprus,2015,5,0,5
Bulgaria,Italy,2015,2,2,4
Croatia,Norway,2015,5,1,6
Czech Republic,Latvia,2015,1,1,2
Ghana,Senegal,2015,1,2,3
Hong Kong,Guam,2015,1,0,1
Iraq,DR Congo,2015,2,1,3
Israel,Wales,2015,0,3,3
Kazakhstan,Iceland,2015,0,3,3
Mauritius,Togo,2015,1,1,2
Morocco,Uruguay,2015,0,1,1
Netherlands,Turkey,2015,1,1,2
Albania,Armenia,2015,2,1,3
Anguilla,Nicaragua,2015,0,3,3
Bermuda,Bahamas,2015,3,0,3
Botswana,Mozambique,2015,1,2,3
Brazil,Chile,2015,1,0,1
Dominica,British Virgin Islands,2015,0,0,0
France,Denmark,2015,2,0,2
Georgia,Germany,2015,0,2,2
Guyana,Grenada,2015,2,0,2
Honduras,French Guiana,2015,3,0,3
Hungary,Greece,2015,0,0,0
Republic of Ireland,Poland,2015,1,1,2
Ivory Coast,Equatorial Guinea,2015,1,1,2
Northern Ireland,Finland,2015,2,1,3
Portugal,Serbia,2015,2,1,3
Romania,Faroe Islands,2015,1,0,1
Scotland,Gibraltar,2015,6,1,7
South Africa,Nigeria,2015,1,1,2
Tanzania,Malawi,2015,1,1,2
Zambia,Rwanda,2015,2,0,2
Bahrain,Philippines,2015,2,1,3
Belarus,Gabon,2015,0,0,0
Indonesia,Myanmar,2015,2,1,3
Jamaica,Cuba,2015,3,0,3
Kuwait,Colombia,2015,1,3,4
North Macedonia,Australia,2015,0,0,0
Oman,Algeria,2015,1,4,5
Qatar,Slovenia,2015,1,0,1
Saudi Arabia,Jordan,2015,2,1,3
Thailand,Cameroon,2015,2,3,5
Austria,Bosnia and Herzegovina,2015,1,1,2
China PR,Tunisia,2015,1,1,2
Estonia,Iceland,2015,1,1,2
Ghana,Mali,2015,1,1,2
Iraq,DR Congo,2015,1,0,1
Israel,Belgium,2015,0,1,1
Italy,England,2015,1,1,2
Japan,Uzbekistan,2015,5,1,6
South Korea,New Zealand,2015,1,0,1
Liechtenstein,San Marino,2015,1,0,1
Luxembourg,Turkey,2015,1,2,3
Mauritania,Niger,2015,2,0,2
Montserrat,Curaçao,2015,2,2,4
Netherlands,Spain,2015,2,0,2
Panama,Costa Rica,2015,2,1,3
Peru,Venezuela,2015,0,1,1
Portugal,Cape Verde,2015,0,2,2
Russia,Kazakhstan,2015,0,0,0
Singapore,Guam,2015,2,2,4
Slovakia,Czech Republic,2015,1,0,1
Sweden,Iran,2015,3,1,4
Switzerland,United States,2015,1,1,2
Tajikistan,Syria,2015,2,3,5
Ukraine,Latvia,2015,1,1,2
United States,Mexico,2015,2,0,2
Barbados,Saint Kitts and Nevis,2015,1,3,4
Zambia,Malawi,2015,2,0,2
Kazakhstan,Burkina Faso,2015,0,0,0
Dominican Republic,Cayman Islands,2015,6,0,6
Grenada,Dominica,2015,1,2,3
Lesotho,South Africa,2015,0,0,0
Saint Lucia,Saint Vincent and the Grenadines,2015,1,2,3
Lesotho,South Africa,2015,1,1,2
Saint Lucia,Grenada,2015,0,2,2
Namibia,Seychelles,2015,0,0,0
Vietnam,North Korea,2015,1,1,2
Zimbabwe,Mauritius,2015,2,0,2
Lesotho,Madagascar,2015,1,2,3
Tanzania,Eswatini,2015,0,1,1
Namibia,Mauritius,2015,2,0,2
Seychelles,Zimbabwe,2015,0,1,1
Lesotho,Eswatini,2015,0,2,2
Madagascar,Tanzania,2015,2,0,2
Thailand,North Korea,2015,0,1,1
Namibia,Zimbabwe,2015,4,1,5
Seychelles,Mauritius,2015,0,1,1
Lesotho,Tanzania,2015,1,0,1
Madagascar,Eswatini,2015,1,1,2
Lebanon,Syria,2015,2,2,4
South Africa,Botswana,2015,0,0,0
Thailand,Vietnam,2015,1,0,1
Zambia,Namibia,2015,0,0,0
Ghana,Madagascar,2015,1,2,3
Mozambique,Malawi,2015,2,2,4
South Africa,Malawi,2015,0,0,0
Zambia,Ghana,2015,3,0,3
Botswana,Mozambique,2015,1,2,3
Namibia,Madagascar,2015,3,2,5
Laos,Afghanistan,2015,0,2,2
Zambia,Malawi,2015,0,1,1
Corsica,Burkina Faso,2015,1,0,1
Bahrain,Oman,2015,0,0,0
Bangladesh,Singapore,2015,1,2,3
Jordan,Lebanon,2015,0,0,0
Madagascar,Botswana,2015,2,1,3
Mexico,Guatemala,2015,3,0,3
Namibia,Mozambique,2015,2,0,2
El Salvador,Honduras,2015,0,2,2
Northern Ireland,Qatar,2015,1,1,2
Bangladesh,Afghanistan,2015,1,1,2
Cambodia,Laos,2015,1,1,2
Panama,Ecuador,2015,1,1,2
Cambodia,Myanmar,2015,1,0,1
Curaçao,Trinidad and Tobago,2015,1,0,1
Hungary,Lithuania,2015,4,0,4
Jordan,Kuwait,2015,2,2,4
Netherlands,United States,2015,3,4,7
Oman,Syria,2015,1,2,3
Scotland,Qatar,2015,1,0,1
Thailand,Bahrain,2015,1,1,2
Andorra,Equatorial Guinea,2015,0,1,1
Burkina Faso,Cameroon,2015,2,3,5
Colombia,Costa Rica,2015,1,0,1
Ecuador,Panama,2015,4,0,4
Guinea,Chad,2015,2,1,3
Malaysia,Hong Kong,2015,0,0,0
Niger,Gabon,2015,2,1,3
Paraguay,Honduras,2015,2,2,4
Rwanda,Kenya,2015,0,0,0
Singapore,Brunei,2015,5,1,6
Uruguay,Guatemala,2015,5,1,6
Brazil,Mexico,2015,2,0,2
Croatia,Gibraltar,2015,4,0,4
Ethiopia,Zambia,2015,0,1,1
France,Belgium,2015,3,4,7
Republic of Ireland,England,2015,0,0,0
Kenya,South Sudan,2015,2,0,2
Russia,Belarus,2015,4,2,6
Rwanda,Tanzania,2015,2,0,2
Serbia,Azerbaijan,2015,4,1,5
Denmark,Montenegro,2015,2,1,3
Egypt,Malawi,2015,2,1,3
Ghana,Togo,2015,1,0,1
Malta,Lithuania,2015,2,0,2
Norway,Sweden,2015,0,0,0
Turkey,Bulgaria,2015,4,0,4
DR Congo,Cameroon,2015,1,1,2
Finland,Estonia,2015,0,2,2
Georgia,Ukraine,2015,1,2,3
Luxembourg,Moldova,2015,0,0,0
Uganda,Gambia,2015,1,1,2
Brazil,Honduras,2015,1,0,1
Curaçao,Cuba,2015,0,0,0
Germany,United States,2015,1,2,3
Switzerland,Liechtenstein,2015,3,0,3
Afghanistan,Syria,2015,0,6,6
Bangladesh,Kyrgyzstan,2015,1,3,4
Cambodia,Singapore,2015,0,4,4
Chile,Ecuador,2015,2,0,2
Dominican Republic,Belize,2015,1,2,3
Guam,Turkmenistan,2015,1,0,1
Hong Kong,Bhutan,2015,7,0,7
India,Oman,2015,1,2,3
Japan,Iraq,2015,4,0,4
South Korea,United Arab Emirates,2015,3,0,3
Laos,Myanmar,2015,2,2,4
Lebanon,Kuwait,2015,0,1,1
Malaysia,Timor-Leste,2015,3,0,3
Maldives,Qatar,2015,0,1,1
Philippines,Bahrain,2015,2,1,3
Saudi Arabia,Palestine,2015,3,2,5
Spain,Costa Rica,2015,2,1,3
Tajikistan,Jordan,2015,1,3,4
Uzbekistan,Iran,2015,0,1,1
Yemen,North Korea,2015,0,3,3
Andorra,Cyprus,2015,1,3,4
Bosnia and Herzegovina,Israel,2015,3,1,4
Croatia,Italy,2015,1,1,2
Guinea,Eswatini,2015,1,2,3
Iceland,Czech Republic,2015,2,1,3
Kazakhstan,Turkey,2015,0,1,1
Latvia,Netherlands,2015,0,2,2
Malta,Bulgaria,2015,0,1,1
Mexico,Bolivia,2015,0,0,0
Morocco,Libya,2015,1,0,1
Norway,Azerbaijan,2015,0,0,0
Tunisia,Djibouti,2015,8,1,9
Wales,Belgium,2015,1,0,1
Albania,France,2015,1,0,1
Algeria,Seychelles,2015,4,0,4
Angola,Central African Republic,2015,4,0,4
Argentina,Paraguay,2015,2,2,4
Armenia,Portugal,2015,2,3,5
Burkina Faso,Comoros,2015,2,0,2
Cape Verde,São Tomé and Príncipe,2015,7,1,8
Denmark,Serbia,2015,2,0,2
Faroe Islands,Greece,2015,2,1,3
Finland,Hungary,2015,0,1,1
Gibraltar,Germany,2015,0,7,7
Republic of Ireland,Scotland,2015,1,1,2
Malawi,Zimbabwe,2015,1,2,3
Mali,South Sudan,2015,2,0,2
Nigeria,Chad,2015,2,0,2
Northern Ireland,Romania,2015,0,0,0
Poland,Georgia,2015,4,0,4
Senegal,Burundi,2015,3,1,4
South Africa,Gambia,2015,0,0,0
Uganda,Botswana,2015,2,0,2
Uruguay,Jamaica,2015,1,0,1
Zambia,Guinea-Bissau,2015,0,0,0
Barbados,Aruba,2015,0,3,3
Belarus,Spain,2015,0,1,1
Brazil,Peru,2015,2,1,3
Cameroon,Mauritania,2015,1,0,1
Colombia,Venezuela,2015,0,1,1
Congo,Kenya,2015,1,1,2
DR Congo,Madagascar,2015,2,1,3
Cuba,Curaçao,2015,1,1,2
Egypt,Tanzania,2015,3,0,3
Equatorial Guinea,Benin,2015,1,1,2
Estonia,San Marino,2015,2,0,2
Ethiopia,Lesotho,2015,2,1,3
Gabon,Ivory Coast,2015,0,0,0
Ghana,Mauritius,2015,7,1,8
Liechtenstein,Moldova,2015,1,1,2
Lithuania,Switzerland,2015,1,2,3
Mozambique,Rwanda,2015,0,1,1
Niger,Namibia,2015,1,0,1
Russia,Austria,2015,0,1,1
Slovakia,North Macedonia,2015,2,1,3
Slovenia,England,2015,2,3,5
Sudan,Sierra Leone,2015,1,0,1
Sweden,Montenegro,2015,3,1,4
Togo,Liberia,2015,2,1,3
Ukraine,Luxembourg,2015,3,0,3
Chile,Mexico,2015,3,3,6
Ecuador,Bolivia,2015,2,3,5
Morocco,Tunisia,2015,1,1,2
Argentina,Uruguay,2015,1,0,1
Bangladesh,Tajikistan,2015,1,1,2
Bhutan,China PR,2015,0,6,6
Myanmar,South Korea,2015,0,2,2
Cambodia,Afghanistan,2015,0,1,1
Timor-Leste,United Arab Emirates,2015,0,3,3
Grenada,Puerto Rico,2015,2,0,2
Guam,India,2015,2,1,3
Hong Kong,Maldives,2015,2,0,2
Italy,Portugal,2015,0,1,1
Japan,Singapore,2015,0,0,0
Jordan,Trinidad and Tobago,2015,3,0,3
North Korea,Uzbekistan,2015,4,2,6
Kyrgyzstan,Australia,2015,1,2,3
Laos,Lebanon,2015,0,2,2
Malaysia,Palestine,2015,0,6,6
Paraguay,Jamaica,2015,1,0,1
Poland,Greece,2015,0,0,0
South Africa,Angola,2015,2,1,3
Suriname,Nicaragua,2015,1,3,4
Turkmenistan,Iran,2015,1,1,2
Yemen,Philippines,2015,0,2,2
Brazil,Colombia,2015,0,1,1
Székely Land,County of Nice,2015,2,3,5
Padania,Romani people,2015,3,2,5
Peru,Venezuela,2015,1,0,1
Székely Land,Felvidék,2015,1,3,4
Romani people,Ellan Vannin,2015,1,3,4
Chile,Bolivia,2015,5,0,5
Mexico,Ecuador,2015,1,2,3
Felvidék,County of Nice,2015,1,4,5
Padania,Ellan Vannin,2015,1,0,1
Székely Land,Romani people,2015,2,4,6
Argentina,Jamaica,2015,1,0,1
Mozambique,Seychelles,2015,5,1,6
Senegal,Gambia,2015,3,1,4
South Africa,Mauritius,2015,3,0,3
Tanzania,Uganda,2015,0,3,3
Uruguay,Paraguay,2015,1,1,2
County of Nice,Ellan Vannin,2015,3,1,4
Padania,Felvidék,2015,5,0,5
Brazil,Venezuela,2015,2,1,3
Colombia,Peru,2015,0,0,0
Djibouti,Burundi,2015,1,2,3
Ethiopia,Kenya,2015,2,0,2
Lesotho,Botswana,2015,0,0,0
Mauritania,Sierra Leone,2015,2,1,3
Morocco,Libya,2015,3,0,3
Namibia,Zambia,2015,2,1,3
Eswatini,Angola,2015,2,2,4
Zimbabwe,Comoros,2015,2,0,2
Ellan Vannin,Felvidék,2015,1,1,2
County of Nice,Padania,2015,1,4,5
Guinea,Liberia,2015,3,1,4
Chile,Uruguay,2015,1,0,1
Bolivia,Peru,2015,1,3,4
Argentina,Colombia,2015,0,0,0
Brazil,Paraguay,2015,1,1,2
Mexico,Costa Rica,2015,2,2,4
Greenland,Menorca,2015,2,2,4
Saare County,Åland Islands,2015,1,2,3
Gibraltar,Gotland,2015,2,1,3
Ynys Môn,Guernsey,2015,2,5,7
Falkland Islands,Hitra,2015,2,1,3
Shetland,Isle of Wight,2015,0,0,0
Western Isles,Isle of Man,2015,0,9,9
Jersey,Alderney,2015,6,0,6
Chile,Peru,2015,2,1,3
Isle of Man,Alderney,2015,7,0,7
Jersey,Western Isles,2015,3,0,3
Åland Islands,Greenland,2015,0,2,2
Menorca,Saare County,2015,3,0,3
Guernsey,Gotland,2015,3,0,3
Gibraltar,Ynys Môn,2015,1,1,2
Isle of Wight,Falkland Islands,2015,3,0,3
Hitra,Shetland,2015,1,4,5
Argentina,Paraguay,2015,6,1,7
Åland Islands,Menorca,2015,1,3,4
Greenland,Saare County,2015,2,1,3
Gotland,Ynys Môn,2015,2,3,5
Gibraltar,Guernsey,2015,0,4,4
Isle of Wight,Hitra,2015,3,1,4
Falkland Islands,Shetland,2015,0,5,5
Jersey,Isle of Man,2015,1,2,3
Alderney,Western Isles,2015,2,3,5
Honduras,Mexico,2015,0,0,0
Hitra,Alderney,2015,5,1,6
Gotland,Saare County,2015,2,3,5
Falkland Islands,Western Isles,2015,1,2,3
Gibraltar,Åland Islands,2015,0,0,0
Jersey,Ynys Môn,2015,1,0,1
Isle of Wight,Greenland,2015,1,2,3
Menorca,Guernsey,2015,1,2,3
Shetland,Isle of Man,2015,1,3,4
Peru,Paraguay,2015,2,0,2
Menorca,Shetland,2015,1,0,1
Guernsey,Isle of Man,2015,3,0,3
Angola,Eswatini,2015,2,0,2
Chile,Argentina,2015,0,0,0
Zambia,Namibia,2015,2,1,3
Malawi,Uganda,2015,1,0,1
Panama,Haiti,2015,1,1,2
United States,Honduras,2015,2,1,3
Costa Rica,Jamaica,2015,2,2,4
El Salvador,Canada,2015,0,0,0
Mexico,Cuba,2015,6,0,6
Trinidad and Tobago,Guatemala,2015,3,1,4
Honduras,Panama,2015,1,1,2
United States,Haiti,2015,1,0,1
Costa Rica,El Salvador,2015,1,1,2
Jamaica,Canada,2015,1,0,1
Guatemala,Mexico,2015,0,0,0
Trinidad and Tobago,Cuba,2015,2,0,2
Honduras,Haiti,2015,0,1,1
United States,Panama,2015,1,1,2
Canada,Costa Rica,2015,0,0,0
Jamaica,El Salvador,2015,1,0,1
Guatemala,Cuba,2015,0,1,1
Trinidad and Tobago,Mexico,2015,4,4,8
Haiti,Jamaica,2015,0,1,1
United States,Cuba,2015,6,0,6
Mexico,Costa Rica,2015,1,0,1
Trinidad and Tobago,Panama,2015,1,1,2
Panama,Mexico,2015,1,2,3
United States,Jamaica,2015,1,2,3
United States,Panama,2015,1,1,2
Jamaica,Mexico,2015,1,3,4
China PR,South Korea,2015,0,2,2
North Korea,Japan,2015,2,1,3
China PR,North Korea,2015,2,0,2
Japan,South Korea,2015,1,1,2
China PR,Japan,2015,1,1,2
South Korea,North Korea,2015,0,0,0
Fiji,Tonga,2015,5,0,5
Cambodia,Bhutan,2015,2,0,2
Lebanon,Iraq,2015,2,3,5
Fiji,American Samoa,2015,6,0,6
Oman,Yemen,2015,1,0,1
Qatar,Singapore,2015,4,0,4
Rwanda,Ethiopia,2015,3,1,4
Tanzania,Libya,2015,1,2,3
United Arab Emirates,Myanmar,2015,1,0,1
Laos,Cambodia,2015,2,1,3
Malaysia,Bangladesh,2015,0,0,0
Niger,Burkina Faso,2015,0,0,0
India,Nepal,2015,0,0,0
Lebanon,Palestine,2015,0,0,0
Samoa,American Samoa,2015,3,2,5
Tonga,Cook Islands,2015,0,3,3
Congo,Ghana,2015,2,3,5
Cook Islands,Samoa,2015,1,0,1
Tonga,American Samoa,2015,1,2,3
Australia,Bangladesh,2015,5,0,5
Azerbaijan,Croatia,2015,0,0,0
Bahrain,North Korea,2015,0,1,1
Belgium,Bosnia and Herzegovina,2015,3,1,4
Bulgaria,Norway,2015,0,1,1
China PR,Hong Kong,2015,0,0,0
Cyprus,Wales,2015,0,1,1
Czech Republic,Kazakhstan,2015,2,1,3
Iran,Guam,2015,6,0,6
Iraq,Taiwan,2015,5,1,6
Israel,Andorra,2015,4,0,4
Italy,Malta,2015,1,0,1
Japan,Cambodia,2015,3,0,3
Jordan,Kyrgyzstan,2015,0,0,0
South Korea,Laos,2015,8,0,8
Kuwait,Myanmar,2015,9,0,9
Netherlands,Iceland,2015,0,1,1
Oman,Turkmenistan,2015,3,1,4
Philippines,Maldives,2015,2,0,2
Qatar,Bhutan,2015,15,0,15
Saudi Arabia,Timor-Leste,2015,7,0,7
Syria,Singapore,2015,1,0,1
Thailand,Afghanistan,2015,2,0,2
Turkey,Latvia,2015,1,1,2
United Arab Emirates,Malaysia,2015,10,0,10
Uzbekistan,Yemen,2015,1,0,1
American Samoa,Cook Islands,2015,2,0,2
Curaçao,El Salvador,2015,0,1,1
Denmark,Albania,2015,0,0,0
Djibouti,Togo,2015,0,2,2
Faroe Islands,Northern Ireland,2015,1,3,4
Georgia,Scotland,2015,1,0,1
Germany,Poland,2015,3,1,4
Gibraltar,Republic of Ireland,2015,0,4,4
Greece,Finland,2015,0,1,1
Grenada,Haiti,2015,1,3,4
Hungary,Romania,2015,0,0,0
Portugal,France,2015,0,1,1
Serbia,Armenia,2015,2,0,2
Tonga,Samoa,2015,0,3,3
Venezuela,Honduras,2015,0,3,3
Austria,Moldova,2015,1,0,1
Botswana,Burkina Faso,2015,1,0,1
Chile,Paraguay,2015,3,2,5
Comoros,Uganda,2015,0,1,1
Costa Rica,Brazil,2015,0,1,1
Estonia,Lithuania,2015,1,0,1
Gabon,Sudan,2015,4,0,4
Guinea-Bissau,Congo,2015,2,4,6
Liberia,Tunisia,2015,1,0,1
Luxembourg,North Macedonia,2015,1,0,1
Mauritania,South Africa,2015,3,1,4
Montenegro,Liechtenstein,2015,2,0,2
Namibia,Senegal,2015,0,2,2
Russia,Sweden,2015,1,0,1
Rwanda,Ghana,2015,0,1,1
San Marino,England,2015,0,6,6
São Tomé and Príncipe,Morocco,2015,0,3,3
Seychelles,Ethiopia,2015,1,1,2
South Sudan,Equatorial Guinea,2015,1,0,1
Spain,Slovakia,2015,2,0,2
Switzerland,Slovenia,2015,3,2,5
Tanzania,Nigeria,2015,0,0,0
Ukraine,Belarus,2015,3,1,4
Bosnia and Herzegovina,Andorra,2015,3,0,3
Central African Republic,DR Congo,2015,2,0,2
Chad,Egypt,2015,1,5,6
Cyprus,Belgium,2015,0,1,1
Iceland,Kazakhstan,2015,0,0,0
Italy,Bulgaria,2015,1,0,1
Latvia,Czech Republic,2015,1,2,3
Lesotho,Algeria,2015,1,3,4
Libya,Cape Verde,2015,1,2,3
Madagascar,Angola,2015,0,0,0
Malta,Azerbaijan,2015,2,2,4
Mauritius,Mozambique,2015,1,0,1
Norway,Croatia,2015,2,0,2
Sierra Leone,Ivory Coast,2015,0,0,0
Eswatini,Malawi,2015,2,2,4
Turkey,Netherlands,2015,3,0,3
Wales,Israel,2015,0,0,0
Albania,Portugal,2015,0,1,1
Armenia,Denmark,2015,0,0,0
Myanmar,New Zealand,2015,1,1,2
Finland,Faroe Islands,2015,1,0,1
France,Serbia,2015,2,1,3
Republic of Ireland,Georgia,2015,1,0,1
Northern Ireland,Hungary,2015,1,1,2
Poland,Gibraltar,2015,8,1,9
Romania,Greece,2015,0,0,0
Scotland,Germany,2015,2,3,5
Afghanistan,Japan,2015,0,6,6
Bangladesh,Jordan,2015,0,4,4
Belarus,Luxembourg,2015,2,0,2
Cambodia,Syria,2015,0,6,6
China PR,Maldives,2015,3,0,3
Ecuador,Honduras,2015,2,0,2
El Salvador,Curaçao,2015,1,0,1
England,Switzerland,2015,2,0,2
Guam,Oman,2015,0,0,0
Hong Kong,Qatar,2015,2,3,5
India,Iran,2015,0,3,3
Laos,Kuwait,2015,0,2,2
Lebanon,South Korea,2015,0,3,3
Liechtenstein,Russia,2015,0,7,7
Lithuania,San Marino,2015,2,1,3
North Macedonia,Spain,2015,0,1,1
Malaysia,Saudi Arabia,2015,0,3,3
Mexico,Argentina,2015,2,2,4
Moldova,Montenegro,2015,0,2,2
Nigeria,Niger,2015,2,0,2
Palestine,United Arab Emirates,2015,0,0,0
Philippines,Uzbekistan,2015,1,5,6
Slovakia,Ukraine,2015,0,0,0
Slovenia,Estonia,2015,1,0,1
South Africa,Senegal,2015,1,0,1
Sweden,Austria,2015,1,4,5
Tajikistan,Australia,2015,0,3,3
Thailand,Iraq,2015,2,2,4
Venezuela,Panama,2015,1,1,2
Yemen,Bahrain,2015,0,4,4
Zambia,Gabon,2015,1,1,2
Rwanda,Gabon,2015,0,1,1
Botswana,Ethiopia,2015,2,3,5
Oman,Syria,2015,2,1,3
Jordan,Iraq,2015,3,0,3
Comoros,Lesotho,2015,0,0,0
Mauritius,Kenya,2015,2,5,7
Seychelles,Burundi,2015,0,1,1
South Sudan,Mauritania,2015,1,1,2
Tanzania,Malawi,2015,2,0,2
Albania,Serbia,2015,0,2,2
Argentina,Ecuador,2015,0,2,2
Bahrain,Uzbekistan,2015,0,4,4
Bhutan,Maldives,2015,3,4,7
Bolivia,Uruguay,2015,0,2,2
Myanmar,Lebanon,2015,0,2,2
Chile,Brazil,2015,2,0,2
Colombia,Peru,2015,2,0,2
Timor-Leste,Palestine,2015,0,3,3
France,Armenia,2015,4,0,4
Georgia,Gibraltar,2015,4,0,4
Hungary,Faroe Islands,2015,2,1,3
Republic of Ireland,Germany,2015,1,0,1
Jordan,Australia,2015,2,0,2
North Korea,Philippines,2015,0,0,0
Kuwait,South Korea,2015,0,1,1
Kyrgyzstan,Tajikistan,2015,2,2,4
Laos,Malaysia,2015,1,3,4
Liberia,Guinea-Bissau,2015,1,1,2
Nigeria,DR Congo,2015,0,2,2
Northern Ireland,Greece,2015,3,1,4
Oman,Iran,2015,1,1,2
Portugal,Denmark,2015,1,0,1
Qatar,China PR,2015,1,0,1
Romania,Finland,2015,1,1,2
São Tomé and Príncipe,Ethiopia,2015,1,0,1
Saudi Arabia,United Arab Emirates,2015,2,1,3
Scotland,Poland,2015,2,2,4
Singapore,Afghanistan,2015,1,0,1
Syria,Japan,2015,0,3,3
Turkmenistan,India,2015,2,1,3
Venezuela,Paraguay,2015,0,1,1
Vietnam,Iraq,2015,1,1,2
Algeria,Guinea,2015,1,2,3
Burkina Faso,Mali,2015,1,4,5
Djibouti,Eswatini,2015,0,6,6
England,Estonia,2015,2,0,2
Gambia,Namibia,2015,1,1,2
Liechtenstein,Sweden,2015,0,2,2
North Macedonia,Ukraine,2015,0,2,2
Moldova,Russia,2015,1,2,3
Montenegro,Austria,2015,2,3,5
Morocco,Ivory Coast,2015,0,1,1
Slovakia,Belarus,2015,0,1,1
Slovenia,Lithuania,2015,1,1,2
Somalia,Niger,2015,0,2,2
Spain,Luxembourg,2015,4,0,4
Switzerland,San Marino,2015,7,0,7
Thailand,Hong Kong,2015,1,0,1
Tunisia,Gabon,2015,3,3,6
Andorra,Belgium,2015,1,4,5
Azerbaijan,Italy,2015,1,3,4
Bosnia and Herzegovina,Wales,2015,2,0,2
Chad,Sierra Leone,2015,1,0,1
Croatia,Bulgaria,2015,3,0,3
Czech Republic,Turkey,2015,0,2,2
Eritrea,Botswana,2015,0,2,2
Iceland,Latvia,2015,2,2,4
Israel,Cyprus,2015,1,2,3
Kazakhstan,Netherlands,2015,1,2,3
Kosovo,Equatorial Guinea,2015,2,0,2
Madagascar,Central African Republic,2015,3,0,3
Norway,Malta,2015,2,0,2
United States,Mexico,2015,2,3,5
Armenia,Albania,2015,0,3,3
Denmark,France,2015,1,2,3
Egypt,Zambia,2015,3,0,3
Ethiopia,São Tomé and Príncipe,2015,3,0,3
Faroe Islands,Romania,2015,0,3,3
Finland,Northern Ireland,2015,1,1,2
Germany,Georgia,2015,2,1,3
Gibraltar,Scotland,2015,0,6,6
Greece,Hungary,2015,4,3,7
Kenya,Mauritius,2015,0,0,0
Malawi,Tanzania,2015,1,0,1
Nigeria,Cameroon,2015,3,0,3
Poland,Republic of Ireland,2015,2,1,3
Serbia,Portugal,2015,1,2,3
Austria,Liechtenstein,2015,3,0,3
Belarus,North Macedonia,2015,0,0,0
Estonia,Switzerland,2015,0,1,1
Gabon,DR Congo,2015,1,2,3
Lithuania,England,2015,0,3,3
Luxembourg,Slovakia,2015,2,4,6
Morocco,Guinea,2015,1,1,2
Russia,Montenegro,2015,2,0,2
San Marino,Slovenia,2015,0,2,2
Sweden,Moldova,2015,2,0,2
Ukraine,Spain,2015,0,1,1
Algeria,Senegal,2015,1,0,1
Bahrain,Philippines,2015,2,0,2
Belgium,Israel,2015,3,1,4
Bhutan,Hong Kong,2015,0,1,1
Botswana,Eritrea,2015,3,1,4
Brazil,Venezuela,2015,3,1,4
Bulgaria,Azerbaijan,2015,2,0,2
Myanmar,Laos,2015,3,1,4
Burundi,Seychelles,2015,2,0,2
Congo,Benin,2015,2,1,3
Cyprus,Bosnia and Herzegovina,2015,2,3,5
Timor-Leste,Malaysia,2015,0,3,3
Ecuador,Bolivia,2015,2,0,2
El Salvador,Guatemala,2015,1,1,2
Guinea-Bissau,Liberia,2015,1,3,4
Iran,Japan,2015,1,1,2
Italy,Norway,2015,2,1,3
Jordan,Tajikistan,2015,3,0,3
North Korea,Yemen,2015,1,0,1
South Korea,Jamaica,2015,3,0,3
Kuwait,Lebanon,2015,0,0,0
Kyrgyzstan,Bangladesh,2015,2,0,2
Latvia,Kazakhstan,2015,0,1,1
Lesotho,Comoros,2015,1,1,2
Madagascar,Central African Republic,2015,2,2,4
Malta,Croatia,2015,0,1,1
Mauritania,South Sudan,2015,4,0,4
Namibia,Gambia,2015,2,1,3
Netherlands,Czech Republic,2015,2,3,5
Niger,Somalia,2015,4,0,4
Oman,India,2015,3,0,3
Paraguay,Argentina,2015,0,0,0
Peru,Chile,2015,3,4,7
Qatar,Maldives,2015,4,0,4
Sierra Leone,Chad,2015,2,1,3
Singapore,Cambodia,2015,2,1,3
Syria,Afghanistan,2015,5,2,7
Turkey,Iceland,2015,1,0,1
Turkmenistan,Guam,2015,1,0,1
Uruguay,Colombia,2015,3,0,3
Vietnam,Thailand,2015,0,3,3
Wales,Andorra,2015,2,0,2
Niger,Togo,2015,2,0,2
Nigeria,Burkina Faso,2015,2,0,2
South Africa,Angola,2015,0,2,2
Eswatini,Djibouti,2015,2,1,3
Uganda,Sudan,2015,2,0,2
Zambia,Mozambique,2015,3,0,3
Cameroon,Congo,2015,0,0,0
Ghana,Ivory Coast,2015,2,1,3
Mali,Mauritania,2015,2,1,3
Zimbabwe,Lesotho,2015,3,1,4
Tunisia,Libya,2015,1,0,1
Libya,Morocco,2015,0,4,4
Angola,South Africa,2015,1,2,3
Gabon,Chad,2015,0,1,1
Mauritania,Mali,2015,1,1,2
Senegal,Guinea,2015,3,1,4
Burkina Faso,Nigeria,2015,0,0,0
Ethiopia,Burundi,2015,3,0,3
Lesotho,Zimbabwe,2015,1,1,2
Mozambique,Zambia,2015,1,1,2
Sudan,Uganda,2015,0,2,2
Togo,Niger,2015,1,1,2
Tunisia,Morocco,2015,2,3,5
Ivory Coast,Ghana,2015,1,0,1
Congo,Cameroon,2015,0,1,1
Cambodia,Brunei,2015,6,1,7
United Arab Emirates,Turkmenistan,2015,5,1,6
Angola,Namibia,2015,1,0,1
DR Congo,Zambia,2015,3,0,3
Angola,DR Congo,2015,1,0,1
Hong Kong,Myanmar,2015,5,0,5
Namibia,Zambia,2015,0,0,0
Vanuatu,Fiji,2015,1,1,2
Palestine,Saudi Arabia,2015,0,0,0
Vanuatu,Fiji,2015,2,1,3
Estonia,Georgia,2015,3,0,3
Jordan,Malta,2015,2,0,2
Mozambique,Gabon,2015,1,0,1
Sudan,Zambia,2015,0,1,1
Afghanistan,Cambodia,2015,3,0,3
Andorra,Saint Kitts and Nevis,2015,0,1,1
Australia,Kyrgyzstan,2015,3,0,3
Benin,Burkina Faso,2015,2,1,3
Bolivia,Venezuela,2015,4,2,6
Burundi,DR Congo,2015,2,3,5
Chile,Colombia,2015,1,1,2
China PR,Bhutan,2015,12,0,12
Ecuador,Uruguay,2015,2,1,3
India,Guam,2015,1,0,1
Iran,Turkmenistan,2015,3,1,4
South Korea,Myanmar,2015,4,0,4
Lebanon,Laos,2015,7,0,7
North Macedonia,Montenegro,2015,4,1,5
Maldives,Hong Kong,2015,0,1,1
Morocco,Equatorial Guinea,2015,2,0,2
Namibia,Guinea,2015,0,1,1
Norway,Hungary,2015,0,1,1
Oman,New Zealand,2015,0,1,1
Palestine,Malaysia,2015,6,0,6
Philippines,Yemen,2015,0,1,1
Singapore,Japan,2015,0,3,3
Tajikistan,Bangladesh,2015,5,0,5
Thailand,Taiwan,2015,4,2,6
Togo,Uganda,2015,0,1,1
United Arab Emirates,Timor-Leste,2015,8,0,8
Uzbekistan,North Korea,2015,3,1,4
Angola,South Africa,2015,1,3,4
Argentina,Brazil,2015,1,1,2
Belgium,Italy,2015,3,1,4
Bosnia and Herzegovina,Republic of Ireland,2015,1,1,2
Comoros,Ghana,2015,0,0,0
Costa Rica,Haiti,2015,1,0,1
Czech Republic,Serbia,2015,4,1,5
France,Germany,2015,2,0,2
Kenya,Cape Verde,2015,1,0,1
Kosovo,Albania,2015,2,2,4
Liberia,Ivory Coast,2015,0,1,1
Libya,Rwanda,2015,1,0,1
Luxembourg,Greece,2015,1,0,1
Madagascar,Senegal,2015,2,2,4
Mauritania,Tunisia,2015,1,2,3
Niger,Cameroon,2015,0,3,3
Northern Ireland,Latvia,2015,1,0,1
Peru,Paraguay,2015,1,0,1
Poland,Iceland,2015,4,2,6
Qatar,Turkey,2015,1,2,3
Slovakia,Switzerland,2015,3,2,5
Spain,England,2015,2,0,2
Eswatini,Nigeria,2015,0,0,0
Wales,Netherlands,2015,2,3,5
Botswana,Mali,2015,2,1,3
Chad,Egypt,2015,1,0,1
Ethiopia,Congo,2015,3,4,7
Gabon,Mozambique,2015,1,0,1
Hong Kong,Macau,2015,2,0,2
Russia,Portugal,2015,1,0,1
Sweden,Denmark,2015,2,1,3
Tanzania,Algeria,2015,2,2,4
Ukraine,Slovenia,2015,2,0,2
DR Congo,Burundi,2015,3,0,3
Equatorial Guinea,Morocco,2015,1,0,1
Guinea,Namibia,2015,2,0,2
Hungary,Norway,2015,2,1,3
Uganda,Togo,2015,3,0,3
Zambia,Sudan,2015,2,0,2
Albania,Georgia,2015,2,2,4
Republic of Ireland,Bosnia and Herzegovina,2015,2,0,2
Algeria,Tanzania,2015,7,0,7
Austria,Switzerland,2015,1,2,3
Azerbaijan,Moldova,2015,2,1,3
Bangladesh,Australia,2015,0,4,4
Bhutan,Qatar,2015,0,3,3
Brazil,Peru,2015,3,0,3
Burkina Faso,Benin,2015,2,0,2
Myanmar,Kuwait,2015,3,0,3
Cambodia,Japan,2015,0,2,2
Cameroon,Niger,2015,0,0,0
Cape Verde,Kenya,2015,2,0,2
Colombia,Argentina,2015,0,1,1
Congo,Ethiopia,2015,2,1,3
Denmark,Sweden,2015,2,2,4
Timor-Leste,Saudi Arabia,2015,0,10,10
Egypt,Chad,2015,4,0,4
England,France,2015,2,0,2
Estonia,Saint Kitts and Nevis,2015,3,0,3
Ghana,Comoros,2015,2,0,2
Guam,Iran,2015,0,6,6
Honduras,Mexico,2015,0,2,2
Hong Kong,China PR,2015,0,0,0
Italy,Romania,2015,2,2,4
Ivory Coast,Liberia,2015,3,0,3
North Korea,Bahrain,2015,2,0,2
Kyrgyzstan,Jordan,2015,1,0,1
Laos,South Korea,2015,0,5,5
Luxembourg,Portugal,2015,0,2,2
North Macedonia,Lebanon,2015,0,1,1
Malaysia,United Arab Emirates,2015,1,2,3
Mali,Botswana,2015,2,0,2
Nigeria,Eswatini,2015,2,0,2
Paraguay,Bolivia,2015,2,1,3
Poland,Czech Republic,2015,3,1,4
Russia,Croatia,2015,1,3,4
Rwanda,Libya,2015,1,3,4
Senegal,Madagascar,2015,3,0,3
Singapore,Syria,2015,1,2,3
Slovakia,Iceland,2015,3,1,4
Slovenia,Ukraine,2015,1,1,2
South Africa,Angola,2015,1,0,1
Tunisia,Mauritania,2015,2,1,3
Turkey,Greece,2015,0,0,0
Turkmenistan,Oman,2015,2,1,3
Uruguay,Chile,2015,3,0,3
Venezuela,Ecuador,2015,1,3,4
Yemen,Uzbekistan,2015,1,3,4
Burundi,Zanzibar,2015,1,0,1
Ethiopia,Rwanda,2015,0,1,1
Kenya,Uganda,2015,2,0,2
Somalia,Tanzania,2015,0,4,4
South Sudan,Djibouti,2015,2,0,2
Sudan,Malawi,2015,1,2,3
Rwanda,Tanzania,2015,1,2,3
Zanzibar,Uganda,2015,0,4,4
Ethiopia,Somalia,2015,2,0,2
Kenya,Burundi,2015,1,1,2
Malawi,Djibouti,2015,3,0,3
South Sudan,Sudan,2015,0,0,0
Djibouti,Sudan,2015,0,4,4
Rwanda,Somalia,2015,3,0,3
South Sudan,Malawi,2015,2,0,2
Zanzibar,Kenya,2015,3,1,4
Ethiopia,Tanzania,2015,1,1,2
Uganda,Burundi,2015,1,0,1
Ethiopia,Tanzania,2015,1,1,2
Uganda,Malawi,2015,2,0,2
Rwanda,Kenya,2015,0,0,0
South Sudan,Sudan,2015,0,0,0
Ethiopia,Uganda,2015,0,0,0
Rwanda,Sudan,2015,1,1,2
Ethiopia,Sudan,2015,1,1,2
Uganda,Rwanda,2015,1,0,1
Nicaragua,Cuba,2015,5,0,5
Nicaragua,Cuba,2015,1,0,1
Honduras,Cuba,2015,2,0,2
Bangladesh,Nepal,2015,1,0,1
Nepal,Sri Lanka,2015,0,1,1
Afghanistan,Bangladesh,2015,4,0,4
Maldives,Bhutan,2015,3,1,4
India,Sri Lanka,2015,2,0,2
Bangladesh,Maldives,2015,1,3,4
Bhutan,Afghanistan,2015,0,3,3
Martinique,Guadeloupe,2015,2,0,2
Catalonia,Basque Country,2015,0,1,1
India,Nepal,2015,4,1,5
Afghanistan,Maldives,2015,4,1,5
Bhutan,Bangladesh,2015,0,3,3
Afghanistan,Sri Lanka,2015,5,0,5
India,Maldives,2015,3,2,5
India,Afghanistan,2016,2,1,3
Rwanda,Cameroon,2016,1,1,2
Sweden,Estonia,2016,1,1,2
Bangladesh,Sri Lanka,2016,4,2,6
Trinidad and Tobago,Haiti,2016,0,1,1
Panama,Cuba,2016,4,0,4
Rwanda,DR Congo,2016,1,0,1
Sweden,Finland,2016,3,0,3
Maldives,Cambodia,2016,3,2,5
Finland,Iceland,2016,0,1,1
Nepal,Sri Lanka,2016,1,0,1
Uganda,Cameroon,2016,0,0,0
Bangladesh,Nepal,2016,0,0,0
Gabon,Morocco,2016,0,0,0
Rwanda,Ivory Coast,2016,1,0,1
United Arab Emirates,Iceland,2016,2,1,3
Angola,Cameroon,2016,0,1,1
DR Congo,Ethiopia,2016,3,0,3
Nigeria,Niger,2016,4,1,5
Tunisia,Guinea,2016,2,2,4
Maldives,Nepal,2016,1,4,5
Mali,Uganda,2016,2,2,4
Zimbabwe,Zambia,2016,0,1,1
Morocco,Ivory Coast,2016,0,1,1
Rwanda,Gabon,2016,2,1,3
Cameroon,Ethiopia,2016,0,0,0
DR Congo,Angola,2016,4,2,6
Niger,Guinea,2016,2,2,4
Tunisia,Nigeria,2016,1,1,2
Uganda,Zambia,2016,0,1,1
Zimbabwe,Mali,2016,0,1,1
Ivory Coast,Gabon,2016,4,1,5
Rwanda,Morocco,2016,1,4,5
Cameroon,DR Congo,2016,3,1,4
Ethiopia,Angola,2016,1,2,3
Guinea,Nigeria,2016,1,0,1
Niger,Tunisia,2016,0,5,5
Egypt,Jordan,2016,0,1,1
Uganda,Zimbabwe,2016,1,1,2
Zambia,Mali,2016,0,0,0
Egypt,Libya,2016,2,0,2
Cameroon,Ivory Coast,2016,0,3,3
Rwanda,DR Congo,2016,1,2,3
Tunisia,Mali,2016,1,2,3
United States,Iceland,2016,3,2,5
Zambia,Guinea,2016,0,0,0
DR Congo,Guinea,2016,1,1,2
Mali,Ivory Coast,2016,1,0,1
Bahrain,Lebanon,2016,2,0,2
Guadeloupe,Martinique,2016,1,1,2
DR Congo,Mali,2016,3,0,3
Guinea,Ivory Coast,2016,1,2,3
Uzbekistan,Lebanon,2016,2,0,2
Guyana,Suriname,2016,2,0,2
French Guiana,Suriname,2016,2,3,5
Egypt,Burkina Faso,2016,2,0,2
Sint Maarten,Anguilla,2016,2,0,2
Iraq,Syria,2016,0,1,1
United Arab Emirates,Bangladesh,2016,6,1,7
Cuba,Bermuda,2016,2,1,3
Antigua and Barbuda,Aruba,2016,2,1,3
Barbados,Curaçao,2016,1,0,1
Chad,Tanzania,2016,0,1,1
Croatia,Israel,2016,2,0,2
Gibraltar,Liechtenstein,2016,0,0,0
Guadeloupe,Suriname,2016,0,0,0
Guinea-Bissau,Kenya,2016,1,0,1
Martinique,British Virgin Islands,2016,3,0,3
Poland,Serbia,2016,1,0,1
Romania,Lithuania,2016,1,0,1
São Tomé and Príncipe,Libya,2016,2,1,3
Slovenia,North Macedonia,2016,1,0,1
South Sudan,Benin,2016,1,2,3
Zambia,Congo,2016,1,1,2
Australia,Tajikistan,2016,7,0,7
Bahrain,Yemen,2016,3,0,3
Bolivia,Colombia,2016,2,3,5
Chile,Argentina,2016,1,2,3
China PR,Maldives,2016,4,0,4
Comoros,Botswana,2016,1,0,1
Czech Republic,Scotland,2016,0,1,1
Denmark,Iceland,2016,2,1,3
Djibouti,Liberia,2016,0,1,1
Ecuador,Paraguay,2016,2,2,4
Estonia,Norway,2016,0,0,0
Ghana,Mozambique,2016,3,1,4
Greece,Montenegro,2016,2,1,3
Iran,India,2016,4,0,4
Iraq,Thailand,2016,2,2,4
Italy,Spain,2016,1,1,2
Japan,Afghanistan,2016,5,0,5
Jordan,Bangladesh,2016,8,0,8
South Korea,Lebanon,2016,1,0,1
Madagascar,Central African Republic,2016,1,1,2
Malta,Moldova,2016,0,0,0
Oman,Guam,2016,1,0,1
Peru,Venezuela,2016,2,2,4
Qatar,Hong Kong,2016,2,0,2
Saudi Arabia,Malaysia,2016,2,0,2
Singapore,Myanmar,2016,2,1,3
Solomon Islands,Papua New Guinea,2016,2,0,2
Syria,Cambodia,2016,6,0,6
Turkey,Sweden,2016,2,1,3
Ukraine,Cyprus,2016,1,0,1
United Arab Emirates,Palestine,2016,2,0,2
Uzbekistan,Philippines,2016,1,0,1
Vietnam,Taiwan,2016,4,1,5
Wales,Northern Ireland,2016,1,1,2
Algeria,Ethiopia,2016,7,1,8
Armenia,Belarus,2016,0,0,0
Brazil,Uruguay,2016,2,2,4
Canada,Mexico,2016,0,3,3
El Salvador,Honduras,2016,2,2,4
Gabon,Sierra Leone,2016,2,1,3
Guatemala,United States,2016,2,0,2
Guinea,Malawi,2016,0,0,0
Haiti,Panama,2016,0,0,0
Republic of Ireland,Switzerland,2016,1,0,1
Ivory Coast,Sudan,2016,1,0,1
Jamaica,Costa Rica,2016,1,1,2
Luxembourg,Bosnia and Herzegovina,2016,0,3,3
Mali,Equatorial Guinea,2016,1,0,1
Mauritania,Gambia,2016,2,1,3
Netherlands,France,2016,2,3,5
Nigeria,Egypt,2016,1,1,2
Portugal,Bulgaria,2016,0,1,1
Slovakia,Latvia,2016,0,0,0
Eswatini,Zimbabwe,2016,1,1,2
Tunisia,Togo,2016,1,0,1
Anguilla,Puerto Rico,2016,0,4,4
Aruba,Saint Kitts and Nevis,2016,0,2,2
Austria,Albania,2016,2,1,3
Azerbaijan,Kazakhstan,2016,0,1,1
Bermuda,French Guiana,2016,2,1,3
British Virgin Islands,Dominica,2016,0,7,7
Burkina Faso,Uganda,2016,1,0,1
Burundi,Namibia,2016,1,3,4
Cameroon,South Africa,2016,2,2,4
Cape Verde,Morocco,2016,0,1,1
DR Congo,Angola,2016,2,1,3
Curaçao,Dominican Republic,2016,2,1,3
Germany,England,2016,2,3,5
Hungary,Croatia,2016,1,1,2
Mauritius,Rwanda,2016,1,0,1
Poland,Finland,2016,5,0,5
Russia,Lithuania,2016,3,0,3
Senegal,Niger,2016,2,0,2
Seychelles,Lesotho,2016,2,0,2
Sint Maarten,United States Virgin Islands,2016,1,2,3
Benin,South Sudan,2016,4,1,5
Botswana,Comoros,2016,2,1,3
Congo,Zambia,2016,1,1,2
Kenya,Guinea-Bissau,2016,0,1,1
Mozambique,Ghana,2016,0,0,0
Romania,Spain,2016,0,0,0
Thailand,South Korea,2016,0,1,1
Andorra,Moldova,2016,0,1,1
Central African Republic,Madagascar,2016,2,1,3
Equatorial Guinea,Mali,2016,0,1,1
Libya,São Tomé and Príncipe,2016,4,0,4
Liechtenstein,Faroe Islands,2016,2,3,5
Northern Ireland,Slovenia,2016,1,0,1
Sierra Leone,Gabon,2016,1,0,1
Ukraine,Wales,2016,1,0,1
Afghanistan,Singapore,2016,2,1,3
Angola,DR Congo,2016,0,2,2
Argentina,Bolivia,2016,2,0,2
Australia,Jordan,2016,5,1,6
Austria,Turkey,2016,1,2,3
China PR,Qatar,2016,2,0,2
Colombia,Ecuador,2016,3,0,3
Costa Rica,Jamaica,2016,3,0,3
Dominica,Martinique,2016,1,4,5
Dominican Republic,Barbados,2016,2,0,2
Egypt,Nigeria,2016,1,0,1
England,Netherlands,2016,1,2,3
Estonia,Serbia,2016,0,1,1
Ethiopia,Algeria,2016,3,3,6
France,Russia,2016,4,2,6
French Guiana,Cuba,2016,3,0,3
Gambia,Mauritania,2016,0,0,0
Georgia,Kazakhstan,2016,1,1,2
Germany,Italy,2016,4,1,5
Gibraltar,Latvia,2016,0,5,5
Greece,Iceland,2016,2,3,5
Honduras,El Salvador,2016,2,0,2
India,Turkmenistan,2016,1,2,3
Iran,Oman,2016,2,0,2
Iraq,Vietnam,2016,1,0,1
Republic of Ireland,Slovakia,2016,2,2,4
Japan,Syria,2016,5,0,5
Lebanon,Myanmar,2016,1,1,2
Lesotho,Seychelles,2016,2,1,3
Liberia,Djibouti,2016,5,0,5
Luxembourg,Albania,2016,0,2,2
North Macedonia,Bulgaria,2016,0,2,2
Malawi,Guinea,2016,1,2,3
Malaysia,Macau,2016,0,0,0
Maldives,Bhutan,2016,4,2,6
Mexico,Canada,2016,2,0,2
Montenegro,Belarus,2016,0,0,0
Morocco,Cape Verde,2016,2,0,2
Namibia,Burundi,2016,1,3,4
Niger,Senegal,2016,1,2,3
Norway,Finland,2016,2,0,2
Palestine,Timor-Leste,2016,7,0,7
Panama,Haiti,2016,1,0,1
Paraguay,Brazil,2016,2,2,4
Philippines,North Korea,2016,3,2,5
Portugal,Belgium,2016,2,1,3
Rwanda,Mauritius,2016,5,0,5
Scotland,Denmark,2016,1,0,1
South Africa,Cameroon,2016,0,0,0
Saint Kitts and Nevis,Antigua and Barbuda,2016,1,0,1
Sudan,Ivory Coast,2016,1,1,2
Suriname,Guadeloupe,2016,3,2,5
Sweden,Czech Republic,2016,1,1,2
Switzerland,Bosnia and Herzegovina,2016,0,2,2
Tajikistan,Kyrgyzstan,2016,0,1,1
Togo,Tunisia,2016,0,0,0
Uganda,Burkina Faso,2016,0,0,0
United Arab Emirates,Saudi Arabia,2016,1,1,2
Uruguay,Peru,2016,1,0,1
United States,Guatemala,2016,4,0,4
Uzbekistan,Bahrain,2016,1,0,1
Venezuela,Chile,2016,1,4,5
United States Virgin Islands,Grenada,2016,1,2,3
Martinique,Panama,2016,0,2,2
Hungary,Ivory Coast,2016,0,0,0
Galicia,Venezuela,2016,1,1,2
Botswana,Lesotho,2016,2,1,3
England,Turkey,2016,2,1,3
Puerto Rico,United States,2016,1,3,4
Romania,DR Congo,2016,1,1,2
Serbia,Cyprus,2016,2,1,3
Azerbaijan,Andorra,2016,0,0,0
Croatia,Moldova,2016,1,0,1
Czech Republic,Malta,2016,6,0,6
England,Australia,2016,2,1,3
Republic of Ireland,Netherlands,2016,1,1,2
Morocco,Congo,2016,2,0,2
Nigeria,Mali,2016,1,0,1
Northern Ireland,Belarus,2016,3,0,3
Slovakia,Georgia,2016,3,1,4
Togo,Zambia,2016,1,0,1
Corsica,Basque Country,2016,1,1,2
Myanmar,Malaysia,2016,0,0,0
Costa Rica,Venezuela,2016,2,1,3
El Salvador,Peru,2016,1,3,4
Gabon,Mauritania,2016,0,2,2
Guatemala,Armenia,2016,1,7,8
Mexico,Paraguay,2016,1,0,1
New Zealand,Fiji,2016,3,1,4
Rwanda,Senegal,2016,0,2,2
Switzerland,Belgium,2016,1,2,3
Vanuatu,Solomon Islands,2016,0,1,1
Albania,Qatar,2016,3,1,4
Azerbaijan,North Macedonia,2016,1,3,4
Bosnia and Herzegovina,Spain,2016,1,3,4
Cambodia,Timor-Leste,2016,2,0,2
Germany,Slovakia,2016,1,3,4
Italy,Scotland,2016,1,0,1
Kenya,Tanzania,2016,1,1,2
Laos,Nepal,2016,1,1,2
Lithuania,Estonia,2016,2,0,2
Papua New Guinea,New Caledonia,2016,1,1,2
Portugal,Norway,2016,3,0,3
Romania,Ukraine,2016,3,4,7
Tahiti,Samoa,2016,4,0,4
Turkey,Montenegro,2016,1,0,1
Abkhazia,Chagos Islands,2016,9,0,9
Iraqi Kurdistan,Székely Land,2016,3,0,3
Padania,Northern Cyprus,2016,1,2,3
Sápmi,Somaliland,2016,5,0,5
France,Cameroon,2016,3,2,5
Gambia,Zambia,2016,0,0,0
Sweden,Slovenia,2016,0,0,0
Chagos Islands,Western Armenia,2016,0,12,12
United Koreans in Japan,Székely Land,2016,1,0,1
Raetia,Padania,2016,0,6,6
Sápmi,Panjab,2016,0,1,1
Austria,Malta,2016,2,1,3
Republic of Ireland,Belarus,2016,1,2,3
Kenya,Sudan,2016,1,1,2
Luxembourg,Nigeria,2016,1,3,4
Serbia,Israel,2016,3,1,4
Solomon Islands,Fiji,2016,0,1,1
Vanuatu,New Zealand,2016,0,5,5
Vietnam,Syria,2016,2,0,2
Zimbabwe,Uganda,2016,2,0,2
Abkhazia,Western Armenia,2016,1,0,1
United Koreans in Japan,Iraqi Kurdistan,2016,0,3,3
Northern Cyprus,Raetia,2016,7,0,7
Somaliland,Panjab,2016,0,5,5
Belgium,Finland,2016,1,1,2
Curaçao,Guyana,2016,5,2,7
Czech Republic,Russia,2016,2,1,3
El Salvador,Armenia,2016,0,4,4
Estonia,Andorra,2016,2,0,2
Grenada,Puerto Rico,2016,3,3,6
Latvia,Lithuania,2016,2,1,3
Martinique,Guadeloupe,2016,2,0,2
New Caledonia,Samoa,2016,7,0,7
Norway,Iceland,2016,3,2,5
Papua New Guinea,Tahiti,2016,2,2,4
Poland,Netherlands,2016,1,2,3
Spain,South Korea,2016,6,1,7
Saint Kitts and Nevis,Suriname,2016,1,0,1
United Koreans in Japan,Northern Cyprus,2016,1,1,2
Abkhazia,Sápmi,2016,2,0,2
England,Portugal,2016,1,0,1
Laos,India,2016,0,1,1
North Macedonia,Iran,2016,1,3,4
Malaysia,Timor-Leste,2016,3,0,3
Maldives,Yemen,2016,0,2,2
Seychelles,Algeria,2016,0,2,2
Tajikistan,Bangladesh,2016,5,0,5
Iraqi Kurdistan,Padania,2016,2,2,4
Western Armenia,Panjab,2016,2,3,5
Chagos Islands,Somaliland,2016,2,3,5
Székely Land,Raetia,2016,7,0,7
Albania,Ukraine,2016,1,3,4
Azerbaijan,Canada,2016,1,1,2
Bosnia and Herzegovina,Denmark,2016,2,2,4
Myanmar,Singapore,2016,0,1,1
China PR,Trinidad and Tobago,2016,4,2,6
Djibouti,Tunisia,2016,0,3,3
Faroe Islands,Kosovo,2016,0,2,2
Japan,Bulgaria,2016,7,2,9
Libya,Morocco,2016,1,1,2
Mauritania,Cameroon,2016,0,1,1
Romania,Georgia,2016,5,1,6
Sierra Leone,Sudan,2016,1,0,1
Switzerland,Moldova,2016,2,1,3
Thailand,Syria,2016,2,2,4
United Arab Emirates,Jordan,2016,1,3,4
United States,Colombia,2016,0,2,2
Vietnam,Hong Kong,2016,2,2,4
United Koreans in Japan,Sápmi,2016,1,2,3
Iraqi Kurdistan,Western Armenia,2016,0,0,0
Chagos Islands,Raetia,2016,3,3,6
Somaliland,Székely Land,2016,7,0,7
Australia,Greece,2016,1,0,1
Austria,Netherlands,2016,0,2,2
Botswana,Uganda,2016,1,2,3
Brazil,Ecuador,2016,0,0,0
Costa Rica,Paraguay,2016,0,0,0
Croatia,San Marino,2016,10,0,10
Estonia,Latvia,2016,0,0,0
Fiji,Vanuatu,2016,2,3,5
France,Scotland,2016,3,0,3
Gambia,South Africa,2016,0,4,4
Germany,Hungary,2016,2,0,2
Guadeloupe,Dominica,2016,2,1,3
Haiti,Peru,2016,0,1,1
Ivory Coast,Gabon,2016,2,1,3
New Zealand,Solomon Islands,2016,1,0,1
Rwanda,Mozambique,2016,2,3,5
Slovakia,Northern Ireland,2016,0,0,0
South Sudan,Mali,2016,0,3,3
Tanzania,Egypt,2016,0,2,2
United States Virgin Islands,Guyana,2016,0,7,7
Abkhazia,Northern Cyprus,2016,2,0,2
Padania,Panjab,2016,1,0,1
United Koreans in Japan,Iraqi Kurdistan,2016,1,1,2
Sápmi,Western Armenia,2016,3,0,3
Belgium,Norway,2016,3,2,5
Central African Republic,Angola,2016,3,0,3
Comoros,Burkina Faso,2016,0,1,1
Czech Republic,South Korea,2016,1,2,3
Jamaica,Venezuela,2016,0,1,1
Kenya,Congo,2016,2,1,3
Lesotho,Ethiopia,2016,1,2,3
Liberia,Togo,2016,2,2,4
Madagascar,DR Congo,2016,1,6,7
Mauritius,Ghana,2016,0,2,2
Mexico,Uruguay,2016,3,1,4
Papua New Guinea,Samoa,2016,8,0,8
Russia,Serbia,2016,1,1,2
Slovenia,Turkey,2016,0,1,1
Eswatini,Guinea,2016,1,0,1
Sweden,Wales,2016,3,0,3
Tahiti,New Caledonia,2016,1,1,2
Thailand,Jordan,2016,2,0,2
United Arab Emirates,Syria,2016,0,1,1
Zimbabwe,Malawi,2016,3,0,3
Padania,Northern Cyprus,2016,0,2,2
Abkhazia,Panjab,2016,1,1,2
Argentina,Chile,2016,2,1,3
Myanmar,Hong Kong,2016,3,0,3
Iceland,Liechtenstein,2016,4,0,4
Italy,Finland,2016,2,0,2
Malaysia,Timor-Leste,2016,3,0,3
Panama,Bolivia,2016,2,1,3
Poland,Lithuania,2016,0,0,0
Singapore,Vietnam,2016,0,3,3
Australia,Greece,2016,1,2,3
Bangladesh,Tajikistan,2016,0,1,1
Bulgaria,Denmark,2016,0,4,4
Cambodia,Taiwan,2016,2,0,2
Canada,Uzbekistan,2016,2,1,3
China PR,Kazakhstan,2016,0,1,1
Colombia,Paraguay,2016,2,1,3
Curaçao,United States Virgin Islands,2016,7,0,7
Dominican Republic,French Guiana,2016,2,1,3
India,Laos,2016,6,1,7
Iran,Kyrgyzstan,2016,6,0,6
Japan,Bosnia and Herzegovina,2016,1,2,3
Spain,Georgia,2016,0,1,1
Saint Vincent and the Grenadines,Saint Kitts and Nevis,2016,0,1,1
United States,Costa Rica,2016,4,0,4
Yemen,Maldives,2016,2,0,2
Brazil,Haiti,2016,7,1,8
Ecuador,Peru,2016,2,2,4
New Zealand,New Caledonia,2016,1,0,1
Papua New Guinea,Solomon Islands,2016,2,1,3
Portugal,Estonia,2016,7,0,7
Mexico,Jamaica,2016,2,0,2
Uruguay,Venezuela,2016,0,1,1
Argentina,Panama,2016,5,0,5
Chile,Bolivia,2016,2,1,3
France,Romania,2016,2,1,3
Albania,Switzerland,2016,0,1,1
Colombia,Costa Rica,2016,2,3,5
England,Russia,2016,1,1,2
Papua New Guinea,New Zealand,2016,0,0,0
Seychelles,Madagascar,2016,0,1,1
United States,Paraguay,2016,1,0,1
Wales,Slovakia,2016,2,1,3
Zimbabwe,Eswatini,2016,2,2,4
Benin,Equatorial Guinea,2016,2,1,3
Brazil,Peru,2016,0,1,1
Ecuador,Haiti,2016,4,0,4
Germany,Ukraine,2016,2,0,2
Lesotho,Mauritius,2016,3,0,3
Malawi,Angola,2016,3,0,3
Poland,Northern Ireland,2016,1,0,1
Turkey,Croatia,2016,0,1,1
Belgium,Italy,2016,0,2,2
Republic of Ireland,Sweden,2016,1,1,2
Madagascar,Zimbabwe,2016,0,0,0
Mexico,Venezuela,2016,1,1,2
Spain,Czech Republic,2016,1,0,1
Eswatini,Seychelles,2016,4,0,4
Uruguay,Jamaica,2016,3,0,3
Angola,Lesotho,2016,0,2,2
Argentina,Bolivia,2016,3,0,3
Austria,Hungary,2016,0,2,2
Chile,Panama,2016,4,2,6
Mauritius,Malawi,2016,0,1,1
Portugal,Iceland,2016,1,1,2
France,Albania,2016,2,0,2
Romania,Switzerland,2016,1,1,2
Russia,Slovakia,2016,1,2,3
Eswatini,Madagascar,2016,1,0,1
Zimbabwe,Seychelles,2016,5,0,5
Angola,Mauritius,2016,0,2,2
England,Wales,2016,2,1,3
Germany,Poland,2016,0,0,0
Malawi,Lesotho,2016,0,1,1
Ukraine,Northern Ireland,2016,0,2,2
United States,Ecuador,2016,2,1,3
Czech Republic,Croatia,2016,2,2,4
Italy,Sweden,2016,1,0,1
Peru,Colombia,2016,0,0,0
Spain,Turkey,2016,3,0,3
Argentina,Venezuela,2016,4,1,5
Belgium,Republic of Ireland,2016,3,0,3
Iceland,Hungary,2016,1,1,2
Mexico,Chile,2016,0,7,7
Namibia,Botswana,2016,1,1,2
Portugal,Austria,2016,0,0,0
South Africa,Lesotho,2016,1,1,2
DR Congo,Mozambique,2016,1,0,1
France,Switzerland,2016,0,0,0
French Guiana,Bermuda,2016,3,0,3
Romania,Albania,2016,0,1,1
Zambia,Eswatini,2016,0,0,0
Russia,Wales,2016,0,3,3
Slovakia,England,2016,0,0,0
Croatia,Spain,2016,2,1,3
Czech Republic,Turkey,2016,0,2,2
Lesotho,Zambia,2016,2,3,5
Namibia,Mozambique,2016,3,0,3
Northern Ireland,Germany,2016,0,1,1
Ukraine,Poland,2016,0,1,1
United States,Argentina,2016,0,4,4
Botswana,DR Congo,2016,0,0,0
Colombia,Chile,2016,0,2,2
Hungary,Portugal,2016,3,3,6
Iceland,Austria,2016,2,1,3
Italy,Republic of Ireland,2016,0,1,1
New Caledonia,Malaysia,2016,1,2,3
South Africa,Eswatini,2016,5,1,6
Sweden,Belgium,2016,0,1,1
Namibia,Zambia,2016,1,0,1
Croatia,Portugal,2016,0,1,1
South Africa,Botswana,2016,3,2,5
Eswatini,DR Congo,2016,1,0,1
Switzerland,Poland,2016,1,1,2
United States,Colombia,2016,0,1,1
Wales,Northern Ireland,2016,1,0,1
Argentina,Chile,2016,0,0,0
Fiji,Malaysia,2016,1,1,2
France,Republic of Ireland,2016,2,1,3
Germany,Slovakia,2016,3,0,3
Hungary,Belgium,2016,0,4,4
England,Iceland,2016,1,2,3
Italy,Spain,2016,2,0,2
Macau,Mongolia,2016,2,2,4
Poland,Portugal,2016,1,1,2
Wales,Belgium,2016,3,1,4
Germany,Italy,2016,1,1,2
Mongolia,Taiwan,2016,0,2,2
Northern Mariana Islands,Macau,2016,1,3,4
France,Iceland,2016,5,2,7
Northern Mariana Islands,Mongolia,2016,0,8,8
Portugal,Wales,2016,2,0,2
France,Germany,2016,2,0,2
France,Portugal,2016,0,1,1
Uzbekistan,Iraq,2016,2,1,3
Cambodia,Singapore,2016,2,1,3
Oman,Turkmenistan,2016,1,0,1
Qatar,Iraq,2016,2,1,3
Bhutan,India,2016,0,3,3
Jordan,Qatar,2016,2,3,5
Iraq,North Korea,2016,1,1,2
Honduras,Nicaragua,2016,1,0,1
North Korea,United Arab Emirates,2016,2,0,2
Saudi Arabia,Laos,2016,4,0,4
Uzbekistan,Burkina Faso,2016,1,0,1
Barawa,Tamil Eelam,2016,0,5,5
Barawa,Chagos Islands,2016,2,3,5
Tajikistan,Syria,2016,0,0,0
Chagos Islands,Tamil Eelam,2016,1,5,6
Dominican Republic,Puerto Rico,2016,5,0,5
Chagos Islands,Tamil Eelam,2016,1,5,6
Egypt,Guinea,2016,1,1,2
Kyrgyzstan,Kazakhstan,2016,2,0,2
Uganda,Kenya,2016,0,0,0
Albania,Morocco,2016,0,0,0
Czech Republic,Armenia,2016,3,0,3
Denmark,Liechtenstein,2016,5,0,5
Estonia,Malta,2016,1,1,2
Germany,Finland,2016,2,0,2
Republic of Ireland,Oman,2016,4,0,4
Lebanon,Jordan,2016,1,1,2
Norway,Belarus,2016,0,1,1
Turkey,Russia,2016,0,0,0
Argentina,Uruguay,2016,1,0,1
Australia,Iraq,2016,2,0,2
Bahrain,Singapore,2016,3,1,4
Belgium,Spain,2016,0,2,2
Bolivia,Peru,2016,0,3,3
Colombia,Venezuela,2016,2,0,2
Ecuador,Brazil,2016,0,3,3
Hong Kong,Cambodia,2016,4,2,6
Iran,Qatar,2016,2,0,2
Italy,France,2016,1,3,4
Japan,United Arab Emirates,2016,1,2,3
South Korea,China PR,2016,3,2,5
Maldives,Bangladesh,2016,5,0,5
Netherlands,Greece,2016,1,2,3
Paraguay,Chile,2016,2,1,3
Portugal,Gibraltar,2016,5,0,5
Saudi Arabia,Thailand,2016,1,0,1
Uzbekistan,Syria,2016,1,0,1
El Salvador,Mexico,2016,1,3,4
Haiti,Costa Rica,2016,0,1,1
Honduras,Canada,2016,2,1,3
Latvia,Luxembourg,2016,3,1,4
Panama,Jamaica,2016,2,0,2
South Africa,Mauritania,2016,1,1,2
Saint Vincent and the Grenadines,United States,2016,0,6,6
Sudan,Gabon,2016,1,2,3
Trinidad and Tobago,Guatemala,2016,2,2,4
Angola,Madagascar,2016,1,1,2
Cameroon,Gambia,2016,2,0,2
Cape Verde,Libya,2016,0,1,1
Ethiopia,Seychelles,2016,2,1,3
Ghana,Rwanda,2016,1,1,2
India,Puerto Rico,2016,4,1,5
Ivory Coast,Sierra Leone,2016,1,1,2
Mozambique,Mauritius,2016,1,0,1
Nigeria,Tanzania,2016,1,0,1
Senegal,Namibia,2016,2,0,2
Algeria,Lesotho,2016,6,0,6
Bahrain,Jordan,2016,0,0,0
Burkina Faso,Botswana,2016,2,1,3
Congo,Guinea-Bissau,2016,1,0,1
DR Congo,Central African Republic,2016,4,1,5
Czech Republic,Northern Ireland,2016,0,0,0
Denmark,Armenia,2016,1,0,1
Equatorial Guinea,South Sudan,2016,4,0,4
Kazakhstan,Poland,2016,2,2,4
Lithuania,Slovenia,2016,2,2,4
Malawi,Eswatini,2016,1,0,1
Malta,Scotland,2016,1,5,6
Norway,Germany,2016,0,3,3
Romania,Montenegro,2016,1,1,2
San Marino,Azerbaijan,2016,0,1,1
Slovakia,England,2016,0,1,1
Tunisia,Liberia,2016,4,1,5
Uganda,Comoros,2016,1,0,1
Zambia,Kenya,2016,1,1,2
Albania,North Macedonia,2016,2,1,3
Croatia,Turkey,2016,1,1,2
Finland,Kosovo,2016,1,1,2
Georgia,Austria,2016,1,2,3
Israel,Italy,2016,1,3,4
Lebanon,Afghanistan,2016,2,0,2
Serbia,Republic of Ireland,2016,2,2,4
Spain,Liechtenstein,2016,8,0,8
Ukraine,Iceland,2016,1,1,2
Wales,Moldova,2016,4,0,4
Andorra,Latvia,2016,0,1,1
Bangladesh,Bhutan,2016,0,0,0
Belarus,France,2016,0,0,0
Bosnia and Herzegovina,Estonia,2016,5,0,5
Brazil,Colombia,2016,2,1,3
Bulgaria,Luxembourg,2016,4,3,7
Cameroon,Gabon,2016,2,1,3
Canada,El Salvador,2016,3,1,4
Chile,Bolivia,2016,3,0,3
China PR,Iran,2016,0,0,0
Costa Rica,Panama,2016,3,1,4
Cyprus,Belgium,2016,0,3,3
Faroe Islands,Hungary,2016,0,0,0
Gibraltar,Greece,2016,1,4,5
Indonesia,Malaysia,2016,3,0,3
Iraq,Saudi Arabia,2016,1,2,3
Jamaica,Haiti,2016,0,2,2
Kyrgyzstan,Philippines,2016,1,2,3
Maldives,Laos,2016,4,0,4
Mexico,Honduras,2016,0,0,0
Palestine,Tajikistan,2016,1,1,2
Peru,Ecuador,2016,2,1,3
Qatar,Uzbekistan,2016,0,1,1
Russia,Ghana,2016,1,0,1
South Africa,Egypt,2016,1,0,1
Sweden,Netherlands,2016,1,1,2
Switzerland,Portugal,2016,2,0,2
Syria,South Korea,2016,0,0,0
Thailand,Japan,2016,0,2,2
United Arab Emirates,Australia,2016,0,1,1
Uruguay,Paraguay,2016,4,0,4
United States,Trinidad and Tobago,2016,4,0,4
Venezuela,Argentina,2016,2,2,4
Qatar,Serbia,2016,3,0,3
Botswana,Angola,2016,1,1,2
DR Congo,Kenya,2016,0,1,1
Togo,Uganda,2016,1,0,1
Curaçao,Antigua and Barbuda,2016,3,0,3
Solomon Islands,New Caledonia,2016,0,3,3
Tajikistan,Palestine,2016,3,3,6
Trinidad and Tobago,Dominican Republic,2016,4,0,4
Austria,Wales,2016,2,2,4
Brazil,Bolivia,2016,5,0,5
Cambodia,Hong Kong,2016,0,2,2
China PR,Syria,2016,0,1,1
Ecuador,Chile,2016,3,0,3
Iceland,Finland,2016,3,2,5
Republic of Ireland,Georgia,2016,1,0,1
Italy,Spain,2016,1,1,2
Japan,Iraq,2016,2,1,3
South Korea,Qatar,2016,3,2,5
Kosovo,Croatia,2016,0,6,6
Kyrgyzstan,Lebanon,2016,0,0,0
Liechtenstein,Albania,2016,0,2,2
North Macedonia,Israel,2016,1,2,3
Mauritania,Canada,2016,0,4,4
Moldova,Serbia,2016,0,3,3
Paraguay,Colombia,2016,0,1,1
Peru,Argentina,2016,2,2,4
Saudi Arabia,Australia,2016,2,2,4
Turkey,Ukraine,2016,2,2,4
United Arab Emirates,Thailand,2016,3,1,4
Uruguay,Venezuela,2016,3,0,3
Uzbekistan,Iran,2016,0,1,1
Vietnam,North Korea,2016,5,2,7
Belgium,Bosnia and Herzegovina,2016,4,0,4
Cuba,United States,2016,0,2,2
Estonia,Gibraltar,2016,4,0,4
France,Bulgaria,2016,4,1,5
Ghana,Uganda,2016,0,0,0
Greece,Cyprus,2016,2,0,2
Hungary,Switzerland,2016,2,3,5
Latvia,Faroe Islands,2016,0,2,2
Luxembourg,Sweden,2016,0,1,1
Netherlands,Belarus,2016,4,1,5
Oman,Jordan,2016,1,1,2
Philippines,Bahrain,2016,1,3,4
Portugal,Andorra,2016,6,0,6
Singapore,Malaysia,2016,0,0,0
Armenia,Romania,2016,0,5,5
Azerbaijan,Norway,2016,1,0,1
Belize,Honduras,2016,1,2,3
Burkina Faso,South Africa,2016,1,1,2
DR Congo,Libya,2016,4,0,4
Dominican Republic,Martinique,2016,1,2,3
England,Malta,2016,2,0,2
French Guiana,Saint Kitts and Nevis,2016,1,0,1
Gabon,Morocco,2016,0,0,0
Germany,Czech Republic,2016,3,0,3
Ivory Coast,Mali,2016,3,1,4
Mexico,New Zealand,2016,2,1,3
Montenegro,Kazakhstan,2016,5,0,5
Northern Ireland,San Marino,2016,4,0,4
Poland,Denmark,2016,3,2,5
Scotland,Lithuania,2016,1,1,2
Senegal,Cape Verde,2016,2,0,2
Slovenia,Slovakia,2016,1,0,1
Solomon Islands,New Caledonia,2016,0,1,1
Suriname,Guyana,2016,3,2,5
Taiwan,Timor-Leste,2016,2,1,3
Albania,Spain,2016,0,2,2
Algeria,Cameroon,2016,1,1,2
Cambodia,Sri Lanka,2016,4,0,4
Congo,Egypt,2016,1,2,3
Finland,Croatia,2016,0,1,1
Iceland,Turkey,2016,2,0,2
Indonesia,Vietnam,2016,2,2,4
Israel,Liechtenstein,2016,2,1,3
North Macedonia,Italy,2016,2,3,5
Moldova,Republic of Ireland,2016,1,3,4
Russia,Costa Rica,2016,3,4,7
Serbia,Austria,2016,3,2,5
Togo,Mozambique,2016,2,0,2
Tunisia,Guinea,2016,2,0,2
Ukraine,Kosovo,2016,3,0,3
Wales,Georgia,2016,1,1,2
Zambia,Nigeria,2016,1,2,3
Andorra,Switzerland,2016,1,2,3
Belarus,Luxembourg,2016,1,1,2
Bhutan,Bangladesh,2016,3,1,4
Bosnia and Herzegovina,Cyprus,2016,2,0,2
Estonia,Greece,2016,0,2,2
Faroe Islands,Portugal,2016,0,6,6
Gibraltar,Belgium,2016,0,6,6
Latvia,Hungary,2016,0,2,2
Netherlands,France,2016,0,1,1
Philippines,North Korea,2016,1,3,4
Sweden,Bulgaria,2016,3,0,3
Argentina,Paraguay,2016,0,1,1
Australia,Japan,2016,1,1,2
Bolivia,Ecuador,2016,2,2,4
Chile,Peru,2016,2,1,3
Colombia,Uruguay,2016,2,2,4
Czech Republic,Azerbaijan,2016,0,0,0
Denmark,Montenegro,2016,0,1,1
Germany,Northern Ireland,2016,2,0,2
Hong Kong,Singapore,2016,2,0,2
Iran,South Korea,2016,1,0,1
Iraq,Thailand,2016,4,0,4
Kazakhstan,Romania,2016,0,0,0
Kyrgyzstan,Turkmenistan,2016,1,0,1
Laos,Maldives,2016,1,1,2
Lebanon,Equatorial Guinea,2016,1,1,2
Lithuania,Malta,2016,2,0,2
Malaysia,Afghanistan,2016,1,1,2
Mexico,Panama,2016,1,0,1
Morocco,Canada,2016,4,0,4
Norway,San Marino,2016,4,1,5
Oman,Bahrain,2016,2,2,4
Poland,Armenia,2016,2,1,3
Puerto Rico,Curaçao,2016,2,4,6
Qatar,Syria,2016,1,0,1
Saudi Arabia,United Arab Emirates,2016,3,0,3
Slovakia,Scotland,2016,3,0,3
Slovenia,England,2016,0,0,0
South Africa,Ghana,2016,1,1,2
Uzbekistan,China PR,2016,2,0,2
Venezuela,Brazil,2016,0,2,2
Brunei,Timor-Leste,2016,2,1,3
Cambodia,Laos,2016,2,1,3
Cambodia,Brunei,2016,3,0,3
Timor-Leste,Laos,2016,1,2,3
Cambodia,Timor-Leste,2016,3,2,5
Laos,Brunei,2016,4,3,7
Brunei,Timor-Leste,2016,4,0,4
Macau,Mongolia,2016,2,1,3
Sri Lanka,Laos,2016,1,2,3
Myanmar,Indonesia,2016,0,0,0
Timor-Leste,Nepal,2016,0,0,0
Zimbabwe,Zambia,2016,1,0,1
Hong Kong,Guam,2016,3,2,5
Jordan,Iraq,2016,0,0,0
North Korea,Taiwan,2016,2,0,2
Laos,Macau,2016,1,4,5
Mongolia,Sri Lanka,2016,2,0,2
Tahiti,Solomon Islands,2016,3,0,3
Nepal,Brunei,2016,3,0,3
Uganda,Zambia,2016,0,1,1
Vietnam,Indonesia,2016,3,2,5
Greece,Belarus,2016,0,1,1
Guam,North Korea,2016,0,2,2
Haiti,French Guiana,2016,2,5,7
Hong Kong,Taiwan,2016,4,2,6
Mongolia,Laos,2016,0,3,3
Netherlands,Belgium,2016,1,1,2
Philippines,Kyrgyzstan,2016,1,0,1
Sri Lanka,Macau,2016,1,1,2
Syria,Singapore,2016,2,0,2
Tajikistan,Turkmenistan,2016,3,0,3
United Arab Emirates,Bahrain,2016,2,0,2
Brazil,Argentina,2016,3,0,3
Colombia,Chile,2016,0,0,0
Iran,Papua New Guinea,2016,8,1,9
Lebanon,Palestine,2016,1,1,2
Paraguay,Peru,2016,1,4,5
Qatar,Russia,2016,2,1,3
Uruguay,Ecuador,2016,2,1,3
Uzbekistan,Jordan,2016,1,0,1
Venezuela,Bolivia,2016,5,0,5
Armenia,Montenegro,2016,3,2,5
Czech Republic,Norway,2016,2,1,3
Denmark,Kazakhstan,2016,4,1,5
England,Scotland,2016,3,0,3
France,Sweden,2016,2,1,3
Honduras,Panama,2016,0,1,1
Japan,Oman,2016,4,0,4
South Korea,Canada,2016,2,0,2
Libya,Tunisia,2016,0,1,1
Malta,Slovenia,2016,0,1,1
Northern Ireland,Azerbaijan,2016,4,0,4
Romania,Poland,2016,0,3,3
San Marino,Germany,2016,0,8,8
Slovakia,Lithuania,2016,4,0,4
Togo,Comoros,2016,2,2,4
Trinidad and Tobago,Costa Rica,2016,0,2,2
United States,Mexico,2016,1,2,3
Albania,Israel,2016,0,3,3
Austria,Republic of Ireland,2016,0,1,1
Cameroon,Zambia,2016,1,1,2
Cape Verde,Burkina Faso,2016,0,2,2
Croatia,Iceland,2016,2,0,2
Georgia,Moldova,2016,1,1,2
Hong Kong,North Korea,2016,0,1,1
Kenya,Mozambique,2016,1,0,1
Liechtenstein,Italy,2016,0,4,4
Macau,Brunei,2016,1,1,2
Mali,Gabon,2016,0,0,0
Morocco,Ivory Coast,2016,0,0,0
Nepal,Laos,2016,2,2,4
New Zealand,New Caledonia,2016,2,0,2
Nigeria,Algeria,2016,3,1,4
Spain,North Macedonia,2016,4,0,4
Turkey,Kosovo,2016,2,0,2
Uganda,Congo,2016,1,0,1
Ukraine,Finland,2016,1,0,1
Wales,Serbia,2016,1,1,2
Belgium,Estonia,2016,8,1,9
Bulgaria,Belarus,2016,1,0,1
Cyprus,Gibraltar,2016,3,1,4
Egypt,Ghana,2016,2,0,2
Greece,Bosnia and Herzegovina,2016,1,1,2
Guinea,DR Congo,2016,1,2,3
Hungary,Andorra,2016,4,0,4
Jamaica,Suriname,2016,1,0,1
Luxembourg,Netherlands,2016,1,3,4
Portugal,Latvia,2016,4,1,5
Singapore,Cambodia,2016,1,0,1
Solomon Islands,Tahiti,2016,1,0,1
Saint Kitts and Nevis,Haiti,2016,0,2,2
Switzerland,Faroe Islands,2016,2,0,2
Tajikistan,Afghanistan,2016,1,0,1
Zimbabwe,Tanzania,2016,3,0,3
Myanmar,Oman,2016,0,3,3
Laos,Brunei,2016,3,2,5
Malaysia,Papua New Guinea,2016,2,1,3
Poland,Slovenia,2016,1,1,2
Argentina,Colombia,2016,3,0,3
Austria,Slovakia,2016,0,0,0
Bahrain,Kyrgyzstan,2016,0,0,0
Bolivia,Paraguay,2016,1,0,1
Chile,Uruguay,2016,3,1,4
China PR,Qatar,2016,0,0,0
Costa Rica,United States,2016,4,0,4
Czech Republic,Denmark,2016,1,1,2
Ecuador,Venezuela,2016,3,0,3
England,Spain,2016,2,2,4
France,Ivory Coast,2016,0,0,0
Gabon,Comoros,2016,1,1,2
Honduras,Trinidad and Tobago,2016,3,1,4
Italy,Germany,2016,0,0,0
Japan,Saudi Arabia,2016,2,1,3
Jordan,Lebanon,2016,0,0,0
Kenya,Liberia,2016,1,0,1
South Korea,Uzbekistan,2016,2,1,3
Malta,Iceland,2016,0,2,2
Morocco,Togo,2016,2,1,3
Mozambique,South Africa,2016,1,1,2
Nepal,Macau,2016,1,0,1
New Caledonia,New Zealand,2016,0,0,0
Northern Ireland,Croatia,2016,0,3,3
Panama,Mexico,2016,0,0,0
Peru,Brazil,2016,0,2,2
Russia,Romania,2016,1,0,1
Syria,Iran,2016,0,0,0
Thailand,Australia,2016,2,2,4
Tunisia,Mauritania,2016,0,0,0
Ukraine,Serbia,2016,2,0,2
United Arab Emirates,Iraq,2016,2,0,2
Philippines,Singapore,2016,0,0,0
Saint Kitts and Nevis,Estonia,2016,1,1,2
Thailand,Indonesia,2016,4,2,6
Myanmar,Vietnam,2016,1,2,3
Malaysia,Cambodia,2016,3,2,5
Antigua and Barbuda,Estonia,2016,0,1,1
Philippines,Indonesia,2016,2,2,4
Thailand,Singapore,2016,1,0,1
Myanmar,Cambodia,2016,3,1,4
Malaysia,Vietnam,2016,0,1,1
Philippines,Thailand,2016,0,1,1
Singapore,Indonesia,2016,1,2,3
Myanmar,Malaysia,2016,1,0,1
Vietnam,Cambodia,2016,2,1,3
Indonesia,Vietnam,2016,2,1,3
Myanmar,Thailand,2016,0,2,2
Vietnam,Indonesia,2016,2,2,4
Thailand,Myanmar,2016,4,0,4
Indonesia,Thailand,2016,2,1,3
Thailand,Indonesia,2016,2,0,2
Ivory Coast,Zimbabwe,2016,0,0,0
Nicaragua,Trinidad and Tobago,2016,2,1,3
Catalonia,Tunisia,2016,3,3,6
Nicaragua,Trinidad and Tobago,2016,1,3,4
Basque Country,Tunisia,2016,3,1,4
Trinidad and Tobago,Suriname,2017,1,2,3
Tunisia,Uganda,2017,2,0,2
Cameroon,DR Congo,2017,2,0,2
Suriname,Haiti,2017,2,4,6
Algeria,Mauritania,2017,3,1,4
Burkina Faso,Mali,2017,2,1,3
Egypt,Tunisia,2017,1,0,1
Ivory Coast,Sweden,2017,2,1,3
Libya,Senegal,2017,1,2,3
Trinidad and Tobago,Haiti,2017,3,4,7
Morocco,Finland,2017,0,1,1
Algeria,Mauritania,2017,6,0,6
Cameroon,Zimbabwe,2017,1,1,2
China PR,Iceland,2017,0,2,2
Chile,Croatia,2017,1,1,2
Congo,Senegal,2017,0,2,2
Ivory Coast,Uganda,2017,3,0,3
Honduras,Nicaragua,2017,2,1,3
Burkina Faso,Cameroon,2017,1,1,2
Cambodia,Saudi Arabia,2017,2,7,9
China PR,Croatia,2017,1,1,2
Gabon,Guinea-Bissau,2017,1,1,2
Algeria,Zimbabwe,2017,2,2,4
Belize,Costa Rica,2017,0,3,3
El Salvador,Honduras,2017,1,2,3
Iceland,Chile,2017,0,1,1
Tunisia,Senegal,2017,0,2,2
DR Congo,Morocco,2017,1,0,1
Ivory Coast,Togo,2017,0,0,0
El Salvador,Belize,2017,3,1,4
Ghana,Uganda,2017,1,0,1
Mali,Egypt,2017,0,0,0
Qatar,Moldova,2017,1,1,2
Cameroon,Guinea-Bissau,2017,2,1,3
Gabon,Burkina Faso,2017,1,1,2
Algeria,Tunisia,2017,1,2,3
Senegal,Zimbabwe,2017,2,0,2
Ivory Coast,DR Congo,2017,2,2,4
Morocco,Togo,2017,3,1,4
Nicaragua,Belize,2017,3,1,4
Egypt,Uganda,2017,1,0,1
Ghana,Mali,2017,1,0,1
Belize,Honduras,2017,0,1,1
Bermuda,Canada,2017,2,4,6
El Salvador,Nicaragua,2017,1,0,1
Gabon,Cameroon,2017,0,0,0
Guinea-Bissau,Burkina Faso,2017,0,2,2
Panama,Costa Rica,2017,1,0,1
Senegal,Algeria,2017,2,2,4
Uzbekistan,Georgia,2017,2,2,4
Zimbabwe,Tunisia,2017,2,4,6
Morocco,Ivory Coast,2017,1,0,1
Togo,DR Congo,2017,1,3,4
Egypt,Ghana,2017,1,0,1
Jordan,Georgia,2017,1,0,1
Uganda,Mali,2017,1,1,2
Brazil,Colombia,2017,1,0,1
Burkina Faso,Tunisia,2017,2,0,2
Senegal,Cameroon,2017,0,0,0
DR Congo,Ghana,2017,1,2,3
Egypt,Morocco,2017,1,0,1
United States,Serbia,2017,0,0,0
Burkina Faso,Egypt,2017,1,1,2
Cameroon,Ghana,2017,2,0,2
Burkina Faso,Ghana,2017,1,0,1
Egypt,Cameroon,2017,1,2,3
Mexico,Iceland,2017,1,0,1
Ecuador,Honduras,2017,3,1,4
Qatar,Azerbaijan,2017,1,2,3
Trinidad and Tobago,Barbados,2017,2,0,2
Burundi,Djibouti,2017,7,0,7
Burundi,Djibouti,2017,1,0,1
Honduras,Nicaragua,2017,2,0,2
Iran,Iraq,2017,0,1,1
San Marino,Moldova,2017,0,2,2
Indonesia,Myanmar,2017,1,3,4
Cambodia,India,2017,2,3,5
Curaçao,El Salvador,2017,1,1,2
Cyprus,Kazakhstan,2017,3,1,4
Czech Republic,Lithuania,2017,3,0,3
Djibouti,South Sudan,2017,2,0,2
Germany,England,2017,1,0,1
Philippines,Malaysia,2017,0,0,0
São Tomé and Príncipe,Madagascar,2017,0,1,1
Scotland,Canada,2017,1,1,2
Vietnam,Taiwan,2017,1,1,2
Yemen,Palestine,2017,0,1,1
Afghanistan,Singapore,2017,2,1,3
Argentina,Chile,2017,1,0,1
Bahrain,Tajikistan,2017,1,1,2
China PR,South Korea,2017,1,0,1
Colombia,Bolivia,2017,1,0,1
Iraq,Australia,2017,1,1,2
Jordan,Hong Kong,2017,4,0,4
Kenya,Uganda,2017,1,1,2
Nigeria,Senegal,2017,1,1,2
Papua New Guinea,Tahiti,2017,1,3,4
Paraguay,Ecuador,2017,2,1,3
Qatar,Iran,2017,0,1,1
Syria,Uzbekistan,2017,1,0,1
Thailand,Saudi Arabia,2017,0,3,3
United Arab Emirates,Japan,2017,0,2,2
Uruguay,Brazil,2017,1,4,5
Venezuela,Peru,2017,2,2,4
Austria,Moldova,2017,2,0,2
Comoros,Mauritius,2017,2,0,2
Croatia,Ukraine,2017,1,0,1
Georgia,Serbia,2017,1,2,3
Guinea,Gabon,2017,2,2,4
Republic of Ireland,Wales,2017,0,0,0
Italy,Albania,2017,2,0,2
Kosovo,Iceland,2017,1,2,3
Libya,Togo,2017,0,0,0
Liechtenstein,North Macedonia,2017,0,3,3
Mauritania,Benin,2017,1,0,1
Mexico,Costa Rica,2017,2,0,2
Morocco,Burkina Faso,2017,2,0,2
Russia,Ivory Coast,2017,0,2,2
Spain,Israel,2017,4,1,5
Trinidad and Tobago,Panama,2017,1,0,1
Tunisia,Cameroon,2017,0,1,1
Turkey,Finland,2017,2,0,2
United States,Honduras,2017,6,0,6
Andorra,Faroe Islands,2017,0,0,0
Belgium,Greece,2017,1,1,2
Bosnia and Herzegovina,Gibraltar,2017,5,0,5
Bulgaria,Netherlands,2017,2,0,2
Cyprus,Estonia,2017,0,0,0
Fiji,New Zealand,2017,0,2,2
Luxembourg,France,2017,1,3,4
Mozambique,Angola,2017,2,0,2
Portugal,Hungary,2017,3,0,3
South Africa,Guinea-Bissau,2017,3,1,4
Sweden,Belarus,2017,4,0,4
Switzerland,Latvia,2017,1,0,1
Tanzania,Botswana,2017,2,0,2
Armenia,Kazakhstan,2017,2,0,2
Azerbaijan,Germany,2017,1,4,5
Barbados,Martinique,2017,2,1,3
England,Lithuania,2017,2,0,2
Kenya,DR Congo,2017,2,1,3
Madagascar,São Tomé and Príncipe,2017,3,2,5
Malta,Slovakia,2017,1,3,4
Montenegro,Poland,2017,1,2,3
Northern Ireland,Norway,2017,2,0,2
Romania,Denmark,2017,0,0,0
San Marino,Czech Republic,2017,0,6,6
Scotland,Slovenia,2017,1,0,1
Zimbabwe,Zambia,2017,0,0,0
Central African Republic,Gambia,2017,1,2,3
Ivory Coast,Senegal,2017,1,1,2
Mauritania,Congo,2017,2,1,3
Turkey,Moldova,2017,3,1,4
Afghanistan,Vietnam,2017,1,1,2
Albania,Bosnia and Herzegovina,2017,1,2,3
Australia,United Arab Emirates,2017,2,0,2
Austria,Finland,2017,1,1,2
Bahrain,Singapore,2017,0,0,0
Bolivia,Argentina,2017,2,0,2
Brazil,Paraguay,2017,3,0,3
Myanmar,India,2017,0,1,1
Cameroon,Guinea,2017,1,2,3
Chile,Venezuela,2017,3,1,4
Ecuador,Colombia,2017,0,2,2
Egypt,Togo,2017,3,0,3
Estonia,Croatia,2017,3,0,3
France,Spain,2017,0,2,2
Georgia,Latvia,2017,5,0,5
Guyana,Martinique,2017,0,0,0
Honduras,Costa Rica,2017,1,1,2
Iran,China PR,2017,1,0,1
Republic of Ireland,Iceland,2017,0,1,1
Japan,Thailand,2017,4,0,4
Jordan,Cambodia,2017,7,0,7
South Korea,Syria,2017,1,0,1
Kyrgyzstan,Macau,2017,1,0,1
Lebanon,Hong Kong,2017,2,0,2
Luxembourg,Cape Verde,2017,0,2,2
North Macedonia,Belarus,2017,3,0,3
Maldives,Palestine,2017,0,3,3
Mauritius,Comoros,2017,1,1,2
Morocco,Tunisia,2017,1,0,1
Mozambique,Lesotho,2017,1,0,1
Netherlands,Italy,2017,1,2,3
New Zealand,Fiji,2017,2,0,2
Oman,Bhutan,2017,14,0,14
Panama,United States,2017,1,1,2
Peru,Uruguay,2017,2,1,3
Philippines,Nepal,2017,4,1,5
Portugal,Sweden,2017,2,3,5
Russia,Belgium,2017,3,3,6
Saudi Arabia,Iraq,2017,1,0,1
South Africa,Angola,2017,0,0,0
South Sudan,Djibouti,2017,6,0,6
Tanzania,Burundi,2017,2,1,3
Trinidad and Tobago,Mexico,2017,0,1,1
Uzbekistan,Qatar,2017,1,0,1
Yemen,Tajikistan,2017,2,1,3
Somalia,South Sudan,2017,1,2,3
Madagascar,Malawi,2017,1,0,1
Mauritius,Seychelles,2017,2,1,3
Martinique,Guadeloupe,2017,4,1,5
Malawi,Madagascar,2017,0,1,1
Seychelles,Mauritius,2017,1,1,2
Vatican City,Monaco,2017,0,0,0
South Sudan,Somalia,2017,2,0,2
Burkina Faso,Benin,2017,1,1,2
Saint Kitts and Nevis,Barbados,2017,2,1,3
Senegal,Mauritania,2017,2,0,2
Egypt,Libya,2017,1,0,1
Guadeloupe,Dominica,2017,2,2,4
Benin,Burkina Faso,2017,2,2,4
Fiji,Solomon Islands,2017,1,1,2
Ghana,Benin,2017,1,1,2
Corsica,Nigeria,2017,1,1,2
El Salvador,Honduras,2017,2,2,4
Fiji,Solomon Islands,2017,1,0,1
Mexico,Croatia,2017,1,2,3
Italy,San Marino,2017,8,0,8
Ivory Coast,Benin,2017,1,1,2
Morocco,Netherlands,2017,1,2,3
Iraq,Jordan,2017,1,0,1
Mexico,Republic of Ireland,2017,3,1,4
Nigeria,Togo,2017,3,0,3
Switzerland,Belarus,2017,1,0,1
Chile,Burkina Faso,2017,3,0,3
France,Paraguay,2017,5,0,5
Nicaragua,Bolivia,2017,0,1,1
Northern Ireland,New Zealand,2017,1,0,1
Oman,Syria,2017,1,1,2
Ethiopia,Uganda,2017,0,0,0
Portugal,Cyprus,2017,4,0,4
United States,Venezuela,2017,1,1,2
Armenia,Saint Kitts and Nevis,2017,5,0,5
Gabon,Zambia,2017,0,0,0
Republic of Ireland,Uruguay,2017,3,1,4
Lesotho,Mauritania,2017,1,0,1
Luxembourg,Albania,2017,2,1,3
Montenegro,Iran,2017,1,2,3
Netherlands,Ivory Coast,2017,5,0,5
Togo,Comoros,2017,2,0,2
Northern Cyprus,Kárpátalja,2017,1,0,1
Belgium,Czech Republic,2017,2,1,3
DR Congo,Botswana,2017,2,0,2
Egypt,Libya,2017,1,0,1
Hungary,Russia,2017,0,3,3
North Macedonia,Turkey,2017,0,0,0
Senegal,Uganda,2017,0,0,0
Abkhazia,South Ossetia,2017,2,1,3
Padania,Ellan Vannin,2017,1,0,1
Felvidék,Székely Land,2017,1,0,1
Afghanistan,Maldives,2017,2,1,3
Algeria,Guinea,2017,2,1,3
Bahrain,Palestine,2017,0,2,2
Denmark,Germany,2017,1,1,2
India,Nepal,2017,2,0,2
Israel,Moldova,2017,1,1,2
Malta,Ukraine,2017,1,0,1
Qatar,North Korea,2017,2,2,4
Uzbekistan,Thailand,2017,2,0,2
Northern Cyprus,South Ossetia,2017,8,0,8
Kárpátalja,Abkhazia,2017,2,2,4
Székely Land,Padania,2017,1,1,2
Ellan Vannin,Felvidék,2017,1,0,1
Bolivia,Nicaragua,2017,3,2,5
China PR,Philippines,2017,8,1,9
Fiji,New Caledonia,2017,2,2,4
Finland,Liechtenstein,2017,1,1,2
Georgia,Saint Kitts and Nevis,2017,3,0,3
Hong Kong,Jordan,2017,0,0,0
Iraq,South Korea,2017,0,0,0
Italy,Uruguay,2017,3,0,3
Japan,Syria,2017,1,1,2
Spain,Colombia,2017,2,2,4
United Arab Emirates,Laos,2017,4,0,4
Northern Cyprus,Abkhazia,2017,0,0,0
South Ossetia,Kárpátalja,2017,1,4,5
Ellan Vannin,Székely Land,2017,2,4,6
Padania,Felvidék,2017,2,0,2
Australia,Saudi Arabia,2017,3,2,5
Cambodia,Indonesia,2017,0,2,2
Costa Rica,Panama,2017,0,0,0
Ecuador,Venezuela,2017,1,1,2
Mexico,Honduras,2017,3,0,3
Peru,Paraguay,2017,1,0,1
United States,Trinidad and Tobago,2017,2,0,2
Andorra,Hungary,2017,1,0,1
Argentina,Brazil,2017,1,0,1
Belarus,Bulgaria,2017,2,1,3
Bosnia and Herzegovina,Greece,2017,0,0,0
Estonia,Belgium,2017,0,2,2
Faroe Islands,Switzerland,2017,0,2,2
Gibraltar,Cyprus,2017,1,2,3
Latvia,Portugal,2017,0,3,3
Libya,Seychelles,2017,5,1,6
Netherlands,Luxembourg,2017,5,0,5
Russia,Chile,2017,1,1,2
Solomon Islands,Papua New Guinea,2017,3,2,5
Sudan,Madagascar,2017,1,3,4
Sweden,France,2017,2,1,3
South Ossetia,Felvidék,2017,0,2,2
Kárpátalja,Ellan Vannin,2017,3,3,6
Northern Cyprus,Székely Land,2017,2,1,3
Padania,Abkhazia,2017,0,0,0
Azerbaijan,Northern Ireland,2017,0,1,1
Burkina Faso,Angola,2017,3,1,4
Burundi,South Sudan,2017,3,0,3
Cameroon,Morocco,2017,1,0,1
DR Congo,Congo,2017,3,1,4
Germany,San Marino,2017,7,0,7
Grenada,Bermuda,2017,1,2,3
Guinea-Bissau,Namibia,2017,1,0,1
Ivory Coast,Guinea,2017,2,3,5
Kazakhstan,Denmark,2017,1,3,4
Lithuania,Slovakia,2017,1,2,3
Malawi,Comoros,2017,1,0,1
Mali,Gabon,2017,2,1,3
Montenegro,Armenia,2017,4,1,5
Niger,Eswatini,2017,0,0,0
Nigeria,South Africa,2017,0,2,2
Norway,Czech Republic,2017,1,1,2
Poland,Romania,2017,3,1,4
Scotland,England,2017,2,2,4
Senegal,Equatorial Guinea,2017,3,0,3
Sierra Leone,Kenya,2017,2,1,3
Singapore,Taiwan,2017,1,2,3
Slovenia,Malta,2017,2,0,2
Tanzania,Lesotho,2017,1,1,2
Zambia,Mozambique,2017,0,1,1
Székely Land,Abkhazia,2017,3,1,4
Northern Cyprus,Padania,2017,1,1,2
Algeria,Togo,2017,1,0,1
Benin,Gambia,2017,1,0,1
Cape Verde,Uganda,2017,0,1,1
Central African Republic,Rwanda,2017,2,1,3
Finland,Ukraine,2017,1,2,3
Ghana,Ethiopia,2017,5,0,5
Iceland,Croatia,2017,1,0,1
Republic of Ireland,Austria,2017,1,1,2
Israel,Albania,2017,0,3,3
Italy,Liechtenstein,2017,5,0,5
Kosovo,Turkey,2017,1,4,5
North Macedonia,Spain,2017,1,2,3
Mexico,United States,2017,1,1,2
Moldova,Georgia,2017,2,2,4
New Caledonia,Fiji,2017,2,1,3
Serbia,Wales,2017,1,1,2
Zimbabwe,Liberia,2017,3,0,3
Belarus,New Zealand,2017,1,0,1
Iran,Uzbekistan,2017,2,0,2
Latvia,Estonia,2017,1,2,3
Australia,Brazil,2017,0,4,4
Bhutan,Maldives,2017,0,2,2
Cambodia,Afghanistan,2017,1,0,1
Cameroon,Colombia,2017,0,4,4
Canada,Curaçao,2017,2,1,3
Costa Rica,Trinidad and Tobago,2017,2,1,3
El Salvador,Ecuador,2017,0,3,3
France,England,2017,3,2,5
Hong Kong,North Korea,2017,1,1,2
India,Kyrgyzstan,2017,1,0,1
Indonesia,Puerto Rico,2017,0,0,0
Iraq,Japan,2017,1,1,2
Macau,Myanmar,2017,0,4,4
Malaysia,Lebanon,2017,1,2,3
Nepal,Yemen,2017,0,0,0
Norway,Sweden,2017,1,1,2
Palestine,Oman,2017,2,1,3
Panama,Honduras,2017,2,2,4
Papua New Guinea,Solomon Islands,2017,1,2,3
Qatar,South Korea,2017,3,2,5
Romania,Chile,2017,3,2,5
Singapore,Argentina,2017,0,6,6
South Africa,Zambia,2017,1,2,3
Syria,China PR,2017,2,2,4
Tajikistan,Philippines,2017,3,4,7
Thailand,United Arab Emirates,2017,1,1,2
Turkmenistan,Bahrain,2017,1,2,3
Vietnam,Jordan,2017,0,0,0
Curaçao,Nicaragua,2017,0,0,0
French Guiana,Barbados,2017,3,0,3
Russia,New Zealand,2017,2,0,2
Cameroon,Chile,2017,0,2,2
Portugal,Mexico,2017,2,2,4
Australia,Germany,2017,2,3,5
Mexico,New Zealand,2017,2,1,3
Russia,Portugal,2017,0,1,1
Cameroon,Australia,2017,1,1,2
Germany,Chile,2017,1,1,2
Jamaica,French Guiana,2017,1,1,2
Martinique,Curaçao,2017,1,2,3
New Zealand,Portugal,2017,0,4,4
Russia,Mexico,2017,1,2,3
Chile,Australia,2017,1,1,2
Germany,Cameroon,2017,3,1,4
Jamaica,Curaçao,2017,1,2,3
Martinique,French Guiana,2017,0,1,1
Mauritius,Angola,2017,0,1,1
Tanzania,Malawi,2017,2,0,2
Menorca,Orkney,2017,1,0,1
Alderney,Jersey,2017,0,3,3
Gotland,Frøya,2017,7,1,8
Western Isles,Greenland,2017,0,3,3
Guernsey,Åland Islands,2017,1,1,2
Saare County,Shetland,2017,4,5,9
Isle of Man,Hitra,2017,5,0,5
Ynys Môn,Falkland Islands,2017,3,0,3
Madagascar,Seychelles,2017,2,0,2
Mozambique,Zimbabwe,2017,0,4,4
Jersey,Menorca,2017,3,3,6
Orkney,Alderney,2017,3,0,3
Gotland,Western Isles,2017,8,0,8
Frøya,Greenland,2017,2,2,4
Shetland,Guernsey,2017,0,3,3
Åland Islands,Saare County,2017,0,0,0
Falkland Islands,Isle of Man,2017,2,5,7
Hitra,Ynys Môn,2017,1,5,6
Angola,Tanzania,2017,0,0,0
Malawi,Mauritius,2017,0,0,0
Menorca,Alderney,2017,6,0,6
Orkney,Jersey,2017,0,3,3
Gotland,Greenland,2017,0,1,1
Frøya,Western Isles,2017,2,4,6
Guernsey,Saare County,2017,1,1,2
Åland Islands,Shetland,2017,2,1,3
Isle of Man,Ynys Môn,2017,4,0,4
Hitra,Falkland Islands,2017,2,1,3
Portugal,Chile,2017,0,0,0
Seychelles,Mozambique,2017,1,2,3
Saint Lucia,Saint Vincent and the Grenadines,2017,2,1,3
Zimbabwe,Madagascar,2017,0,0,0
Germany,Mexico,2017,4,1,5
Malawi,Angola,2017,0,0,0
Tanzania,Mauritius,2017,1,1,2
Falkland Islands,Alderney,2017,0,3,3
Saare County,Frøya,2017,4,2,6
Hitra,Western Isles,2017,1,1,2
Orkney,Shetland,2017,3,1,4
Ynys Môn,Åland Islands,2017,0,2,2
Gotland,Jersey,2017,2,3,5
Greenland,Menorca,2017,1,1,2
Guernsey,Isle of Man,2017,3,4,7
Dominica,Barbados,2017,2,1,3
Mozambique,Madagascar,2017,1,4,5
Zimbabwe,Seychelles,2017,6,0,6
Menorca,Guernsey,2017,0,1,1
Greenland,Isle of Man,2017,0,6,6
Botswana,Zambia,2017,1,2,3
Gambia,Guinea-Bissau,2017,0,0,0
Mexico,Paraguay,2017,2,1,3
Namibia,Lesotho,2017,0,0,0
United States,Ghana,2017,2,1,3
Chile,Germany,2017,0,1,1
Portugal,Mexico,2017,2,1,3
South Africa,Tanzania,2017,0,1,1
Eswatini,Zimbabwe,2017,1,2,3
Barbados,Saint Lucia,2017,1,1,2
Grenada,Saint Vincent and the Grenadines,2017,4,3,7
Namibia,Eswatini,2017,1,0,1
South Africa,Botswana,2017,2,0,2
Saint Lucia,Dominica,2017,0,0,0
Saint Vincent and the Grenadines,Barbados,2017,4,2,6
Lesotho,Zimbabwe,2017,3,4,7
Zambia,Tanzania,2017,4,2,6
Dominica,Saint Vincent and the Grenadines,2017,2,2,4
Grenada,Barbados,2017,0,2,2
French Guiana,Canada,2017,2,4,6
Honduras,Costa Rica,2017,0,1,1
South Africa,Namibia,2017,1,0,1
Tanzania,Lesotho,2017,0,0,0
Guinea-Bissau,Gambia,2017,0,1,1
Martinique,Nicaragua,2017,2,0,2
United States,Panama,2017,1,1,2
Curaçao,Jamaica,2017,0,2,2
Mexico,El Salvador,2017,3,1,4
Zambia,Zimbabwe,2017,1,3,4
Costa Rica,Canada,2017,1,1,2
Honduras,French Guiana,2017,0,0,0
Panama,Nicaragua,2017,2,1,3
United States,Martinique,2017,3,2,5
El Salvador,Curaçao,2017,2,0,2
Mexico,Jamaica,2017,0,0,0
Canada,Honduras,2017,0,0,0
Costa Rica,French Guiana,2017,3,0,3
Thailand,North Korea,2017,3,0,3
South Sudan,Uganda,2017,0,0,0
Panama,Martinique,2017,3,0,3
United States,Nicaragua,2017,3,0,3
Djibouti,Ethiopia,2017,1,5,6
Tanzania,Rwanda,2017,1,1,2
Botswana,South Africa,2017,0,2,2
Comoros,Lesotho,2017,2,0,2
Gambia,Mali,2017,0,0,0
Guinea-Bissau,Guinea,2017,1,3,4
Sierra Leone,Senegal,2017,1,1,2
Burkina Faso,North Korea,2017,3,3,6
Curaçao,Mexico,2017,0,2,2
Jamaica,El Salvador,2017,1,1,2
Madagascar,Mozambique,2017,2,2,4
Mauritius,Angola,2017,0,1,1
Namibia,Zimbabwe,2017,1,0,1
Eswatini,Zambia,2017,0,4,4
Liberia,Mauritania,2017,0,2,2
Togo,Benin,2017,1,1,2
Thailand,Belarus,2017,0,0,0
Costa Rica,Panama,2017,1,0,1
United States,El Salvador,2017,2,0,2
Jamaica,Canada,2017,2,1,3
Mexico,Honduras,2017,1,0,1
United States,Costa Rica,2017,2,0,2
Rwanda,Tanzania,2017,0,0,0
Uganda,South Sudan,2017,5,1,6
South Africa,Botswana,2017,1,0,1
Zambia,Eswatini,2017,3,0,3
Guinea,Guinea-Bissau,2017,7,0,7
Mali,Gambia,2017,4,0,4
Senegal,Sierra Leone,2017,3,1,4
Mexico,Jamaica,2017,0,1,1
Burundi,Sudan,2017,0,0,0
Ethiopia,Djibouti,2017,3,0,3
Angola,Mauritius,2017,3,2,5
Lesotho,Comoros,2017,1,0,1
Mozambique,Madagascar,2017,0,2,2
Zimbabwe,Namibia,2017,1,0,1
Mauritania,Liberia,2017,0,1,1
Benin,Togo,2017,1,1,2
Ecuador,Trinidad and Tobago,2017,3,1,4
United States,Jamaica,2017,2,1,3
Sudan,Burundi,2017,1,0,1
Zambia,Ethiopia,2017,0,0,0
Rwanda,Sudan,2017,2,1,3
Congo,DR Congo,2017,0,0,0
São Tomé and Príncipe,Cameroon,2017,0,2,2
Algeria,Libya,2017,1,2,3
Burkina Faso,Ghana,2017,2,2,4
Egypt,Morocco,2017,1,1,2
Niger,Ivory Coast,2017,2,1,3
Andorra,Qatar,2017,0,1,1
Libya,Algeria,2017,1,1,2
Morocco,Egypt,2017,3,1,4
India,Mauritius,2017,2,1,3
Cameroon,São Tomé and Príncipe,2017,2,0,2
DR Congo,Congo,2017,1,1,2
Ivory Coast,Niger,2017,1,0,1
Ghana,Burkina Faso,2017,1,2,3
Malaysia,Syria,2017,1,2,3
Mauritius,Saint Kitts and Nevis,2017,1,1,2
Qatar,Turkmenistan,2017,2,1,3
India,Saint Kitts and Nevis,2017,1,1,2
Trinidad and Tobago,Jamaica,2017,1,2,3
Iraq,Syria,2017,1,1,2
Bahrain,Jordan,2017,0,0,0
Myanmar,Malaysia,2017,1,0,1
United Arab Emirates,Saudi Arabia,2017,2,1,3
Oman,Afghanistan,2017,2,0,2
Belgium,Gibraltar,2017,9,0,9
Brazil,Ecuador,2017,2,0,2
Bulgaria,Sweden,2017,3,2,5
Chile,Paraguay,2017,0,3,3
China PR,Uzbekistan,2017,1,0,1
Cyprus,Bosnia and Herzegovina,2017,3,2,5
France,Netherlands,2017,4,0,4
Greece,Estonia,2017,0,0,0
Guinea,Libya,2017,3,2,5
Hungary,Latvia,2017,3,1,4
Japan,Australia,2017,2,0,2
Kenya,Mauritania,2017,1,1,2
South Korea,Iran,2017,0,0,0
Luxembourg,Belarus,2017,1,0,1
Niger,Togo,2017,0,2,2
Peru,Bolivia,2017,2,1,3
Portugal,Faroe Islands,2017,5,1,6
Singapore,Hong Kong,2017,1,1,2
Switzerland,Andorra,2017,3,0,3
Syria,Qatar,2017,3,1,4
Thailand,Iraq,2017,1,2,3
Uganda,Egypt,2017,1,0,1
Uruguay,Argentina,2017,0,0,0
Venezuela,Colombia,2017,0,0,0
Cape Verde,South Africa,2017,2,1,3
Czech Republic,Germany,2017,1,2,3
Denmark,Poland,2017,4,0,4
Ghana,Congo,2017,1,1,2
Kazakhstan,Montenegro,2017,0,3,3
Lithuania,Scotland,2017,0,3,3
Malta,England,2017,0,4,4
Mexico,Panama,2017,1,0,1
Morocco,Mali,2017,6,0,6
New Zealand,Solomon Islands,2017,6,1,7
Nigeria,Cameroon,2017,4,0,4
Norway,Azerbaijan,2017,2,0,2
Romania,Armenia,2017,1,0,1
San Marino,Northern Ireland,2017,0,3,3
Slovakia,Slovenia,2017,1,0,1
Trinidad and Tobago,Honduras,2017,1,2,3
Tunisia,DR Congo,2017,2,1,3
United States,Costa Rica,2017,0,2,2
Albania,Liechtenstein,2017,2,0,2
Canada,Jamaica,2017,2,0,2
Croatia,Kosovo,2017,1,0,1
Finland,Iceland,2017,1,0,1
Gabon,Ivory Coast,2017,0,3,3
Georgia,Republic of Ireland,2017,1,1,2
Indonesia,Fiji,2017,0,0,0
Israel,North Macedonia,2017,0,1,1
Mozambique,Kenya,2017,1,1,2
Senegal,Burkina Faso,2017,0,0,0
Serbia,Moldova,2017,3,0,3
Spain,Italy,2017,3,0,3
Ukraine,Turkey,2017,2,0,2
Wales,Austria,2017,1,0,1
Zambia,Algeria,2017,3,1,4
Belarus,Sweden,2017,0,4,4
Equatorial Guinea,Benin,2017,1,2,3
Estonia,Cyprus,2017,1,0,1
Faroe Islands,Andorra,2017,1,0,1
France,Luxembourg,2017,0,0,0
Gibraltar,Bosnia and Herzegovina,2017,0,4,4
Greece,Belgium,2017,1,2,3
Hungary,Portugal,2017,0,1,1
Latvia,Switzerland,2017,0,3,3
Netherlands,Bulgaria,2017,3,1,4
Armenia,Denmark,2017,1,4,5
Azerbaijan,San Marino,2017,5,1,6
Cameroon,Nigeria,2017,1,1,2
England,Slovakia,2017,2,1,3
Germany,Norway,2017,6,0,6
Libya,Guinea,2017,1,0,1
Malawi,Togo,2017,1,0,1
Montenegro,Romania,2017,1,0,1
Northern Ireland,Czech Republic,2017,2,0,2
Poland,Kazakhstan,2017,3,0,3
Scotland,Malta,2017,2,0,2
Slovenia,Lithuania,2017,4,0,4
Algeria,Zambia,2017,0,1,1
Argentina,Venezuela,2017,1,1,2
Australia,Thailand,2017,2,1,3
Austria,Georgia,2017,1,1,2
Bahrain,Taiwan,2017,5,0,5
Bhutan,Palestine,2017,0,2,2
Bolivia,Chile,2017,1,0,1
Burkina Faso,Senegal,2017,2,2,4
Cambodia,Vietnam,2017,1,2,3
Colombia,Brazil,2017,1,1,2
Congo,Ghana,2017,1,5,6
DR Congo,Tunisia,2017,2,2,4
Costa Rica,Mexico,2017,1,1,2
Ecuador,Peru,2017,0,2,2
Egypt,Uganda,2017,1,0,1
Honduras,United States,2017,1,1,2
Iceland,Ukraine,2017,2,0,2
Iran,Syria,2017,2,2,4
Iraq,United Arab Emirates,2017,1,0,1
Republic of Ireland,Serbia,2017,0,1,1
Italy,Israel,2017,1,0,1
Ivory Coast,Gabon,2017,1,2,3
Jordan,Afghanistan,2017,4,1,5
North Korea,Lebanon,2017,2,2,4
Kosovo,Finland,2017,0,1,1
Liechtenstein,Spain,2017,0,8,8
Macau,India,2017,0,2,2
North Macedonia,Albania,2017,1,1,2
Malaysia,Hong Kong,2017,1,1,2
Mali,Morocco,2017,0,0,0
Mauritania,Niger,2017,0,2,2
Moldova,Wales,2017,0,2,2
Nepal,Tajikistan,2017,1,2,3
Oman,Maldives,2017,5,0,5
Panama,Trinidad and Tobago,2017,3,0,3
Paraguay,Uruguay,2017,1,2,3
Philippines,Yemen,2017,2,2,4
Qatar,China PR,2017,1,2,3
Saudi Arabia,Japan,2017,1,0,1
Singapore,Turkmenistan,2017,1,1,2
Solomon Islands,New Zealand,2017,2,2,4
South Africa,Cape Verde,2017,1,2,3
Turkey,Croatia,2017,1,0,1
Uzbekistan,South Korea,2017,0,0,0
Macau,Laos,2017,3,1,4
Argentina,Peru,2017,0,0,0
Armenia,Poland,2017,1,6,7
Azerbaijan,Czech Republic,2017,1,2,3
Bolivia,Brazil,2017,0,0,0
Myanmar,Thailand,2017,1,3,4
Chile,Ecuador,2017,2,1,3
Colombia,Paraguay,2017,1,2,3
England,Slovenia,2017,1,0,1
Hong Kong,Laos,2017,4,0,4
Iran,Togo,2017,2,0,2
Iraq,Kenya,2017,2,1,3
Malta,Lithuania,2017,1,1,2
Montenegro,Denmark,2017,0,1,1
Northern Ireland,Germany,2017,1,3,4
Qatar,Singapore,2017,3,1,4
Romania,Kazakhstan,2017,3,1,4
San Marino,Norway,2017,0,8,8
Scotland,Slovakia,2017,1,0,1
Syria,Australia,2017,1,1,2
Taiwan,Mongolia,2017,4,2,6
Venezuela,Uruguay,2017,0,0,0
Austria,Serbia,2017,3,2,5
Croatia,Finland,2017,1,1,2
Georgia,Wales,2017,0,1,1
Republic of Ireland,Moldova,2017,2,0,2
Italy,North Macedonia,2017,1,1,2
Japan,New Zealand,2017,2,1,3
Kosovo,Ukraine,2017,0,2,2
Liechtenstein,Israel,2017,0,1,1
Mali,Ivory Coast,2017,0,0,0
Mauritania,Comoros,2017,0,1,1
Mexico,Trinidad and Tobago,2017,3,1,4
Spain,Albania,2017,3,0,3
Turkey,Iceland,2017,0,3,3
United States,Panama,2017,4,0,4
Andorra,Portugal,2017,0,2,2
Belarus,Netherlands,2017,1,3,4
Bosnia and Herzegovina,Belgium,2017,3,4,7
Bulgaria,France,2017,0,1,1
Cameroon,Algeria,2017,2,0,2
Cape Verde,Senegal,2017,0,2,2
Costa Rica,Honduras,2017,1,1,2
Cyprus,Greece,2017,1,2,3
Faroe Islands,Latvia,2017,0,0,0
Gibraltar,Estonia,2017,0,6,6
Grenada,Guyana,2017,1,0,1
Guinea,Tunisia,2017,1,4,5
Libya,DR Congo,2017,1,2,3
Morocco,Gabon,2017,3,0,3
Nigeria,Zambia,2017,1,0,1
Russia,South Korea,2017,4,2,6
Saudi Arabia,Jamaica,2017,5,2,7
South Africa,Burkina Faso,2017,3,1,4
Sweden,Luxembourg,2017,8,0,8
Switzerland,Hungary,2017,5,2,7
Tanzania,Malawi,2017,1,1,2
Uganda,Ghana,2017,0,0,0
Czech Republic,San Marino,2017,5,0,5
Denmark,Romania,2017,1,1,2
Egypt,Congo,2017,2,1,3
El Salvador,Canada,2017,1,0,1
Germany,Azerbaijan,2017,5,1,6
Kazakhstan,Armenia,2017,1,1,2
Lithuania,England,2017,0,1,1
Norway,Northern Ireland,2017,1,0,1
Poland,Montenegro,2017,4,2,6
Slovakia,Malta,2017,3,0,3
Slovenia,Scotland,2017,2,2,4
Thailand,Kenya,2017,1,0,1
Albania,Italy,2017,0,1,1
Equatorial Guinea,Mauritius,2017,3,1,4
Finland,Turkey,2017,2,2,4
Iceland,Kosovo,2017,2,0,2
Israel,Spain,2017,0,1,1
North Macedonia,Liechtenstein,2017,4,0,4
Moldova,Austria,2017,0,1,1
Serbia,Georgia,2017,1,0,1
Ukraine,Croatia,2017,0,2,2
Wales,Republic of Ireland,2017,0,1,1
Afghanistan,Jordan,2017,3,3,6
Australia,Syria,2017,2,1,3
Belgium,Cyprus,2017,4,0,4
Benin,Gabon,2017,1,0,1
Brazil,Chile,2017,3,0,3
Myanmar,Kyrgyzstan,2017,2,2,4
Ecuador,Argentina,2017,1,3,4
Estonia,Bosnia and Herzegovina,2017,1,2,3
France,Belarus,2017,2,1,3
Greece,Gibraltar,2017,4,0,4
Honduras,Mexico,2017,3,2,5
Hong Kong,Malaysia,2017,2,0,2
Hungary,Faroe Islands,2017,1,0,1
Japan,Haiti,2017,3,3,6
South Korea,Morocco,2017,1,3,4
Latvia,Andorra,2017,4,0,4
Lebanon,North Korea,2017,5,0,5
Luxembourg,Bulgaria,2017,1,1,2
Maldives,Oman,2017,1,3,4
Netherlands,Sweden,2017,2,0,2
Palestine,Bhutan,2017,10,0,10
Panama,Costa Rica,2017,2,1,3
Paraguay,Venezuela,2017,0,1,1
Peru,Colombia,2017,1,1,2
Portugal,Switzerland,2017,2,0,2
Qatar,Curaçao,2017,1,2,3
Russia,Iran,2017,1,1,2
Saudi Arabia,Ghana,2017,0,3,3
Taiwan,Bahrain,2017,2,1,3
Tajikistan,Nepal,2017,3,0,3
Trinidad and Tobago,United States,2017,2,1,3
Turkmenistan,Singapore,2017,2,1,3
Uruguay,Bolivia,2017,4,2,6
Vietnam,Cambodia,2017,5,0,5
Yemen,Philippines,2017,1,1,2
India,Macau,2017,4,1,5
Grenada,Panama,2017,0,5,5
Bermuda,Barbados,2017,2,3,5
Congo,Benin,2017,1,1,2
Iceland,Czech Republic,2017,1,2,3
Nicaragua,Dominican Republic,2017,0,3,3
Armenia,Belarus,2017,4,1,5
Cambodia,Myanmar,2017,1,2,3
Croatia,Greece,2017,4,1,5
Finland,Estonia,2017,3,0,3
Hong Kong,Bahrain,2017,0,2,2
Iran,Panama,2017,2,1,3
Luxembourg,Hungary,2017,2,1,3
Northern Ireland,Switzerland,2017,0,1,1
Romania,Turkey,2017,2,0,2
Scotland,Netherlands,2017,0,1,1
Singapore,Lebanon,2017,0,1,1
Algeria,Nigeria,2017,3,0,3
Belgium,Mexico,2017,3,3,6
China PR,Serbia,2017,0,2,2
England,Germany,2017,0,0,0
France,Wales,2017,2,0,2
Georgia,Cyprus,2017,1,0,1
Honduras,Australia,2017,0,0,0
Japan,Brazil,2017,1,3,4
North Korea,Malaysia,2017,4,1,5
South Korea,Colombia,2017,2,1,3
Poland,Uruguay,2017,0,0,0
Portugal,Saudi Arabia,2017,3,0,3
South Africa,Senegal,2017,0,2,2
Sweden,Italy,2017,1,0,1
Ukraine,Slovakia,2017,2,1,3
Comoros,Madagascar,2017,1,1,2
DR Congo,Guinea,2017,3,1,4
Denmark,Republic of Ireland,2017,0,0,0
Dominican Republic,Nicaragua,2017,1,0,1
Gabon,Mali,2017,0,0,0
Ivory Coast,Morocco,2017,0,2,2
North Macedonia,Norway,2017,2,0,2
Malawi,Lesotho,2017,1,1,2
Namibia,Zimbabwe,2017,3,1,4
New Zealand,Peru,2017,0,0,0
Qatar,Czech Republic,2017,0,1,1
Russia,Argentina,2017,0,1,1
Spain,Costa Rica,2017,5,0,5
Trinidad and Tobago,Grenada,2017,2,2,4
Tunisia,Libya,2017,0,0,0
Zambia,Cameroon,2017,2,2,4
Benin,Tanzania,2017,1,1,2
Congo,Uganda,2017,1,1,2
Ghana,Egypt,2017,1,1,2
Greece,Croatia,2017,0,0,0
Malta,Estonia,2017,0,3,3
Switzerland,Northern Ireland,2017,0,0,0
Togo,Mauritius,2017,6,0,6
Armenia,Cyprus,2017,3,2,5
Bulgaria,Saudi Arabia,2017,1,0,1
Georgia,Belarus,2017,2,2,4
Iran,Venezuela,2017,1,0,1
Iraq,Syria,2017,1,1,2
Italy,Sweden,2017,0,0,0
Kosovo,Latvia,2017,4,3,7
Malaysia,North Korea,2017,1,4,5
Poland,Mexico,2017,0,1,1
Turkey,Albania,2017,2,3,5
Algeria,Central African Republic,2017,3,0,3
Argentina,Nigeria,2017,2,4,6
Austria,Uruguay,2017,2,1,3
Belgium,Japan,2017,1,0,1
Bhutan,Oman,2017,2,4,6
Burkina Faso,Cape Verde,2017,4,0,4
Cambodia,Jordan,2017,0,1,1
China PR,Colombia,2017,0,4,4
England,Brazil,2017,0,0,0
Gabon,Botswana,2017,0,0,0
Germany,France,2017,2,2,4
Hong Kong,Lebanon,2017,0,1,1
Hungary,Costa Rica,2017,1,0,1
India,Myanmar,2017,2,2,4
Republic of Ireland,Denmark,2017,1,5,6
South Korea,Serbia,2017,1,1,2
Macau,Kyrgyzstan,2017,3,4,7
Nepal,Philippines,2017,0,0,0
Palestine,Maldives,2017,8,1,9
Portugal,United States,2017,1,1,2
Qatar,Iceland,2017,1,1,2
Romania,Netherlands,2017,0,3,3
Russia,Spain,2017,3,3,6
Senegal,South Africa,2017,2,1,3
Singapore,Bahrain,2017,0,3,3
Slovakia,Norway,2017,1,0,1
Tajikistan,Yemen,2017,0,0,0
Trinidad and Tobago,Guyana,2017,1,1,2
Turkmenistan,Taiwan,2017,2,1,3
United Arab Emirates,Uzbekistan,2017,1,0,1
Vietnam,Afghanistan,2017,0,0,0
Wales,Panama,2017,1,1,2
Australia,Honduras,2017,3,1,4
Peru,New Zealand,2017,2,0,2
Fiji,Estonia,2017,0,2,2
Vanuatu,Estonia,2017,0,1,1
Indonesia,Guyana,2017,2,1,3
New Caledonia,Estonia,2017,1,1,2
Laos,Philippines,2017,1,3,4
Fiji,Tuvalu,2017,8,0,8
Indonesia,Brunei,2017,4,0,4
Kyrgyzstan,Mongolia,2017,3,0,3
Tonga,Solomon Islands,2017,0,8,8
Vanuatu,New Caledonia,2017,1,2,3
Kenya,Rwanda,2017,2,0,2
Laos,Timor-Leste,2017,2,1,3
Libya,Tanzania,2017,0,0,0
Saint Kitts and Nevis,Grenada,2017,1,0,1
Taiwan,Philippines,2017,3,0,3
Brunei,Kyrgyzstan,2017,0,4,4
Indonesia,Mongolia,2017,3,2,5
Taiwan,Timor-Leste,2017,3,1,4
Uganda,Burundi,2017,0,0,0
Timor-Leste,Philippines,2017,1,0,1
Kenya,Libya,2017,0,0,0
Tuvalu,New Caledonia,2017,2,1,3
South Sudan,Ethiopia,2017,0,3,3
Taiwan,Laos,2017,2,0,2
Zanzibar,Rwanda,2017,3,1,4
Indonesia,Kyrgyzstan,2017,0,1,1
Solomon Islands,Fiji,2017,0,0,0
Vanuatu,Tonga,2017,5,0,5
Burundi,Ethiopia,2017,4,1,5
Rwanda,Libya,2017,0,0,0
Tanzania,Zanzibar,2017,1,2,3
Uganda,South Sudan,2017,5,1,6
Tonga,New Caledonia,2017,2,4,6
Japan,North Korea,2017,1,0,1
Kenya,Zanzibar,2017,0,0,0
South Korea,China PR,2017,2,2,4
Rwanda,Tanzania,2017,2,1,3
Solomon Islands,Tuvalu,2017,6,0,6
Vanuatu,Fiji,2017,1,1,2
Ethiopia,Uganda,2017,1,1,2
Kenya,Tanzania,2017,1,0,1
Libya,Zanzibar,2017,1,0,1
South Sudan,Burundi,2017,0,0,0
Fiji,Tonga,2017,4,0,4
New Caledonia,Solomon Islands,2017,0,0,0
Japan,China PR,2017,2,1,3
North Korea,South Korea,2017,0,1,1
Vanuatu,Tuvalu,2017,10,0,10
Kenya,Burundi,2017,1,0,1
Qatar,Liechtenstein,2017,1,2,3
Tuvalu,Tonga,2017,4,3,7
Uganda,Zanzibar,2017,1,2,3
Fiji,New Caledonia,2017,2,3,5
Vanuatu,Solomon Islands,2017,3,2,5
China PR,North Korea,2017,1,1,2
Japan,South Korea,2017,1,4,5
Burundi,Uganda,2017,1,2,3
Kenya,Zanzibar,2017,2,2,4
Bahrain,Kuwait,2017,0,0,0
Kuwait,Saudi Arabia,2017,1,2,3
Oman,United Arab Emirates,2017,0,1,1
Bahrain,Iraq,2017,1,1,2
Qatar,Yemen,2017,4,0,4
Jordan,Libya,2017,1,1,2
Kuwait,Oman,2017,0,1,1
United Arab Emirates,Saudi Arabia,2017,0,0,0
Iraq,Qatar,2017,2,1,3
Yemen,Bahrain,2017,0,1,1
Kuwait,United Arab Emirates,2017,0,0,0
Saudi Arabia,Oman,2017,0,2,2
Iraq,Yemen,2017,3,0,3
Qatar,Bahrain,2017,1,1,2
Iraq,United Arab Emirates,2018,0,0,0
Oman,Bahrain,2018,1,0,1
Oman,United Arab Emirates,2018,0,0,0
Estonia,Sweden,2018,1,1,2
Denmark,Sweden,2018,0,1,1
Indonesia,Iceland,2018,0,6,6
Jordan,Finland,2018,1,2,3
Morocco,Mauritania,2018,4,0,4
Indonesia,Iceland,2018,1,4,5
Guinea,Sudan,2018,1,2,3
Ivory Coast,Namibia,2018,0,1,1
Zambia,Uganda,2018,3,1,4
Libya,Equatorial Guinea,2018,3,0,3
Nigeria,Rwanda,2018,0,0,0
Angola,Burkina Faso,2018,0,0,0
Cameroon,Congo,2018,0,1,1
Morocco,Guinea,2018,3,1,4
Sudan,Mauritania,2018,1,0,1
Ivory Coast,Zambia,2018,0,2,2
Uganda,Namibia,2018,0,1,1
Libya,Nigeria,2018,0,1,1
Rwanda,Equatorial Guinea,2018,1,0,1
Angola,Cameroon,2018,1,0,1
Congo,Burkina Faso,2018,2,0,2
Mauritania,Guinea,2018,0,1,1
Morocco,Sudan,2018,0,0,0
Namibia,Zambia,2018,1,1,2
Uganda,Ivory Coast,2018,0,0,0
Equatorial Guinea,Nigeria,2018,1,3,4
Rwanda,Libya,2018,0,1,1
Burkina Faso,Cameroon,2018,1,1,2
Congo,Angola,2018,0,0,0
Moldova,South Korea,2018,0,1,1
Morocco,Namibia,2018,2,0,2
Zambia,Sudan,2018,0,1,1
United States,Bosnia and Herzegovina,2018,0,0,0
Congo,Libya,2018,1,1,2
Nigeria,Angola,2018,2,1,3
Yorkshire,Ellan Vannin,2018,1,1,2
Azerbaijan,Moldova,2018,0,0,0
Jamaica,South Korea,2018,2,2,4
Mexico,Bosnia and Herzegovina,2018,1,0,1
Morocco,Libya,2018,3,1,4
Sudan,Nigeria,2018,0,1,1
Latvia,South Korea,2018,0,1,1
Libya,Sudan,2018,1,1,2
Morocco,Nigeria,2018,4,0,4
Saudi Arabia,Moldova,2018,3,0,3
Iraq,Saudi Arabia,2018,4,1,5
Iran,Sierra Leone,2018,4,0,4
Andorra,Liechtenstein,2018,1,0,1
Antigua and Barbuda,Bermuda,2018,3,2,5
Iraq,Qatar,2018,2,3,5
Jordan,Kuwait,2018,1,0,1
Laos,Cambodia,2018,0,1,1
Madagascar,Togo,2018,0,0,0
South Africa,Angola,2018,1,1,2
Tahiti,New Caledonia,2018,0,0,0
Zambia,Zimbabwe,2018,2,2,4
Algeria,Tanzania,2018,4,1,5
Bahrain,Palestine,2018,0,0,0
Belize,Grenada,2018,4,2,6
Burkina Faso,Guinea-Bissau,2018,2,0,2
China PR,Wales,2018,0,6,6
Denmark,Panama,2018,1,0,1
Dominican Republic,Turks and Caicos Islands,2018,4,0,4
Faroe Islands,Latvia,2018,1,1,2
Kyrgyzstan,Myanmar,2018,5,1,6
Macau,Mauritius,2018,0,1,1
Malaysia,Mongolia,2018,2,2,4
Malta,Luxembourg,2018,0,1,1
Nicaragua,Cuba,2018,3,1,4
Philippines,Fiji,2018,3,2,5
Slovakia,United Arab Emirates,2018,2,1,3
Thailand,Gabon,2018,0,0,0
Austria,Slovenia,2018,3,0,3
Azerbaijan,Belarus,2018,0,1,1
Bulgaria,Bosnia and Herzegovina,2018,0,1,1
Curaçao,Bolivia,2018,1,1,2
Cyprus,Montenegro,2018,0,0,0
Finland,North Macedonia,2018,0,0,0
France,Colombia,2018,2,3,5
Gambia,Central African Republic,2018,1,1,2
Germany,Spain,2018,1,1,2
Greece,Switzerland,2018,0,1,1
Guadeloupe,Trinidad and Tobago,2018,0,1,1
Hungary,Kazakhstan,2018,2,3,5
Italy,Argentina,2018,0,2,2
Japan,Mali,2018,1,1,2
Mexico,Iceland,2018,3,0,3
Netherlands,England,2018,0,1,1
Norway,Australia,2018,4,1,5
Peru,Croatia,2018,2,0,2
Poland,Nigeria,2018,0,1,1
Portugal,Egypt,2018,2,1,3
Russia,Brazil,2018,0,3,3
Scotland,Costa Rica,2018,0,1,1
Senegal,Uzbekistan,2018,1,1,2
Serbia,Morocco,2018,1,2,3
Singapore,Maldives,2018,3,2,5
Tunisia,Iran,2018,1,0,1
Turkey,Republic of Ireland,2018,1,0,1
Ukraine,Saudi Arabia,2018,1,1,2
Uruguay,Czech Republic,2018,2,0,2
Angola,Zimbabwe,2018,2,2,4
Armenia,Estonia,2018,0,0,0
Botswana,Lesotho,2018,1,0,1
Canada,New Zealand,2018,1,0,1
Comoros,Kenya,2018,2,2,4
Georgia,Lithuania,2018,4,0,4
Israel,Romania,2018,1,2,3
Ivory Coast,Togo,2018,2,2,4
Kosovo,Madagascar,2018,1,0,1
Mauritania,Guinea,2018,2,0,2
Northern Ireland,South Korea,2018,2,1,3
Qatar,Syria,2018,2,2,4
Sweden,Chile,2018,1,2,3
Tahiti,New Caledonia,2018,4,3,7
Uganda,São Tomé and Príncipe,2018,3,1,4
Zambia,South Africa,2018,0,2,2
Barbados,Bermuda,2018,0,0,0
Dominican Republic,Saint Kitts and Nevis,2018,2,1,3
Faroe Islands,Liechtenstein,2018,3,0,3
Gibraltar,Latvia,2018,1,0,1
Jamaica,Antigua and Barbuda,2018,1,1,2
Kuwait,Cameroon,2018,1,3,4
Martinique,Trinidad and Tobago,2018,0,0,0
Nicaragua,Cuba,2018,3,3,6
Thailand,Slovakia,2018,2,3,5
Yorkshire,Chagos Islands,2018,6,0,6
Albania,Norway,2018,0,1,1
Bulgaria,Kazakhstan,2018,2,1,3
China PR,Czech Republic,2018,1,4,5
Curaçao,Bolivia,2018,1,0,1
Finland,Malta,2018,5,0,5
Portugal,Netherlands,2018,0,3,3
Wales,Uruguay,2018,0,1,1
Afghanistan,Cambodia,2018,2,1,3
Algeria,Iran,2018,1,2,3
Armenia,Lithuania,2018,0,1,1
Australia,Colombia,2018,0,0,0
Azerbaijan,North Macedonia,2018,1,1,2
Bahrain,Turkmenistan,2018,4,0,4
Belgium,Saudi Arabia,2018,4,0,4
Bosnia and Herzegovina,Senegal,2018,0,0,0
Myanmar,Macau,2018,1,0,1
Central African Republic,Kenya,2018,3,2,5
Denmark,Chile,2018,0,0,0
England,Italy,2018,1,1,2
Georgia,Estonia,2018,2,0,2
Germany,Brazil,2018,0,1,1
Greece,Egypt,2018,1,0,1
Hungary,Scotland,2018,0,1,1
Iraq,Syria,2018,1,1,2
Jordan,Vietnam,2018,1,1,2
North Korea,Hong Kong,2018,2,0,2
Kosovo,Burkina Faso,2018,2,0,2
Kyrgyzstan,India,2018,2,1,3
Laos,Bangladesh,2018,2,2,4
Lebanon,Malaysia,2018,2,1,3
Luxembourg,Austria,2018,0,4,4
Maldives,Bhutan,2018,7,0,7
Mexico,Croatia,2018,0,1,1
Moldova,Ivory Coast,2018,1,2,3
Mongolia,Mauritius,2018,0,2,2
Montenegro,Turkey,2018,2,2,4
Morocco,Uzbekistan,2018,2,0,2
Namibia,Lesotho,2018,2,1,3
Oman,Palestine,2018,1,0,1
Peru,Iceland,2018,3,1,4
Philippines,Tajikistan,2018,2,1,3
Poland,South Korea,2018,3,2,5
Romania,Sweden,2018,1,0,1
Russia,France,2018,1,3,4
Serbia,Nigeria,2018,2,0,2
Seychelles,Eswatini,2018,0,0,0
Slovenia,Belarus,2018,0,2,2
Spain,Argentina,2018,6,1,7
Switzerland,Panama,2018,6,0,6
Taiwan,Singapore,2018,1,0,1
Tanzania,DR Congo,2018,2,0,2
Tunisia,Costa Rica,2018,1,0,1
Uganda,Malawi,2018,0,0,0
Ukraine,Japan,2018,2,1,3
United States,Paraguay,2018,1,0,1
Yemen,Nepal,2018,2,1,3
Malaysia,Bhutan,2018,7,0,7
Barawa,Chagos Islands,2018,4,1,5
Barawa,Yorkshire,2018,2,7,9
Trinidad and Tobago,Panama,2018,0,1,1
Zimbabwe,Botswana,2018,0,1,1
Saint Kitts and Nevis,Jamaica,2018,1,3,4
Antigua and Barbuda,Jamaica,2018,0,2,2
Barawa,Surrey,2018,1,3,4
Iraq,Palestine,2018,0,0,0
Algeria,Saudi Arabia,2018,0,2,2
Kuwait,Palestine,2018,2,0,2
Saudi Arabia,Greece,2018,2,0,2
Iran,Uzbekistan,2018,1,0,1
Jordan,Cyprus,2018,3,0,3
Kuwait,Egypt,2018,1,1,2
Kenya,Eswatini,2018,0,1,1
China PR,Myanmar,2018,1,0,1
Cameroon,Burkina Faso,2018,0,1,1
Niger,Central African Republic,2018,3,3,6
Madagascar,Mozambique,2018,2,1,3
Comoros,Seychelles,2018,1,1,2
United States,Bolivia,2018,3,0,3
Nigeria,DR Congo,2018,1,1,2
Kenya,Equatorial Guinea,2018,1,0,1
Portugal,Tunisia,2018,2,2,4
Italy,Saudi Arabia,2018,2,1,3
France,Republic of Ireland,2018,2,0,2
Mexico,Wales,2018,0,0,0
Turkey,Iran,2018,2,1,3
South Korea,Honduras,2018,2,0,2
Bosnia and Herzegovina,Montenegro,2018,0,0,0
Malawi,Mauritius,2018,0,1,1
Angola,Botswana,2018,1,2,3
Argentina,Haiti,2018,4,0,4
Albania,Kosovo,2018,0,3,3
Armenia,Malta,2018,1,1,2
Azerbaijan,Kyrgyzstan,2018,3,0,3
Peru,Scotland,2018,2,0,2
Panama,Northern Ireland,2018,0,0,0
Madagascar,Seychelles,2018,1,1,2
Comoros,Mozambique,2018,0,3,3
Japan,Ghana,2018,0,2,2
Central African Republic,Uganda,2018,1,0,1
Austria,Russia,2018,1,0,1
Malawi,Botswana,2018,1,1,2
Angola,Mauritius,2018,1,0,1
Estonia,Lithuania,2018,2,0,2
Ukraine,Morocco,2018,0,0,0
Romania,Chile,2018,3,2,5
Luxembourg,Senegal,2018,0,0,0
Mozambique,Seychelles,2018,2,1,3
Comoros,Madagascar,2018,0,1,1
Slovakia,Netherlands,2018,1,1,2
Ellan Vannin,Cascadia,2018,4,1,5
Barawa,Tamil Eelam,2018,4,0,4
Abkhazia,Tibet,2018,3,0,3
Northern Cyprus,Kárpátalja,2018,1,1,2
Székely Land,Tuvalu,2018,4,0,4
Padania,Matabeleland,2018,6,1,7
United Koreans in Japan,Western Armenia,2018,0,0,0
Panjab,Kabylia,2018,8,0,8
France,Italy,2018,3,1,4
Turkey,Tunisia,2018,2,2,4
South Korea,Bosnia and Herzegovina,2018,1,3,4
Czech Republic,Australia,2018,0,4,4
Algeria,Cape Verde,2018,2,3,5
Colombia,Egypt,2018,0,0,0
Malta,Georgia,2018,0,1,1
Botswana,Mauritius,2018,6,0,6
Angola,Malawi,2018,0,0,0
India,Taiwan,2018,5,0,5
El Salvador,Honduras,2018,1,0,1
Thailand,China PR,2018,0,2,2
England,Nigeria,2018,2,1,3
Montenegro,Slovenia,2018,0,2,2
Mexico,Scotland,2018,1,0,1
Sweden,Denmark,2018,0,0,0
Republic of Ireland,United States,2018,2,1,3
Belgium,Portugal,2018,0,0,0
Austria,Germany,2018,2,1,3
Niger,Uganda,2018,2,1,3
Iceland,Norway,2018,2,3,5
Zambia,Namibia,2018,0,0,0
Lesotho,Eswatini,2018,1,0,1
Latvia,Estonia,2018,1,0,1
Kenya,New Zealand,2018,2,1,3
Ellan Vannin,Tamil Eelam,2018,2,0,2
Barawa,Cascadia,2018,1,2,3
Abkhazia,Kárpátalja,2018,0,2,2
Northern Cyprus,Tibet,2018,3,1,4
Székely Land,Matabeleland,2018,5,0,5
Padania,Tuvalu,2018,8,0,8
United Koreans in Japan,Kabylia,2018,0,0,0
Panjab,Western Armenia,2018,0,1,1
Albania,Ukraine,2018,1,4,5
Saudi Arabia,Peru,2018,0,3,3
Spain,Switzerland,2018,1,1,2
Croatia,Brazil,2018,0,2,2
Costa Rica,Northern Ireland,2018,3,0,3
Barbados,Belize,2018,0,0,0
Andorra,Cape Verde,2018,0,0,0
South Africa,Madagascar,2018,0,0,0
Zimbabwe,Botswana,2018,1,1,2
Tamil Eelam,Cascadia,2018,0,6,6
Barawa,Ellan Vannin,2018,2,0,2
Abkhazia,Northern Cyprus,2018,2,2,4
Kárpátalja,Tibet,2018,5,1,6
Padania,Székely Land,2018,3,1,4
Tuvalu,Matabeleland,2018,1,3,4
Panjab,United Koreans in Japan,2018,1,1,2
Western Armenia,Kabylia,2018,4,0,4
Italy,Netherlands,2018,1,1,2
Serbia,Chile,2018,0,1,1
Slovakia,Morocco,2018,1,2,3
Armenia,Moldova,2018,0,0,0
India,Kenya,2018,3,0,3
Russia,Turkey,2018,1,1,2
Romania,Finland,2018,2,0,2
Luxembourg,Georgia,2018,1,0,1
Kazakhstan,Azerbaijan,2018,3,0,3
Martinique,French Guiana,2018,3,0,3
Lithuania,Latvia,2018,1,1,2
Taiwan,New Zealand,2018,0,1,1
South Africa,Namibia,2018,4,1,5
Eswatini,Botswana,2018,0,2,2
Matabeleland,Kabylia,2018,0,0,0
Abkhazia,Tamil Eelam,2018,6,0,6
United Koreans in Japan,Tuvalu,2018,5,0,5
Barawa,Northern Cyprus,2018,0,8,8
Padania,Panjab,2018,2,0,2
Kárpátalja,Cascadia,2018,3,1,4
Western Armenia,Székely Land,2018,0,4,4
Norway,Panama,2018,1,0,1
Czech Republic,Nigeria,2018,1,0,1
Belgium,Egypt,2018,3,0,3
Belarus,Hungary,2018,1,1,2
Zambia,Madagascar,2018,1,0,1
Lesotho,Zimbabwe,2018,0,0,0
England,Costa Rica,2018,2,0,2
Uruguay,Uzbekistan,2018,3,0,3
Portugal,Algeria,2018,3,0,3
South Korea,Bolivia,2018,0,0,0
Iceland,Ghana,2018,2,2,4
Guadeloupe,French Guiana,2018,0,2,2
India,New Zealand,2018,1,2,3
Tamil Eelam,Tuvalu,2018,4,3,7
Tibet,Kabylia,2018,1,8,9
Abkhazia,United Koreans in Japan,2018,2,0,2
Barawa,Panjab,2018,0,5,5
Cascadia,Western Armenia,2018,4,0,4
Northern Cyprus,Padania,2018,3,2,5
Kárpátalja,Székely Land,2018,4,2,6
Germany,Saudi Arabia,2018,2,1,3
Croatia,Senegal,2018,2,1,3
Switzerland,Japan,2018,2,0,2
Lithuania,Iran,2018,0,1,1
Poland,Chile,2018,2,2,4
Taiwan,Kenya,2018,0,4,4
South Africa,Botswana,2018,3,0,3
Madagascar,Lesotho,2018,0,1,1
Zambia,Zimbabwe,2018,2,4,6
Serbia,Bolivia,2018,5,1,6
Denmark,Mexico,2018,2,0,2
Sweden,Peru,2018,0,0,0
Hungary,Australia,2018,1,2,3
Estonia,Morocco,2018,1,3,4
Latvia,Azerbaijan,2018,1,3,4
Finland,Belarus,2018,2,0,2
Tunisia,Spain,2018,0,1,1
France,United States,2018,1,1,2
Matabeleland,Tamil Eelam,2018,1,0,1
Tibet,United Koreans in Japan,2018,1,1,2
Kabylia,Abkhazia,2018,0,2,2
Barawa,Western Armenia,2018,0,7,7
Panjab,Cascadia,2018,3,3,6
Padania,Székely Land,2018,0,0,0
Northern Cyprus,Kárpátalja,2018,0,0,0
Austria,Brazil,2018,0,3,3
India,Kenya,2018,2,0,2
South Korea,Senegal,2018,0,2,2
Belgium,Costa Rica,2018,4,1,5
Japan,Paraguay,2018,4,2,6
Poland,Lithuania,2018,4,0,4
Russia,Saudi Arabia,2018,5,0,5
Egypt,Uruguay,2018,0,1,1
Morocco,Iran,2018,0,1,1
Portugal,Spain,2018,3,3,6
France,Australia,2018,2,1,3
Argentina,Iceland,2018,1,1,2
Peru,Denmark,2018,0,1,1
Croatia,Nigeria,2018,2,0,2
Costa Rica,Serbia,2018,0,1,1
Germany,Mexico,2018,0,1,1
Brazil,Switzerland,2018,1,1,2
Sweden,South Korea,2018,1,0,1
Belgium,Panama,2018,3,0,3
Tunisia,England,2018,1,2,3
Colombia,Japan,2018,1,2,3
Poland,Senegal,2018,1,2,3
Russia,Egypt,2018,3,1,4
Portugal,Morocco,2018,1,0,1
Uruguay,Saudi Arabia,2018,1,0,1
Iran,Spain,2018,0,1,1
Denmark,Australia,2018,1,1,2
France,Peru,2018,1,0,1
Argentina,Croatia,2018,0,3,3
Brazil,Costa Rica,2018,2,0,2
Nigeria,Iceland,2018,2,0,2
Serbia,Switzerland,2018,1,2,3
Belgium,Tunisia,2018,5,2,7
South Korea,Mexico,2018,1,2,3
Germany,Sweden,2018,2,1,3
England,Panama,2018,6,1,7
Japan,Senegal,2018,2,2,4
Poland,Colombia,2018,0,3,3
Russia,Uruguay,2018,0,3,3
Saudi Arabia,Egypt,2018,2,1,3
Spain,Morocco,2018,2,2,4
Iran,Portugal,2018,1,1,2
Australia,Peru,2018,0,2,2
Denmark,France,2018,0,0,0
Nigeria,Argentina,2018,1,2,3
Iceland,Croatia,2018,1,2,3
South Korea,Germany,2018,2,0,2
Mexico,Sweden,2018,0,3,3
Serbia,Brazil,2018,0,2,2
Switzerland,Costa Rica,2018,2,2,4
Japan,Poland,2018,0,1,1
Senegal,Colombia,2018,0,1,1
Panama,Tunisia,2018,1,2,3
England,Belgium,2018,0,1,1
France,Argentina,2018,4,3,7
Uruguay,Portugal,2018,2,1,3
Russia,Spain,2018,1,1,2
Croatia,Denmark,2018,1,1,2
Brazil,Mexico,2018,2,0,2
Belgium,Japan,2018,3,2,5
Sweden,Switzerland,2018,1,0,1
Colombia,England,2018,1,1,2
Malaysia,Fiji,2018,1,0,1
Uruguay,France,2018,0,2,2
Brazil,Belgium,2018,1,2,3
Sweden,England,2018,0,2,2
Russia,Croatia,2018,2,2,4
France,Belgium,2018,1,0,1
Croatia,England,2018,2,1,3
Belgium,England,2018,2,0,2
France,Croatia,2018,4,2,6
Liberia,Sierra Leone,2018,0,0,0
Belize,Barbados,2018,1,0,1
Palestine,Iraq,2018,0,3,3
Guatemala,Cuba,2018,3,0,3
Andorra,United Arab Emirates,2018,0,0,0
Grenada,Jamaica,2018,1,5,6
Guatemala,Cuba,2018,1,0,1
Barbados,Jamaica,2018,2,2,4
Sint Maarten,Anguilla,2018,1,1,2
Anguilla,Saint Martin,2018,1,2,3
Barbados,Cuba,2018,0,0,0
Bangladesh,Sri Lanka,2018,0,1,1
Barbados,Cuba,2018,0,2,2
Macau,Solomon Islands,2018,1,4,5
Timor-Leste,Brunei,2018,3,1,4
Ethiopia,Burundi,2018,1,1,2
Guam,Northern Mariana Islands,2018,4,0,4
Mongolia,Macau,2018,4,1,5
Macau,Guam,2018,2,0,2
Mongolia,Northern Mariana Islands,2018,9,0,9
Nepal,Pakistan,2018,1,2,3
Bangladesh,Bhutan,2018,2,0,2
Fiji,Solomon Islands,2018,1,1,2
Slovakia,Denmark,2018,3,0,3
India,Sri Lanka,2018,2,0,2
Germany,France,2018,0,0,0
Czech Republic,Ukraine,2018,1,2,3
Wales,Republic of Ireland,2018,4,1,5
Norway,Cyprus,2018,2,0,2
Slovenia,Bulgaria,2018,1,2,3
Kazakhstan,Georgia,2018,0,2,2
Latvia,Andorra,2018,0,0,0
Armenia,Liechtenstein,2018,2,1,3
Gibraltar,North Macedonia,2018,0,2,2
Austria,Sweden,2018,2,0,2
Bahrain,Philippines,2018,1,1,2
Jordan,Lebanon,2018,0,1,1
Kyrgyzstan,Palestine,2018,1,1,2
Netherlands,Peru,2018,2,1,3
Portugal,Croatia,2018,1,1,2
Trinidad and Tobago,United Arab Emirates,2018,2,0,2
Uzbekistan,Syria,2018,1,1,2
Northern Mariana Islands,Macau,2018,1,1,2
Mongolia,Guam,2018,1,1,2
Nepal,Bhutan,2018,4,0,4
Bangladesh,Pakistan,2018,1,0,1
Dominica,Suriname,2018,0,0,0
Guyana,Barbados,2018,3,0,3
Italy,Poland,2018,1,1,2
Turkey,Russia,2018,1,2,3
Albania,Israel,2018,1,0,1
Lithuania,Serbia,2018,0,1,1
Romania,Montenegro,2018,0,0,0
Faroe Islands,Malta,2018,3,1,4
Azerbaijan,Kosovo,2018,0,0,0
Argentina,Guatemala,2018,3,0,3
Taiwan,Malaysia,2018,2,0,2
Ecuador,Jamaica,2018,2,0,2
South Korea,Costa Rica,2018,2,0,2
Mexico,Uruguay,2018,1,4,5
Qatar,China PR,2018,1,0,1
Scotland,Belgium,2018,0,4,4
Singapore,Mauritius,2018,1,1,2
United States,Brazil,2018,0,2,2
Venezuela,Colombia,2018,1,2,3
Maldives,Sri Lanka,2018,0,0,0
Anguilla,French Guiana,2018,0,5,5
Antigua and Barbuda,Saint Lucia,2018,0,3,3
Belize,Bahamas,2018,4,0,4
Switzerland,Iceland,2018,6,0,6
England,Spain,2018,1,2,3
Northern Ireland,Bosnia and Herzegovina,2018,1,2,3
Finland,Hungary,2018,1,0,1
Estonia,Greece,2018,0,1,1
Belarus,San Marino,2018,5,0,5
Luxembourg,Moldova,2018,4,0,4
Brunei,Timor-Leste,2018,1,0,1
Equatorial Guinea,Sudan,2018,1,0,1
Comoros,Cameroon,2018,1,1,2
Gabon,Burundi,2018,1,1,2
Gambia,Algeria,2018,1,1,2
South Africa,Libya,2018,0,0,0
Mauritania,Burkina Faso,2018,2,0,2
Egypt,Niger,2018,6,0,6
Namibia,Zambia,2018,1,1,2
Uganda,Tanzania,2018,0,0,0
Pakistan,Bhutan,2018,3,0,3
Bangladesh,Nepal,2018,0,2,2
Saint Vincent and the Grenadines,Nicaragua,2018,0,2,2
Cuba,Turks and Caicos Islands,2018,11,0,11
Montserrat,El Salvador,2018,1,2,3
France,Netherlands,2018,2,1,3
Ukraine,Slovakia,2018,1,0,1
Denmark,Wales,2018,2,0,2
Bulgaria,Norway,2018,1,0,1
Cyprus,Slovenia,2018,2,1,3
Georgia,Latvia,2018,1,0,1
North Macedonia,Armenia,2018,2,0,2
Liechtenstein,Gibraltar,2018,2,0,2
Germany,Peru,2018,2,1,3
Lebanon,Oman,2018,0,0,0
Congo,Zimbabwe,2018,1,1,2
Rwanda,Ivory Coast,2018,1,2,3
India,Maldives,2018,2,0,2
Bonaire,Dominican Republic,2018,0,5,5
United States Virgin Islands,Canada,2018,0,8,8
Aruba,Bermuda,2018,3,1,4
Jamaica,Cayman Islands,2018,4,0,4
Saint Kitts and Nevis,Puerto Rico,2018,1,0,1
Portugal,Italy,2018,1,0,1
Sweden,Turkey,2018,2,3,5
Scotland,Albania,2018,2,0,2
Montenegro,Lithuania,2018,2,0,2
Serbia,Romania,2018,2,2,4
Andorra,Kazakhstan,2018,1,1,2
Kosovo,Faroe Islands,2018,2,0,2
Malta,Azerbaijan,2018,1,1,2
Bahrain,China PR,2018,0,0,0
Cambodia,Malaysia,2018,1,3,4
Kuwait,Iraq,2018,2,2,4
Kyrgyzstan,Syria,2018,2,1,3
Russia,Czech Republic,2018,5,1,6
Saudi Arabia,Bolivia,2018,2,2,4
Haiti,Sint Maarten,2018,13,0,13
Curaçao,Grenada,2018,10,0,10
Iceland,Belgium,2018,0,3,3
Spain,Croatia,2018,6,0,6
Bosnia and Herzegovina,Austria,2018,1,0,1
Hungary,Greece,2018,2,1,3
Finland,Estonia,2018,1,0,1
San Marino,Luxembourg,2018,0,3,3
Moldova,Belarus,2018,0,0,0
Colombia,Argentina,2018,0,0,0
Ecuador,Guatemala,2018,2,0,2
England,Switzerland,2018,1,0,1
Gabon,Zambia,2018,0,1,1
Indonesia,Mauritius,2018,1,0,1
Japan,Costa Rica,2018,3,0,3
Jordan,Oman,2018,0,0,0
Kenya,Malawi,2018,1,0,1
South Korea,Chile,2018,0,0,0
Laos,United Arab Emirates,2018,0,3,3
Liberia,Nigeria,2018,1,2,3
Northern Ireland,Israel,2018,3,0,3
Panama,Venezuela,2018,0,2,2
Poland,Republic of Ireland,2018,1,1,2
Qatar,Palestine,2018,3,0,3
Singapore,Fiji,2018,2,0,2
United States,Mexico,2018,1,0,1
Uzbekistan,Iran,2018,0,1,1
Saint Martin,Guadeloupe,2018,0,3,3
Brazil,El Salvador,2018,5,0,5
India,Pakistan,2018,3,1,4
Nepal,Maldives,2018,0,3,3
Maldives,India,2018,2,1,3
Botswana,Namibia,2018,1,0,1
Saint Vincent and the Grenadines,Barbados,2018,1,1,2
Albania,Jordan,2018,0,0,0
Indonesia,Myanmar,2018,3,0,3
Italy,Ukraine,2018,1,1,2
Ethiopia,Kenya,2018,0,0,0
Zambia,Guinea-Bissau,2018,2,1,3
Poland,Portugal,2018,2,3,5
Russia,Sweden,2018,0,0,0
Israel,Scotland,2018,2,1,3
Montenegro,Serbia,2018,0,2,2
Lithuania,Romania,2018,1,2,3
Faroe Islands,Azerbaijan,2018,0,3,3
Kosovo,Malta,2018,3,1,4
Argentina,Iraq,2018,4,0,4
Bahrain,Syria,2018,0,1,1
France,Iceland,2018,2,2,4
Honduras,United Arab Emirates,2018,1,1,2
Hong Kong,Thailand,2018,0,1,1
Kuwait,Lebanon,2018,1,0,1
Mexico,Costa Rica,2018,3,2,5
Turkey,Bosnia and Herzegovina,2018,0,0,0
United States,Colombia,2018,2,4,6
Wales,Spain,2018,1,4,5
Congo,Liberia,2018,3,1,4
French Guiana,Saint Vincent and the Grenadines,2018,0,1,1
Belgium,Switzerland,2018,2,1,3
Croatia,England,2018,0,0,0
Austria,Northern Ireland,2018,1,0,1
Estonia,Finland,2018,0,1,1
Greece,Hungary,2018,1,0,1
Belarus,Luxembourg,2018,1,0,1
Moldova,San Marino,2018,2,0,2
Cambodia,Timor-Leste,2018,2,2,4
Japan,Panama,2018,3,0,3
South Korea,Uruguay,2018,2,1,3
Peru,Chile,2018,3,0,3
Qatar,Ecuador,2018,4,3,7
Saudi Arabia,Brazil,2018,0,2,2
Singapore,Mongolia,2018,2,0,2
Sri Lanka,Malaysia,2018,1,4,5
Cameroon,Malawi,2018,1,0,1
Gabon,South Sudan,2018,3,0,3
Togo,Gambia,2018,1,1,2
Ivory Coast,Central African Republic,2018,4,0,4
Angola,Mauritania,2018,4,1,5
Egypt,Eswatini,2018,4,1,5
Cape Verde,Tanzania,2018,3,0,3
Basque Country,Venezuela,2018,4,2,6
United States Virgin Islands,Curaçao,2018,0,5,5
Bahamas,Antigua and Barbuda,2018,0,6,6
Dominican Republic,Cayman Islands,2018,3,0,3
Bermuda,Sint Maarten,2018,12,0,12
Grenada,Cuba,2018,0,2,2
Netherlands,Germany,2018,3,0,3
Slovakia,Czech Republic,2018,1,2,3
Republic of Ireland,Denmark,2018,0,0,0
Norway,Slovenia,2018,1,0,1
Bulgaria,Cyprus,2018,2,1,3
Latvia,Kazakhstan,2018,1,1,2
Georgia,Andorra,2018,3,0,3
Armenia,Gibraltar,2018,0,1,1
North Macedonia,Liechtenstein,2018,4,1,5
China PR,India,2018,0,0,0
Myanmar,Bolivia,2018,0,3,3
Oman,Philippines,2018,1,1,2
Uzbekistan,North Korea,2018,2,0,2
Equatorial Guinea,Madagascar,2018,0,1,1
Nigeria,Libya,2018,4,0,4
Puerto Rico,Martinique,2018,0,1,1
Turks and Caicos Islands,Guyana,2018,0,8,8
Suriname,British Virgin Islands,2018,5,0,5
El Salvador,Barbados,2018,3,0,3
Poland,Italy,2018,0,1,1
Russia,Turkey,2018,2,0,2
Israel,Albania,2018,2,0,2
Romania,Serbia,2018,0,0,0
Lithuania,Montenegro,2018,1,4,5
Faroe Islands,Kosovo,2018,1,1,2
Azerbaijan,Malta,2018,1,1,2
Scotland,Portugal,2018,1,3,4
Thailand,Trinidad and Tobago,2018,1,0,1
Guinea-Bissau,Zambia,2018,2,1,3
Saint Martin,Saint Kitts and Nevis,2018,0,10,10
Bonaire,Jamaica,2018,0,6,6
Montserrat,Belize,2018,1,0,1
Nicaragua,Anguilla,2018,6,0,6
Iceland,Switzerland,2018,1,2,3
Spain,England,2018,2,3,5
Bosnia and Herzegovina,Northern Ireland,2018,2,0,2
Estonia,Hungary,2018,3,3,6
Finland,Greece,2018,2,0,2
Luxembourg,San Marino,2018,3,0,3
Belarus,Moldova,2018,0,0,0
Croatia,Jordan,2018,2,1,3
Kuwait,Australia,2018,0,4,4
Saudi Arabia,Iraq,2018,1,1,2
France,Germany,2018,2,1,3
Ukraine,Czech Republic,2018,1,0,1
Republic of Ireland,Wales,2018,0,1,1
Norway,Bulgaria,2018,1,0,1
Slovenia,Cyprus,2018,1,1,2
Kazakhstan,Andorra,2018,4,0,4
Latvia,Georgia,2018,0,3,3
Armenia,North Macedonia,2018,4,0,4
Gibraltar,Liechtenstein,2018,2,1,3
Bahrain,Myanmar,2018,4,1,5
Belgium,Netherlands,2018,1,1,2
Cambodia,Singapore,2018,1,2,3
China PR,Syria,2018,2,0,2
Colombia,Costa Rica,2018,3,1,4
Denmark,Austria,2018,2,0,2
Indonesia,Hong Kong,2018,1,1,2
Iran,Bolivia,2018,2,1,3
Japan,Uruguay,2018,4,3,7
South Korea,Panama,2018,2,2,4
Laos,Mongolia,2018,1,4,5
Malaysia,Kyrgyzstan,2018,0,1,1
Mexico,Chile,2018,0,1,1
Oman,Ecuador,2018,0,0,0
Sweden,Slovakia,2018,1,1,2
United Arab Emirates,Venezuela,2018,0,2,2
United States,Peru,2018,1,1,2
Uzbekistan,Qatar,2018,2,0,2
Madagascar,Equatorial Guinea,2018,1,0,1
Malawi,Cameroon,2018,0,0,0
Burundi,Mali,2018,1,1,2
Benin,Algeria,2018,1,0,1
Seychelles,South Africa,2018,0,0,0
Liberia,Congo,2018,2,1,3
Central African Republic,Ivory Coast,2018,0,0,0
Mauritania,Angola,2018,1,0,1
Eswatini,Egypt,2018,0,2,2
Tanzania,Cape Verde,2018,2,0,2
Argentina,Brazil,2018,0,1,1
Martinique,British Virgin Islands,2018,4,0,4
Canada,Dominica,2018,5,0,5
Guadeloupe,Aruba,2018,0,0,0
Saint Lucia,Haiti,2018,1,2,3
Parishes of Jersey,Yorkshire,2018,2,1,3
Malaysia,Maldives,2018,3,0,3
Cambodia,Malaysia,2018,0,1,1
Laos,Vietnam,2018,0,3,3
Singapore,Indonesia,2018,1,0,1
Thailand,Timor-Leste,2018,7,0,7
North Korea,Mongolia,2018,4,1,5
Taiwan,Hong Kong,2018,1,2,3
Myanmar,Cambodia,2018,4,1,5
Malaysia,Laos,2018,3,1,4
Indonesia,Timor-Leste,2018,3,1,4
Philippines,Singapore,2018,1,0,1
Taiwan,Mongolia,2018,2,1,3
Hong Kong,North Korea,2018,0,0,0
Switzerland,Qatar,2018,0,1,1
Vanuatu,New Caledonia,2018,0,1,1
Belgium,Iceland,2018,2,0,2
Croatia,Spain,2018,3,2,5
Austria,Bosnia and Herzegovina,2018,0,0,0
Hungary,Estonia,2018,2,0,2
Greece,Finland,2018,1,0,1
Andorra,Georgia,2018,1,1,2
Kazakhstan,Latvia,2018,1,1,2
Luxembourg,Belarus,2018,0,2,2
San Marino,Moldova,2018,0,1,1
England,United States,2018,3,0,3
Germany,Russia,2018,3,0,3
Iran,Trinidad and Tobago,2018,1,0,1
Israel,Guatemala,2018,7,0,7
Peru,Ecuador,2018,0,2,2
Poland,Czech Republic,2018,0,1,1
Republic of Ireland,Northern Ireland,2018,0,0,0
Uzbekistan,Lebanon,2018,0,0,0
Netherlands,France,2018,2,0,2
Slovakia,Ukraine,2018,4,1,5
Wales,Denmark,2018,1,2,3
Slovenia,Norway,2018,1,1,2
Cyprus,Bulgaria,2018,1,1,2
Gibraltar,Armenia,2018,2,6,8
Liechtenstein,North Macedonia,2018,0,2,2
Argentina,Mexico,2018,2,0,2
Brazil,Uruguay,2018,1,0,1
Chile,Costa Rica,2018,2,3,5
Honduras,Panama,2018,1,0,1
Japan,Venezuela,2018,1,1,2
Oman,Syria,2018,1,1,2
Palestine,Pakistan,2018,2,1,3
Saudi Arabia,Yemen,2018,1,0,1
United Arab Emirates,Bolivia,2018,0,0,0
Laos,Myanmar,2018,1,3,4
Vietnam,Malaysia,2018,2,0,2
Morocco,Cameroon,2018,2,0,2
South Sudan,Burundi,2018,2,5,7
Egypt,Tunisia,2018,3,2,5
Taiwan,North Korea,2018,0,2,2
Mongolia,Hong Kong,2018,1,5,6
Grenada,Saint Martin,2018,5,2,7
Bermuda,El Salvador,2018,1,0,1
Aruba,Montserrat,2018,0,2,2
Belize,Puerto Rico,2018,1,0,1
Italy,Portugal,2018,0,0,0
Turkey,Sweden,2018,0,1,1
Albania,Scotland,2018,0,4,4
Serbia,Montenegro,2018,2,1,3
Romania,Lithuania,2018,3,0,3
Malta,Kosovo,2018,0,5,5
Azerbaijan,Faroe Islands,2018,2,0,2
Australia,South Korea,2018,1,1,2
Jordan,India,2018,2,1,3
Vanuatu,New Caledonia,2018,2,2,4
Thailand,Indonesia,2018,4,2,6
Timor-Leste,Philippines,2018,2,3,5
Equatorial Guinea,Senegal,2018,0,1,1
Gambia,Benin,2018,3,1,4
Seychelles,Libya,2018,1,8,9
Namibia,Guinea-Bissau,2018,0,0,0
Uganda,Cape Verde,2018,1,0,1
Cuba,Dominican Republic,2018,1,0,1
Jamaica,Suriname,2018,2,1,3
Cayman Islands,Saint Lucia,2018,0,0,0
Nicaragua,Haiti,2018,0,2,2
Switzerland,Belgium,2018,5,2,7
England,Croatia,2018,2,1,3
Northern Ireland,Austria,2018,1,2,3
Greece,Estonia,2018,0,1,1
Hungary,Finland,2018,2,0,2
San Marino,Belarus,2018,0,2,2
Moldova,Luxembourg,2018,1,1,2
Spain,Bosnia and Herzegovina,2018,1,0,1
Ethiopia,Ghana,2018,0,2,2
Congo,DR Congo,2018,1,1,2
Guinea,Ivory Coast,2018,1,1,2
Angola,Burkina Faso,2018,2,1,3
Yorkshire,Panjab,2018,5,4,9
Turks and Caicos Islands,Saint Vincent and the Grenadines,2018,3,2,5
Bahamas,Anguilla,2018,1,1,2
Barbados,United States Virgin Islands,2018,3,0,3
Saint Kitts and Nevis,Canada,2018,0,1,1
Germany,Netherlands,2018,2,2,4
Czech Republic,Slovakia,2018,1,0,1
Denmark,Republic of Ireland,2018,0,0,0
Bulgaria,Slovenia,2018,1,1,2
Cyprus,Norway,2018,0,2,2
Andorra,Latvia,2018,0,0,0
Georgia,Kazakhstan,2018,2,1,3
North Macedonia,Gibraltar,2018,4,0,4
Liechtenstein,Armenia,2018,2,2,4
Iceland,Qatar,2018,2,2,4
Oman,Bahrain,2018,2,1,3
Curaçao,Guadeloupe,2018,6,0,6
Martinique,Antigua and Barbuda,2018,4,2,6
Portugal,Poland,2018,1,1,2
Sweden,Russia,2018,2,0,2
Scotland,Israel,2018,3,2,5
Montenegro,Romania,2018,0,1,1
Serbia,Lithuania,2018,4,1,5
Kosovo,Azerbaijan,2018,4,0,4
Malta,Faroe Islands,2018,1,1,2
Albania,Wales,2018,1,0,1
Argentina,Mexico,2018,2,0,2
Australia,Lebanon,2018,3,0,3
Brazil,Cameroon,2018,1,0,1
Chile,Honduras,2018,4,1,5
China PR,Palestine,2018,1,1,2
El Salvador,Haiti,2018,1,0,1
France,Uruguay,2018,1,0,1
Iran,Venezuela,2018,1,1,2
Iraq,Bolivia,2018,0,0,0
Italy,United States,2018,1,0,1
Japan,Kyrgyzstan,2018,4,0,4
Jordan,Saudi Arabia,2018,1,1,2
South Korea,Uzbekistan,2018,4,0,4
Kuwait,Syria,2018,1,2,3
Nigeria,Uganda,2018,0,0,0
Panama,Ecuador,2018,1,2,3
Peru,Costa Rica,2018,2,3,5
South Africa,Paraguay,2018,1,1,2
Tunisia,Morocco,2018,0,1,1
Turkey,Ukraine,2018,0,0,0
United Arab Emirates,Yemen,2018,2,0,2
Myanmar,Vietnam,2018,0,0,0
Cambodia,Laos,2018,3,1,4
Sint Maarten,Dominica,2018,0,2,2
French Guiana,Guyana,2018,2,1,3
Philippines,Thailand,2018,1,1,2
Singapore,Timor-Leste,2018,6,1,7
Vietnam,Cambodia,2018,3,0,3
Malaysia,Myanmar,2018,3,0,3
Indonesia,Philippines,2018,0,0,0
Thailand,Singapore,2018,3,0,3
Malaysia,Thailand,2018,0,0,0
Philippines,Vietnam,2018,1,2,3
Thailand,Malaysia,2018,2,2,4
Vietnam,Philippines,2018,2,1,3
Malaysia,Vietnam,2018,2,2,4
Oman,Tajikistan,2018,2,1,3
Vietnam,Malaysia,2018,1,0,1
Oman,Tajikistan,2018,1,0,1
Palestine,Pakistan,2018,2,0,2
Bahrain,Tajikistan,2018,5,0,5
Jordan,Kyrgyzstan,2018,0,1,1
Qatar,Jordan,2018,2,0,2
Iraq,China PR,2018,2,1,3
Palestine,Iran,2018,1,1,2
Afghanistan,Turkmenistan,2018,0,2,2
Qatar,Kyrgyzstan,2018,1,0,1
Vietnam,North Korea,2018,1,1,2
Bahrain,Lebanon,2018,1,0,1
India,Oman,2018,0,0,0
Qatar,Algeria,2018,0,1,1
China PR,Jordan,2018,1,1,2
Iraq,Palestine,2018,1,0,1
United Arab Emirates,Kuwait,2018,0,2,2
Bahrain,North Korea,2018,4,0,4
Australia,Oman,2018,5,0,5
Yemen,Syria,2018,0,1,1
South Korea,Saudi Arabia,2018,0,0,0
Kyrgyzstan,Palestine,2018,2,1,3
Philippines,Vietnam,2018,2,4,6
Qatar,Iran,2018,1,2,3
Oman,Thailand,2019,2,0,2
United Arab Emirates,Bahrain,2019,1,1,2
Thailand,India,2019,1,4,5
Australia,Jordan,2019,0,1,1
Syria,Palestine,2019,0,0,0
China PR,Kyrgyzstan,2019,2,1,3
South Korea,Philippines,2019,1,0,1
Iran,Yemen,2019,5,0,5
Finland,Sweden,2019,1,0,1
Iraq,Vietnam,2019,3,2,5
Saudi Arabia,North Korea,2019,4,0,4
Qatar,Lebanon,2019,2,0,2
Japan,Turkmenistan,2019,3,2,5
Uzbekistan,Oman,2019,2,1,3
Bahrain,Thailand,2019,0,1,1
Jordan,Syria,2019,2,0,2
United Arab Emirates,India,2019,2,0,2
Estonia,Finland,2019,2,1,3
Iceland,Sweden,2019,2,2,4
Palestine,Australia,2019,0,3,3
Philippines,China PR,2019,0,3,3
Kyrgyzstan,South Korea,2019,0,1,1
Vietnam,Iran,2019,0,2,2
Yemen,Iraq,2019,0,3,3
Lebanon,Saudi Arabia,2019,0,2,2
North Korea,Qatar,2019,0,6,6
Oman,Japan,2019,0,1,1
Turkmenistan,Uzbekistan,2019,0,4,4
India,Bahrain,2019,0,1,1
United Arab Emirates,Thailand,2019,1,1,2
Estonia,Iceland,2019,0,0,0
Australia,Syria,2019,3,2,5
Palestine,Jordan,2019,0,0,0
South Korea,China PR,2019,2,0,2
Kyrgyzstan,Philippines,2019,3,1,4
Iran,Iraq,2019,0,0,0
Vietnam,Yemen,2019,2,0,2
Lebanon,North Korea,2019,4,1,5
Saudi Arabia,Qatar,2019,0,2,2
Japan,Uzbekistan,2019,2,1,3
Oman,Turkmenistan,2019,3,1,4
Iran,Oman,2019,2,0,2
Jordan,Vietnam,2019,1,1,2
Thailand,China PR,2019,1,2,3
Australia,Uzbekistan,2019,0,0,0
Japan,Saudi Arabia,2019,1,0,1
United Arab Emirates,Kyrgyzstan,2019,3,2,5
South Korea,Bahrain,2019,2,1,3
Qatar,Iraq,2019,1,0,1
China PR,Iran,2019,0,3,3
Vietnam,Japan,2019,0,1,1
South Korea,Qatar,2019,0,1,1
United Arab Emirates,Australia,2019,1,0,1
United States,Panama,2019,3,0,3
Iran,Japan,2019,0,3,3
United Arab Emirates,Qatar,2019,0,4,4
Japan,Qatar,2019,1,3,4
United States,Costa Rica,2019,2,0,2
Kazakhstan,Moldova,2019,1,0,1
Cuba,Bermuda,2019,5,0,5
Bolivia,Nicaragua,2019,2,2,4
Barbados,Grenada,2019,3,0,3
El Salvador,Guatemala,2019,3,1,4
Cambodia,Bangladesh,2019,0,1,1
Bahamas,Turks and Caicos Islands,2019,6,1,7
Fiji,New Caledonia,2019,3,0,3
Solomon Islands,Vanuatu,2019,3,1,4
Myanmar,Taiwan,2019,0,0,0
Germany,Serbia,2019,1,1,2
Wales,Trinidad and Tobago,2019,1,0,1
Kosovo,Denmark,2019,2,2,4
Kuwait,Nepal,2019,0,0,0
Mauritius,New Caledonia,2019,3,1,4
United Arab Emirates,Saudi Arabia,2019,2,1,3
United States,Ecuador,2019,1,0,1
Northern Ireland,Estonia,2019,2,0,2
Netherlands,Belarus,2019,4,0,4
Croatia,Azerbaijan,2019,2,1,3
Slovakia,Hungary,2019,2,0,2
Austria,Poland,2019,0,1,1
North Macedonia,Latvia,2019,3,1,4
Israel,Slovenia,2019,1,1,2
Cyprus,San Marino,2019,5,0,5
Belgium,Russia,2019,3,1,4
Kazakhstan,Scotland,2019,3,0,3
British Virgin Islands,Turks and Caicos Islands,2019,2,2,4
Argentina,Venezuela,2019,1,3,4
Guatemala,Costa Rica,2019,1,0,1
Japan,Colombia,2019,0,1,1
South Korea,Bolivia,2019,1,0,1
Mexico,Chile,2019,3,1,4
Peru,Paraguay,2019,1,0,1
Bulgaria,Montenegro,2019,1,1,2
England,Czech Republic,2019,5,0,5
Portugal,Ukraine,2019,0,0,0
Luxembourg,Lithuania,2019,2,1,3
Albania,Turkey,2019,0,2,2
Andorra,Iceland,2019,0,2,2
Moldova,France,2019,1,4,5
Botswana,Angola,2019,0,1,1
Anguilla,United States Virgin Islands,2019,0,3,3
Saint Vincent and the Grenadines,Bonaire,2019,2,1,3
Cayman Islands,Montserrat,2019,1,2,3
Saint Lucia,Aruba,2019,3,2,5
Brazil,Panama,2019,1,1,2
Malaysia,Afghanistan,2019,2,1,3
Oman,Singapore,2019,1,1,2
Georgia,Switzerland,2019,0,2,2
Gibraltar,Republic of Ireland,2019,0,1,1
Malta,Faroe Islands,2019,2,1,3
Sweden,Romania,2019,2,1,3
Spain,Norway,2019,2,1,3
Bosnia and Herzegovina,Armenia,2019,2,1,3
Italy,Finland,2019,2,0,2
Liechtenstein,Greece,2019,0,2,2
Senegal,Madagascar,2019,2,0,2
Cameroon,Comoros,2019,3,0,3
Mali,South Sudan,2019,3,0,3
Ghana,Kenya,2019,1,0,1
Niger,Egypt,2019,1,1,2
Zambia,Namibia,2019,4,1,5
Dominica,Bahamas,2019,4,0,4
Sint Maarten,Saint Martin,2019,4,3,7
Antigua and Barbuda,Curaçao,2019,2,1,3
Guyana,Belize,2019,2,1,3
Suriname,Saint Kitts and Nevis,2019,2,0,2
Guadeloupe,Martinique,2019,0,1,1
Taiwan,Solomon Islands,2019,0,1,1
Fiji,Mauritius,2019,1,0,1
Northern Ireland,Belarus,2019,2,1,3
Netherlands,Germany,2019,2,3,5
Wales,Slovakia,2019,1,0,1
Hungary,Croatia,2019,2,1,3
Israel,Austria,2019,4,2,6
Poland,Latvia,2019,2,0,2
Slovenia,North Macedonia,2019,1,1,2
San Marino,Scotland,2019,0,2,2
Kazakhstan,Russia,2019,0,4,4
Cyprus,Belgium,2019,0,2,2
Benin,Togo,2019,2,1,3
Libya,South Africa,2019,1,2,3
Zimbabwe,Congo,2019,2,0,2
Central African Republic,Guinea,2019,0,0,0
Tanzania,Uganda,2019,3,0,3
British Virgin Islands,Bonaire,2019,1,2,3
Puerto Rico,Grenada,2019,0,2,2
Canada,French Guiana,2019,4,1,5
Dominican Republic,Bermuda,2019,1,3,4
Haiti,Cuba,2019,2,1,3
Barbados,Nicaragua,2019,0,1,1
El Salvador,Jamaica,2019,2,0,2
Catalonia,Venezuela,2019,2,1,3
Azerbaijan,Lithuania,2019,0,0,0
Kuwait,Nepal,2019,1,0,1
Myanmar,Indonesia,2019,0,2,2
Saudi Arabia,Equatorial Guinea,2019,3,2,5
Kosovo,Bulgaria,2019,1,1,2
Montenegro,England,2019,1,5,6
Portugal,Serbia,2019,1,1,2
Luxembourg,Ukraine,2019,1,2,3
Turkey,Moldova,2019,4,0,4
Andorra,Albania,2019,0,3,3
France,Iceland,2019,4,0,4
Algeria,Tunisia,2019,1,0,1
Costa Rica,Jamaica,2019,1,0,1
Czech Republic,Brazil,2019,1,3,4
Ghana,Mauritania,2019,3,1,4
Gibraltar,Estonia,2019,0,1,1
Honduras,Ecuador,2019,0,0,0
Ivory Coast,Liberia,2019,1,0,1
Japan,Bolivia,2019,0,1,1
South Korea,Colombia,2019,2,1,3
Morocco,Argentina,2019,0,1,1
Nicaragua,Guatemala,2019,0,1,1
Nigeria,Egypt,2019,1,0,1
Paraguay,Mexico,2019,2,4,6
Peru,El Salvador,2019,0,2,2
Senegal,Mali,2019,2,1,3
United Arab Emirates,Syria,2019,0,0,0
United States,Chile,2019,1,1,2
Republic of Ireland,Georgia,2019,1,0,1
Switzerland,Denmark,2019,3,3,6
Malta,Spain,2019,0,2,2
Norway,Sweden,2019,3,3,6
Romania,Faroe Islands,2019,4,1,5
Bosnia and Herzegovina,Greece,2019,2,2,4
Italy,Liechtenstein,2019,6,0,6
Armenia,Finland,2019,0,2,2
Botswana,Seychelles,2019,2,0,2
Eswatini,Malawi,2019,0,0,0
Yorkshire,Somaliland,2019,6,2,8
Malawi,Eswatini,2019,1,1,2
Seychelles,Botswana,2019,1,3,4
Eswatini,Mauritius,2019,2,2,4
Kernow,Barawa,2019,5,0,5
Cascadia,Chagos Islands,2019,6,3,9
Mozambique,Namibia,2019,1,2,3
Malawi,Seychelles,2019,3,0,3
Eswatini,Comoros,2019,2,2,4
Seychelles,Mozambique,2019,0,0,0
Namibia,Malawi,2019,1,2,3
Laos,Sri Lanka,2019,2,1,3
Comoros,Mauritius,2019,2,1,3
Panama,Basque Country,2019,0,0,0
Mozambique,Malawi,2019,1,1,2
Namibia,Seychelles,2019,3,0,3
Turkey,Greece,2019,2,1,3
Laos,Sri Lanka,2019,2,2,4
Lesotho,Uganda,2019,0,0,0
Zimbabwe,Comoros,2019,2,0,2
Venezuela,Ecuador,2019,1,1,2
Yorkshire,Parishes of Jersey,2019,1,0,1
South Africa,Botswana,2019,2,2,4
Zambia,Malawi,2019,2,2,4
El Salvador,Haiti,2019,1,0,1
France,Bolivia,2019,2,0,2
Luxembourg,Madagascar,2019,3,3,6
Malaysia,Nepal,2019,2,0,2
Turkey,Uzbekistan,2019,0,0,0
Abkhazia,Chameria,2019,3,1,4
Artsakh,Sápmi,2019,3,2,5
Padania,Székely Land,2019,4,0,4
Western Armenia,South Ossetia,2019,1,2,3
Parishes of Jersey,Chagos Islands,2019,9,2,11
Colombia,Panama,2019,3,0,3
Vanuatu,Tahiti,2019,2,0,2
Artsakh,Chameria,2019,1,4,5
Sápmi,Abkhazia,2019,0,1,1
Székely Land,Western Armenia,2019,0,5,5
South Ossetia,Padania,2019,2,1,3
Comoros,Malawi,2019,1,2,3
Artsakh,Abkhazia,2019,1,1,2
Chameria,Sápmi,2019,4,0,4
South Ossetia,Székely Land,2019,2,2,4
Padania,Western Armenia,2019,1,1,2
South Africa,Uganda,2019,1,1,2
Lesotho,Botswana,2019,1,2,3
Zimbabwe,Zambia,2019,0,0,0
Brazil,Qatar,2019,2,0,2
Japan,Trinidad and Tobago,2019,0,0,0
Mexico,Venezuela,2019,3,1,4
Paraguay,Honduras,2019,1,1,2
Peru,Costa Rica,2019,1,0,1
United States,Jamaica,2019,0,1,1
Portugal,Switzerland,2019,3,1,4
Bermuda,Guyana,2019,1,0,1
Chile,Haiti,2019,2,1,3
Taiwan,Nepal,2019,1,1,2
Iran,Syria,2019,5,0,5
Slovakia,Jordan,2019,5,1,6
Tajikistan,Afghanistan,2019,1,1,2
England,Netherlands,2019,1,3,4
Abkhazia,Western Armenia,2019,1,1,2
South Ossetia,Chameria,2019,0,0,0
Padania,Sápmi,2019,4,0,4
Artsakh,Székely Land,2019,2,1,3
Bhutan,Guam,2019,1,0,1
Cambodia,Pakistan,2019,2,0,2
Laos,Bangladesh,2019,0,1,1
Macau,Sri Lanka,2019,1,0,1
Mongolia,Brunei,2019,2,0,2
Czech Republic,Bulgaria,2019,2,1,3
Montenegro,Kosovo,2019,1,1,2
Lithuania,Luxembourg,2019,1,1,2
Ukraine,Serbia,2019,5,0,5
Georgia,Gibraltar,2019,3,0,3
Denmark,Republic of Ireland,2019,1,1,2
Faroe Islands,Spain,2019,1,4,5
Norway,Romania,2019,2,2,4
Sweden,Malta,2019,3,0,3
Austria,Slovenia,2019,1,0,1
North Macedonia,Poland,2019,0,1,1
Latvia,Israel,2019,0,3,3
Lesotho,Zimbabwe,2019,2,2,4
South Africa,Malawi,2019,0,0,0
Argentina,Nicaragua,2019,5,1,6
China PR,Philippines,2019,2,0,2
Fiji,Tahiti,2019,1,1,2
Ivory Coast,Comoros,2019,3,1,4
Kenya,Madagascar,2019,1,0,1
South Korea,Australia,2019,1,0,1
Tunisia,Iraq,2019,2,0,2
Uruguay,Panama,2019,3,0,3
Uzbekistan,North Korea,2019,4,0,4
Malaysia,Timor-Leste,2019,7,1,8
Estonia,Northern Ireland,2019,1,2,3
Belarus,Germany,2019,0,2,2
Croatia,Wales,2019,2,1,3
Azerbaijan,Hungary,2019,1,3,4
Iceland,Albania,2019,1,0,1
Moldova,Andorra,2019,1,0,1
Turkey,France,2019,2,0,2
Russia,San Marino,2019,9,0,9
Scotland,Cyprus,2019,2,1,3
Belgium,Kazakhstan,2019,3,0,3
Finland,Bosnia and Herzegovina,2019,2,0,2
Armenia,Liechtenstein,2019,3,0,3
Greece,Italy,2019,0,3,3
Botswana,Zambia,2019,0,1,1
Angola,Guinea-Bissau,2019,2,0,2
Nigeria,Zimbabwe,2019,0,0,0
Singapore,Solomon Islands,2019,4,3,7
Abkhazia,Chameria,2019,0,0,0
Sápmi,Székely Land,2019,3,2,5
Artsakh,Padania,2019,2,0,2
Brazil,Honduras,2019,7,0,7
Cameroon,Zambia,2019,2,1,3
DR Congo,Burkina Faso,2019,0,0,0
Japan,El Salvador,2019,2,0,2
Mexico,Ecuador,2019,3,2,5
Paraguay,Guatemala,2019,2,0,2
Peru,Colombia,2019,0,3,3
Turkmenistan,Uganda,2019,0,0,0
United States,Venezuela,2019,0,3,3
Switzerland,England,2019,0,0,0
Portugal,Netherlands,2019,1,0,1
Western Armenia,South Ossetia,2019,0,1,1
Czech Republic,Montenegro,2019,3,0,3
Bulgaria,Kosovo,2019,2,3,5
Serbia,Lithuania,2019,4,1,5
Ukraine,Luxembourg,2019,1,0,1
Republic of Ireland,Gibraltar,2019,2,0,2
Denmark,Georgia,2019,5,1,6
Faroe Islands,Norway,2019,0,2,2
Malta,Romania,2019,0,4,4
Spain,Sweden,2019,3,0,3
North Macedonia,Austria,2019,1,4,5
Poland,Israel,2019,4,0,4
Latvia,Slovenia,2019,0,5,5
Vanuatu,Fiji,2019,0,0,0
Germany,Estonia,2019,8,0,8
Belarus,Northern Ireland,2019,0,1,1
Azerbaijan,Slovakia,2019,1,5,6
Hungary,Wales,2019,1,0,1
Iceland,Turkey,2019,2,1,3
Albania,Moldova,2019,2,0,2
Andorra,France,2019,0,4,4
Kazakhstan,San Marino,2019,4,0,4
Belgium,Scotland,2019,3,0,3
Russia,Cyprus,2019,1,0,1
Italy,Bosnia and Herzegovina,2019,2,1,3
Liechtenstein,Finland,2019,0,2,2
Greece,Armenia,2019,2,3,5
Algeria,Burundi,2019,1,1,2
Benin,Guinea,2019,1,0,1
China PR,Tajikistan,2019,1,0,1
Croatia,Tunisia,2019,1,2,3
Hong Kong,Taiwan,2019,0,2,2
Jordan,Indonesia,2019,4,1,5
South Korea,Iran,2019,1,1,2
Kyrgyzstan,Palestine,2019,2,2,4
Singapore,Myanmar,2019,1,2,3
Uzbekistan,Syria,2019,2,0,2
Bangladesh,Laos,2019,0,0,0
Brunei,Mongolia,2019,2,1,3
Guam,Bhutan,2019,5,0,5
Pakistan,Cambodia,2019,1,2,3
Sri Lanka,Macau,2019,3,0,3
Malaysia,Timor-Leste,2019,5,1,6
Morocco,Gambia,2019,0,1,1
Ynys Môn,Saint Helena,2019,7,2,9
Egypt,Tanzania,2019,1,0,1
Cameroon,Mali,2019,1,1,2
Madagascar,Mauritania,2019,1,3,4
Brazil,Bolivia,2019,3,0,3
Venezuela,Peru,2019,0,0,0
Argentina,Colombia,2019,0,2,2
Canada,Martinique,2019,4,0,4
Mexico,Cuba,2019,7,0,7
Ghana,South Africa,2019,0,0,0
Indonesia,Vanuatu,2019,6,0,6
Ivory Coast,Uganda,2019,0,1,1
Kenya,DR Congo,2019,1,1,2
Tanzania,Zimbabwe,2019,1,1,2
Jersey,Orkney,2019,5,0,5
Ynys Môn,Western Isles,2019,2,1,3
Alderney,Hitra,2019,2,4,6
Saint Helena,Shetland,2019,1,6,7
Paraguay,Qatar,2019,2,2,4
Uruguay,Ecuador,2019,4,0,4
Haiti,Bermuda,2019,2,1,3
Costa Rica,Nicaragua,2019,4,0,4
Algeria,Mali,2019,3,2,5
Egypt,Guinea,2019,3,1,4
Morocco,Zambia,2019,2,3,5
Senegal,Nigeria,2019,1,0,1
Ynys Môn,Orkney,2019,3,1,4
Jersey,Western Isles,2019,7,0,7
Isle of Man,Hitra,2019,7,1,8
Guernsey,Shetland,2019,2,1,3
Japan,Chile,2019,0,4,4
Curaçao,El Salvador,2019,0,1,1
Jamaica,Honduras,2019,3,2,5
Tunisia,Burundi,2019,2,1,3
Ynys Môn,Jersey,2019,1,0,1
Western Isles,Orkney,2019,1,2,3
Isle of Man,Alderney,2019,6,1,7
Guernsey,Saint Helena,2019,9,0,9
Bolivia,Peru,2019,1,3,4
Brazil,Venezuela,2019,0,0,0
Panama,Trinidad and Tobago,2019,2,0,2
United States,Guyana,2019,4,0,4
Benin,Mauritania,2019,3,1,4
Colombia,Qatar,2019,1,0,1
Argentina,Paraguay,2019,1,1,2
Cuba,Martinique,2019,0,3,3
Mexico,Canada,2019,3,1,4
Ivory Coast,Zambia,2019,4,1,5
Western Isles,Saint Helena,2019,2,1,3
Orkney,Alderney,2019,1,2,3
Jersey,Hitra,2019,3,1,4
Ynys Môn,Shetland,2019,2,1,3
Isle of Man,Guernsey,2019,2,3,5
Uruguay,Japan,2019,2,2,4
Nicaragua,Haiti,2019,0,2,2
Costa Rica,Bermuda,2019,2,1,3
Shetland,Isle of Man,2019,0,5,5
Ynys Môn,Guernsey,2019,2,1,3
Egypt,Zimbabwe,2019,1,0,1
Ecuador,Chile,2019,1,2,3
El Salvador,Jamaica,2019,0,0,0
Honduras,Curaçao,2019,0,1,1
DR Congo,Uganda,2019,0,2,2
Nigeria,Burundi,2019,1,0,1
Guinea,Madagascar,2019,2,2,4
Bolivia,Venezuela,2019,1,3,4
Guyana,Panama,2019,2,4,6
United States,Trinidad and Tobago,2019,6,0,6
Brazil,Peru,2019,5,0,5
Senegal,Tanzania,2019,2,0,2
Algeria,Kenya,2019,2,0,2
Morocco,Namibia,2019,1,0,1
Colombia,Paraguay,2019,1,0,1
Qatar,Argentina,2019,0,2,2
Canada,Cuba,2019,7,0,7
Martinique,Mexico,2019,2,3,5
Ivory Coast,South Africa,2019,1,0,1
Tunisia,Angola,2019,1,1,2
Mali,Mauritania,2019,4,1,5
Chile,Uruguay,2019,0,1,1
Ecuador,Japan,2019,1,1,2
Bermuda,Nicaragua,2019,2,0,2
Haiti,Costa Rica,2019,2,1,3
Cameroon,Guinea-Bissau,2019,2,0,2
Ghana,Benin,2019,2,2,4
Jamaica,Curaçao,2019,1,1,2
Honduras,El Salvador,2019,4,0,4
Uganda,Zimbabwe,2019,1,1,2
Egypt,DR Congo,2019,2,0,2
Nigeria,Guinea,2019,1,0,1
Trinidad and Tobago,Guyana,2019,1,1,2
United States,Panama,2019,1,0,1
Madagascar,Burundi,2019,1,0,1
Senegal,Algeria,2019,0,1,1
Kenya,Tanzania,2019,3,2,5
Brazil,Paraguay,2019,0,0,0
Morocco,Ivory Coast,2019,1,0,1
South Africa,Namibia,2019,1,0,1
Tunisia,Mali,2019,1,1,2
Colombia,Chile,2019,0,0,0
Venezuela,Argentina,2019,0,2,2
Mauritania,Angola,2019,0,0,0
Cameroon,Ghana,2019,0,0,0
Benin,Guinea-Bissau,2019,0,0,0
Uruguay,Peru,2019,0,0,0
Haiti,Canada,2019,3,2,5
Mexico,Costa Rica,2019,1,1,2
Egypt,Uganda,2019,2,0,2
Zimbabwe,DR Congo,2019,0,4,4
Burundi,Guinea,2019,0,2,2
Madagascar,Nigeria,2019,2,0,2
Jamaica,Panama,2019,1,0,1
United States,Curaçao,2019,1,0,1
Kenya,Senegal,2019,0,3,3
Tanzania,Algeria,2019,0,3,3
Namibia,Ivory Coast,2019,1,4,5
South Africa,Morocco,2019,0,1,1
Angola,Mali,2019,0,1,1
Mauritania,Tunisia,2019,0,0,0
Benin,Cameroon,2019,0,0,0
Guinea-Bissau,Ghana,2019,0,2,2
Brazil,Argentina,2019,2,0,2
Haiti,Mexico,2019,0,1,1
Chile,Peru,2019,0,3,3
United States,Jamaica,2019,3,1,4
Morocco,Benin,2019,1,1,2
Uganda,Senegal,2019,0,1,1
Egypt,South Africa,2019,0,1,1
Nigeria,Cameroon,2019,3,2,5
Argentina,Chile,2019,2,1,3
Algeria,Guinea,2019,3,0,3
Madagascar,DR Congo,2019,2,2,4
Brazil,Peru,2019,3,1,4
United States,Mexico,2019,0,1,1
India,Tajikistan,2019,2,4,6
Ghana,Tunisia,2019,1,1,2
Mali,Ivory Coast,2019,0,1,1
Samoa,Papua New Guinea,2019,0,6,6
American Samoa,New Caledonia,2019,0,5,5
Tuvalu,Solomon Islands,2019,0,13,13
Tahiti,Fiji,2019,1,2,3
Syria,North Korea,2019,5,2,7
Nigeria,South Africa,2019,2,1,3
Senegal,Benin,2019,1,0,1
Papua New Guinea,Vanuatu,2019,2,0,2
Tuvalu,Tahiti,2019,0,7,7
American Samoa,Fiji,2019,0,9,9
Solomon Islands,New Caledonia,2019,0,2,2
Tajikistan,Syria,2019,2,0,2
Ivory Coast,Algeria,2019,1,1,2
Madagascar,Tunisia,2019,0,3,3
Samoa,Tonga,2019,2,0,2
American Samoa,Tuvalu,2019,1,1,2
Solomon Islands,Tahiti,2019,0,3,3
New Caledonia,Fiji,2019,1,0,1
India,North Korea,2019,2,5,7
Algeria,Nigeria,2019,2,1,3
Senegal,Tunisia,2019,1,0,1
Tonga,Vanuatu,2019,0,14,14
Fiji,Tuvalu,2019,10,1,11
Solomon Islands,American Samoa,2019,13,0,13
Tahiti,New Caledonia,2019,0,3,3
North Korea,Tajikistan,2019,1,0,1
India,Syria,2019,1,1,2
Tunisia,Nigeria,2019,0,1,1
Papua New Guinea,Tonga,2019,8,0,8
Samoa,Vanuatu,2019,0,11,11
New Caledonia,Tuvalu,2019,11,0,11
American Samoa,Tahiti,2019,8,1,9
Fiji,Solomon Islands,2019,4,4,8
Senegal,Algeria,2019,0,1,1
Tajikistan,North Korea,2019,0,1,1
Papua New Guinea,Fiji,2019,1,1,2
Equatorial Guinea,Liberia,2019,1,1,2
Djibouti,Ethiopia,2019,0,1,1
Botswana,Zambia,2019,0,0,0
Comoros,Namibia,2019,0,2,2
Burundi,South Sudan,2019,2,0,2
Somalia,Uganda,2019,1,3,4
Cape Verde,Mauritania,2019,0,0,0
Guinea-Bissau,Mali,2019,0,4,4
Chad,Equatorial Guinea,2019,3,3,6
Tanzania,Kenya,2019,0,0,0
Lesotho,South Africa,2019,3,2,5
Madagascar,Mozambique,2019,1,0,1
Eswatini,Angola,2019,1,1,2
Liberia,Senegal,2019,1,0,1
Benin,Togo,2019,0,0,0
Mauritius,Zimbabwe,2019,0,4,4
Uganda,Somalia,2019,4,1,5
Angola,Eswatini,2019,1,1,2
Zambia,Botswana,2019,3,2,5
Mauritania,Cape Verde,2019,2,1,3
Senegal,Liberia,2019,3,0,3
Equatorial Guinea,Chad,2019,2,1,3
Ethiopia,Djibouti,2019,4,3,7
Kenya,Tanzania,2019,0,0,0
South Sudan,Burundi,2019,1,2,3
Mozambique,Madagascar,2019,3,2,5
Namibia,Comoros,2019,0,0,0
South Africa,Lesotho,2019,0,3,3
Zimbabwe,Mauritius,2019,3,1,4
Mali,Guinea-Bissau,2019,3,0,3
Togo,Benin,2019,1,0,1
Saint Vincent and the Grenadines,Trinidad and Tobago,2019,1,0,1
Dominican Republic,Guatemala,2019,0,0,0
Saint Kitts and Nevis,Antigua and Barbuda,2019,4,3,7
Belize,Saint Vincent and the Grenadines,2019,1,1,2
Taiwan,Guam,2019,3,0,3
United Arab Emirates,Dominican Republic,2019,4,0,4
Belize,Saint Vincent and the Grenadines,2019,1,0,1
China PR,Myanmar,2019,4,1,5
Malaysia,Jordan,2019,0,1,1
United Arab Emirates,Sri Lanka,2019,5,1,6
Libya,Burkina Faso,2019,0,1,1
Burundi,Tanzania,2019,1,1,2
Djibouti,Eswatini,2019,2,1,3
Eritrea,Namibia,2019,1,2,3
Ethiopia,Lesotho,2019,0,0,0
Liberia,Sierra Leone,2019,3,1,4
Mauritius,Mozambique,2019,0,1,1
São Tomé and Príncipe,Guinea-Bissau,2019,0,1,1
South Sudan,Equatorial Guinea,2019,1,1,2
Argentina,Chile,2019,0,0,0
Honduras,Puerto Rico,2019,4,0,4
South Korea,Georgia,2019,2,2,4
Montenegro,Hungary,2019,2,1,3
Northern Ireland,Luxembourg,2019,1,0,1
Peru,Ecuador,2019,0,1,1
Saudi Arabia,Mali,2019,1,1,2
Republic of Ireland,Switzerland,2019,1,1,2
Gibraltar,Denmark,2019,0,6,6
Faroe Islands,Sweden,2019,0,4,4
Norway,Malta,2019,2,0,2
Romania,Spain,2019,1,2,3
Israel,North Macedonia,2019,1,1,2
Armenia,Italy,2019,1,3,4
Bosnia and Herzegovina,Liechtenstein,2019,5,0,5
Finland,Greece,2019,1,0,1
Japan,Paraguay,2019,2,0,2
Bermuda,Panama,2019,1,4,5
Grenada,Saint Kitts and Nevis,2019,2,1,3
French Guiana,Belize,2019,3,0,3
Dominica,Suriname,2019,1,2,3
United States Virgin Islands,Cayman Islands,2019,0,2,2
Barbados,Saint Martin,2019,4,0,4
Guatemala,Anguilla,2019,10,0,10
Guam,Maldives,2019,0,1,1
Philippines,Syria,2019,2,5,7
Taiwan,Jordan,2019,1,2,3
Kuwait,Nepal,2019,7,0,7
Cambodia,Hong Kong,2019,1,1,2
Bahrain,Iraq,2019,1,1,2
Palestine,Uzbekistan,2019,2,0,2
Singapore,Yemen,2019,2,2,4
India,Oman,2019,1,2,3
Qatar,Afghanistan,2019,6,0,6
Mongolia,Myanmar,2019,1,0,1
Tajikistan,Kyrgyzstan,2019,1,0,1
Thailand,Vietnam,2019,0,0,0
Indonesia,Malaysia,2019,2,3,5
North Korea,Lebanon,2019,2,0,2
Sri Lanka,Turkmenistan,2019,0,2,2
Chad,Sudan,2019,1,3,4
Seychelles,Rwanda,2019,0,3,3
Somalia,Zimbabwe,2019,1,0,1
Brazil,Colombia,2019,2,2,4
Costa Rica,Uruguay,2019,1,2,3
Ivory Coast,Benin,2019,1,2,3
Morocco,Burkina Faso,2019,1,1,2
Tunisia,Mauritania,2019,1,0,1
United States,Mexico,2019,0,3,3
Estonia,Belarus,2019,1,2,3
Germany,Netherlands,2019,2,4,6
Wales,Azerbaijan,2019,2,1,3
Slovakia,Croatia,2019,0,4,4
Austria,Latvia,2019,6,0,6
Slovenia,Poland,2019,2,0,2
Cyprus,Kazakhstan,2019,1,1,2
Scotland,Russia,2019,1,2,3
San Marino,Belgium,2019,0,4,4
Martinique,Trinidad and Tobago,2019,1,1,2
Aruba,Guyana,2019,0,1,1
Jamaica,Antigua and Barbuda,2019,6,0,6
Nicaragua,Saint Vincent and the Grenadines,2019,1,1,2
Bonaire,British Virgin Islands,2019,4,2,6
Comoros,Togo,2019,1,1,2
Gambia,Angola,2019,0,1,1
Libya,Niger,2019,2,0,2
Kosovo,Czech Republic,2019,2,1,3
England,Bulgaria,2019,4,0,4
Lithuania,Ukraine,2019,0,3,3
Serbia,Portugal,2019,2,4,6
Iceland,Moldova,2019,3,0,3
France,Albania,2019,4,1,5
Turkey,Andorra,2019,1,0,1
Canada,Cuba,2019,6,0,6
Curaçao,Haiti,2019,1,0,1
Montserrat,Dominican Republic,2019,2,1,3
El Salvador,Saint Lucia,2019,3,0,3
Guadeloupe,Sint Maarten,2019,5,1,6
Botswana,Malawi,2019,0,0,0
Kenya,Uganda,2019,1,1,2
Switzerland,Gibraltar,2019,4,0,4
Georgia,Denmark,2019,0,0,0
Romania,Malta,2019,1,0,1
Spain,Faroe Islands,2019,4,0,4
Sweden,Norway,2019,1,1,2
Armenia,Bosnia and Herzegovina,2019,4,2,6
Finland,Italy,2019,1,2,3
Greece,Liechtenstein,2019,1,1,2
Panama,Bermuda,2019,0,2,2
Belize,Grenada,2019,1,2,3
Saint Kitts and Nevis,French Guiana,2019,2,2,4
Saint Vincent and the Grenadines,Dominica,2019,1,0,1
Suriname,Nicaragua,2019,6,0,6
Saint Martin,United States Virgin Islands,2019,1,2,3
Cayman Islands,Barbados,2019,3,2,5
Equatorial Guinea,South Sudan,2019,1,0,1
Lesotho,Ethiopia,2019,1,1,2
Sierra Leone,Liberia,2019,1,0,1
Tanzania,Burundi,2019,1,1,2
Algeria,Benin,2019,1,0,1
Iraq,Uzbekistan,2019,0,0,0
Wales,Belarus,2019,1,0,1
Northern Ireland,Germany,2019,0,2,2
Estonia,Netherlands,2019,0,4,4
Azerbaijan,Croatia,2019,1,1,2
Hungary,Slovakia,2019,1,2,3
Poland,Austria,2019,0,0,0
Slovenia,Israel,2019,3,2,5
Latvia,North Macedonia,2019,0,2,2
Scotland,Belgium,2019,0,4,4
Russia,Kazakhstan,2019,1,0,1
San Marino,Cyprus,2019,0,4,4
Trinidad and Tobago,Martinique,2019,2,2,4
Antigua and Barbuda,Aruba,2019,2,1,3
Guyana,Jamaica,2019,0,4,4
Bahamas,Bonaire,2019,2,1,3
Argentina,Mexico,2019,4,0,4
Brazil,Peru,2019,0,1,1
Colombia,Venezuela,2019,0,0,0
Ecuador,Bolivia,2019,3,0,3
Honduras,Chile,2019,2,1,3
Ivory Coast,Tunisia,2019,2,1,3
Jordan,Paraguay,2019,2,4,6
Morocco,Niger,2019,1,0,1
Oman,Lebanon,2019,1,0,1
Republic of Ireland,Bulgaria,2019,3,1,4
Ukraine,Nigeria,2019,2,2,4
United States,Uruguay,2019,1,1,2
England,Kosovo,2019,5,3,8
Montenegro,Czech Republic,2019,0,3,3
Luxembourg,Serbia,2019,1,3,4
Lithuania,Portugal,2019,1,5,6
Albania,Iceland,2019,4,2,6
France,Andorra,2019,3,0,3
Moldova,Turkey,2019,0,4,4
Cuba,Canada,2019,0,1,1
Haiti,Curaçao,2019,1,1,2
Montserrat,Saint Lucia,2019,1,1,2
Dominican Republic,El Salvador,2019,1,0,1
Puerto Rico,Guatemala,2019,0,5,5
Turks and Caicos Islands,Guadeloupe,2019,0,3,3
Guam,Philippines,2019,1,4,5
Maldives,China PR,2019,0,5,5
Kuwait,Australia,2019,0,3,3
Taiwan,Nepal,2019,0,2,2
Cambodia,Bahrain,2019,0,1,1
Hong Kong,Iran,2019,0,2,2
Yemen,Saudi Arabia,2019,2,2,4
Singapore,Palestine,2019,2,1,3
Afghanistan,Bangladesh,2019,1,0,1
Qatar,India,2019,0,0,0
Mongolia,Tajikistan,2019,0,1,1
Myanmar,Japan,2019,0,2,2
Indonesia,Thailand,2019,0,3,3
Malaysia,United Arab Emirates,2019,1,2,3
Turkmenistan,South Korea,2019,0,2,2
Sri Lanka,North Korea,2019,0,1,1
Angola,Gambia,2019,2,1,3
Guinea-Bissau,São Tomé and Príncipe,2019,2,1,3
Malawi,Botswana,2019,1,0,1
Mozambique,Mauritius,2019,2,0,2
Namibia,Eritrea,2019,2,0,2
Rwanda,Seychelles,2019,7,0,7
Sudan,Chad,2019,0,0,0
Eswatini,Djibouti,2019,0,0,0
Togo,Comoros,2019,2,0,2
Zimbabwe,Somalia,2019,3,1,4
DR Congo,Rwanda,2019,2,3,5
Burundi,Uganda,2019,0,3,3
Algeria,Morocco,2019,0,0,0
Tunisia,Libya,2019,1,0,1
Mauritania,Mali,2019,0,0,0
Senegal,Guinea,2019,1,0,1
Central African Republic,DR Congo,2019,0,2,2
Equatorial Guinea,Congo,2019,2,2,4
Ethiopia,Rwanda,2019,0,1,1
Tanzania,Sudan,2019,0,1,1
Madagascar,Namibia,2019,1,0,1
Eswatini,Zambia,2019,0,1,1
Zimbabwe,Lesotho,2019,3,1,4
Ghana,Burkina Faso,2019,0,1,1
Niger,Ivory Coast,2019,2,0,2
Togo,Nigeria,2019,4,1,5
Bangladesh,Bhutan,2019,4,1,5
Botswana,Liberia,2019,0,0,0
Mexico,Trinidad and Tobago,2019,2,0,2
Bangladesh,Bhutan,2019,2,0,2
Jordan,Singapore,2019,0,0,0
Malaysia,Sri Lanka,2019,6,0,6
Djibouti,Gambia,2019,1,1,2
Liberia,Chad,2019,1,0,1
Mauritius,São Tomé and Príncipe,2019,1,3,4
South Sudan,Seychelles,2019,2,1,3
Bahrain,Azerbaijan,2019,2,3,5
Germany,Argentina,2019,2,2,4
Belarus,Estonia,2019,0,0,0
Netherlands,Northern Ireland,2019,3,1,4
Croatia,Hungary,2019,3,0,3
Slovakia,Wales,2019,1,1,2
Austria,Israel,2019,3,1,4
North Macedonia,Slovenia,2019,2,1,3
Latvia,Poland,2019,0,3,3
Kazakhstan,Cyprus,2019,1,2,3
Belgium,San Marino,2019,9,0,9
Russia,Scotland,2019,4,0,4
Algeria,DR Congo,2019,1,1,2
Brazil,Senegal,2019,1,1,2
Cape Verde,Togo,2019,2,1,3
Gabon,Burkina Faso,2019,1,0,1
Kosovo,Gibraltar,2019,1,0,1
Niger,Zambia,2019,1,1,2
Serbia,Paraguay,2019,1,0,1
Thailand,Congo,2019,1,1,2
Venezuela,Bolivia,2019,4,1,5
Trinidad and Tobago,Honduras,2019,0,2,2
Haiti,Costa Rica,2019,1,1,2
Belize,Saint Kitts and Nevis,2019,0,4,4
French Guiana,Grenada,2019,0,0,0
British Virgin Islands,Bahamas,2019,0,4,4
Sint Maarten,Turks and Caicos Islands,2019,2,5,7
Syria,Maldives,2019,2,1,3
China PR,Guam,2019,7,0,7
Jordan,Kuwait,2019,0,0,0
Australia,Nepal,2019,5,0,5
Iran,Cambodia,2019,14,0,14
Iraq,Hong Kong,2019,2,0,2
Uzbekistan,Yemen,2019,5,0,5
Saudi Arabia,Singapore,2019,3,0,3
Bangladesh,Qatar,2019,0,2,2
Oman,Afghanistan,2019,3,0,3
Japan,Mongolia,2019,6,0,6
Kyrgyzstan,Myanmar,2019,7,0,7
United Arab Emirates,Indonesia,2019,5,0,5
Vietnam,Malaysia,2019,1,0,1
Lebanon,Turkmenistan,2019,2,1,3
South Korea,Sri Lanka,2019,8,0,8
Czech Republic,England,2019,2,1,3
Montenegro,Bulgaria,2019,0,0,0
Portugal,Luxembourg,2019,3,0,3
Ukraine,Lithuania,2019,2,0,2
Iceland,France,2019,0,1,1
Andorra,Moldova,2019,1,0,1
Turkey,Albania,2019,1,0,1
Morocco,Libya,2019,1,1,2
Uruguay,Peru,2019,1,0,1
United States,Cuba,2019,7,0,7
Bermuda,Mexico,2019,1,5,6
Antigua and Barbuda,Guyana,2019,2,1,3
Saint Vincent and the Grenadines,Suriname,2019,2,2,4
Nicaragua,Dominica,2019,3,1,4
Georgia,Republic of Ireland,2019,0,0,0
Denmark,Switzerland,2019,1,0,1
Faroe Islands,Romania,2019,0,3,3
Malta,Sweden,2019,0,4,4
Norway,Spain,2019,1,1,2
Bosnia and Herzegovina,Finland,2019,4,1,5
Italy,Greece,2019,2,0,2
Liechtenstein,Armenia,2019,1,1,2
Colombia,Chile,2019,0,0,0
Guinea,Comoros,2019,0,1,1
Ivory Coast,DR Congo,2019,3,1,4
Tunisia,Cameroon,2019,0,0,0
Dominican Republic,Saint Lucia,2019,3,0,3
Montserrat,El Salvador,2019,0,2,2
Jamaica,Aruba,2019,2,0,2
Barbados,United States Virgin Islands,2019,1,0,1
Saint Martin,Cayman Islands,2019,3,0,3
Anguilla,Guatemala,2019,0,5,5
Belarus,Netherlands,2019,1,2,3
Estonia,Germany,2019,0,3,3
Hungary,Azerbaijan,2019,1,0,1
Wales,Croatia,2019,1,1,2
Poland,North Macedonia,2019,2,0,2
Slovenia,Austria,2019,0,1,1
Scotland,San Marino,2019,6,0,6
Cyprus,Russia,2019,0,5,5
Kazakhstan,Belgium,2019,0,2,2
Gambia,Djibouti,2019,1,1,2
Chad,Liberia,2019,1,0,1
São Tomé and Príncipe,Mauritius,2019,2,1,3
Seychelles,South Sudan,2019,0,1,1
Benin,Zambia,2019,2,2,4
Brazil,Nigeria,2019,1,1,2
Ecuador,Argentina,2019,1,6,7
Equatorial Guinea,Togo,2019,1,1,2
Ethiopia,Uganda,2019,0,1,1
Kenya,Mozambique,2019,0,1,1
Lesotho,Malawi,2019,1,1,2
Niger,Central African Republic,2019,0,2,2
Slovakia,Paraguay,2019,1,1,2
South Africa,Mali,2019,2,1,3
Honduras,Martinique,2019,1,0,1
Costa Rica,Curaçao,2019,0,0,0
Saint Kitts and Nevis,Belize,2019,0,1,1
Grenada,French Guiana,2019,1,0,1
British Virgin Islands,Bonaire,2019,3,4,7
Kosovo,Montenegro,2019,2,0,2
Bulgaria,England,2019,0,6,6
Lithuania,Serbia,2019,1,2,3
Ukraine,Portugal,2019,2,1,3
Iceland,Andorra,2019,2,0,2
France,Turkey,2019,1,1,2
Moldova,Albania,2019,0,4,4
Czech Republic,Northern Ireland,2019,2,3,5
Egypt,Botswana,2019,1,0,1
Rwanda,Tanzania,2019,0,0,0
Venezuela,Trinidad and Tobago,2019,2,0,2
Guyana,Antigua and Barbuda,2019,5,1,6
Dominica,Nicaragua,2019,0,4,4
Suriname,Saint Vincent and the Grenadines,2019,0,1,1
Sint Maarten,Guadeloupe,2019,1,2,3
Gibraltar,Georgia,2019,2,3,5
Switzerland,Republic of Ireland,2019,2,0,2
Faroe Islands,Malta,2019,1,0,1
Sweden,Spain,2019,1,1,2
Romania,Norway,2019,1,1,2
Israel,Latvia,2019,3,1,4
Finland,Armenia,2019,3,0,3
Liechtenstein,Italy,2019,0,5,5
Greece,Bosnia and Herzegovina,2019,2,1,3
Algeria,Colombia,2019,3,0,3
Bermuda,Guatemala,2019,0,0,0
Bolivia,Haiti,2019,3,1,4
Chile,Guinea,2019,3,2,5
Denmark,Luxembourg,2019,4,0,4
Kuwait,Turkmenistan,2019,1,1,2
Mauritania,Libya,2019,0,0,0
Morocco,Gabon,2019,2,3,5
Peru,Uruguay,2019,1,1,2
Canada,United States,2019,2,0,2
Mexico,Panama,2019,3,1,4
Dominican Republic,Montserrat,2019,0,0,0
Saint Lucia,El Salvador,2019,0,2,2
Aruba,Jamaica,2019,0,6,6
Cayman Islands,Saint Martin,2019,1,0,1
United States Virgin Islands,Barbados,2019,0,4,4
Anguilla,Puerto Rico,2019,2,3,5
Syria,Guam,2019,4,0,4
Philippines,China PR,2019,0,0,0
Jordan,Nepal,2019,3,0,3
Taiwan,Australia,2019,1,7,8
Cambodia,Iraq,2019,0,4,4
Bahrain,Iran,2019,1,0,1
Palestine,Saudi Arabia,2019,0,0,0
Singapore,Uzbekistan,2019,1,3,4
India,Bangladesh,2019,1,1,2
Qatar,Oman,2019,2,1,3
Mongolia,Kyrgyzstan,2019,1,2,3
Tajikistan,Japan,2019,0,3,3
Thailand,United Arab Emirates,2019,2,1,3
Indonesia,Vietnam,2019,1,3,4
North Korea,South Korea,2019,0,0,0
Sri Lanka,Lebanon,2019,0,3,3
Sudan,Tanzania,2019,1,2,3
Rwanda,Ethiopia,2019,1,1,2
Uganda,Burundi,2019,3,0,3
Morocco,Algeria,2019,3,0,3
Namibia,Madagascar,2019,2,0,2
Zambia,Eswatini,2019,2,2,4
Nigeria,Togo,2019,2,0,2
Congo,Equatorial Guinea,2019,1,0,1
DR Congo,Central African Republic,2019,4,1,5
Libya,Tunisia,2019,1,2,3
Lesotho,Zimbabwe,2019,0,0,0
Guinea,Senegal,2019,1,0,1
Mali,Mauritania,2019,2,0,2
Burkina Faso,Ghana,2019,0,0,0
Ivory Coast,Niger,2019,1,0,1
Egypt,Liberia,2019,1,0,1
Nicaragua,Cuba,2019,0,0,0
Malaysia,Tajikistan,2019,1,0,1
Namibia,Zambia,2019,0,2,2
Uzbekistan,Kyrgyzstan,2019,3,1,4
Nicaragua,Cuba,2019,0,1,1
Trinidad and Tobago,Anguilla,2019,15,0,15
Namibia,Chad,2019,2,1,3
Malawi,South Sudan,2019,1,0,1
Burkina Faso,Uganda,2019,0,0,0
Sudan,São Tomé and Príncipe,2019,4,0,4
Angola,Gambia,2019,1,3,4
Central African Republic,Burundi,2019,2,0,2
Cameroon,Cape Verde,2019,0,0,0
Guinea-Bissau,Eswatini,2019,3,0,3
Senegal,Congo,2019,2,0,2
Nigeria,Benin,2019,2,1,3
Sierra Leone,Lesotho,2019,1,1,2
Mali,Guinea,2019,2,2,4
Ghana,South Africa,2019,2,0,2
DR Congo,Gabon,2019,0,0,0
Mozambique,Rwanda,2019,2,0,2
Egypt,Kenya,2019,1,1,2
Togo,Comoros,2019,0,1,1
Algeria,Zambia,2019,5,0,5
England,Montenegro,2019,7,0,7
Czech Republic,Kosovo,2019,2,1,3
Portugal,Lithuania,2019,6,0,6
Serbia,Luxembourg,2019,3,2,5
Turkey,Iceland,2019,0,0,0
Albania,Andorra,2019,2,2,4
France,Moldova,2019,2,1,3
Martinique,Honduras,2019,1,1,2
Curaçao,Costa Rica,2019,1,2,3
Saint Kitts and Nevis,Grenada,2019,0,0,0
Belize,French Guiana,2019,2,0,2
Bahamas,British Virgin Islands,2019,3,0,3
Turks and Caicos Islands,Sint Maarten,2019,3,2,5
Bulgaria,Paraguay,2019,0,1,1
Cambodia,Mongolia,2019,1,1,2
Ecuador,Trinidad and Tobago,2019,3,0,3
Qatar,Singapore,2019,2,0,2
Republic of Ireland,New Zealand,2019,3,1,4
Ukraine,Estonia,2019,1,0,1
Maldives,Philippines,2019,1,2,3
Syria,China PR,2019,2,1,3
Jordan,Australia,2019,0,1,1
Kuwait,Taiwan,2019,9,0,9
Iraq,Iran,2019,2,1,3
Hong Kong,Bahrain,2019,0,0,0
Uzbekistan,Saudi Arabia,2019,2,3,5
Yemen,Palestine,2019,1,0,1
Afghanistan,India,2019,1,1,2
Oman,Bangladesh,2019,4,1,5
Myanmar,Tajikistan,2019,4,3,7
Kyrgyzstan,Japan,2019,0,2,2
Vietnam,United Arab Emirates,2019,1,0,1
Malaysia,Thailand,2019,2,1,3
Lebanon,South Korea,2019,0,0,0
Turkmenistan,North Korea,2019,3,1,4
Morocco,Mauritania,2019,0,0,0
Zimbabwe,Botswana,2019,0,0,0
Tanzania,Equatorial Guinea,2019,2,1,3
Tunisia,Libya,2019,4,1,5
Denmark,Gibraltar,2019,6,0,6
Switzerland,Georgia,2019,1,0,1
Norway,Faroe Islands,2019,4,0,4
Spain,Malta,2019,7,0,7
Romania,Sweden,2019,0,2,2
Finland,Liechtenstein,2019,3,0,3
Brazil,Argentina,2019,0,1,1
Bosnia and Herzegovina,Italy,2019,0,3,3
Armenia,Greece,2019,0,1,1
United States,Canada,2019,4,1,5
Panama,Mexico,2019,0,3,3
Antigua and Barbuda,Jamaica,2019,0,2,2
Guyana,Aruba,2019,4,2,6
Saint Vincent and the Grenadines,Nicaragua,2019,1,0,1
Suriname,Dominica,2019,4,0,4
Colombia,Peru,2019,1,0,1
Hungary,Uruguay,2019,1,2,3
Ivory Coast,Niger,2019,1,0,1
Madagascar,Ethiopia,2019,1,0,1
Northern Ireland,Netherlands,2019,0,0,0
Germany,Belarus,2019,4,0,4
Croatia,Slovakia,2019,3,1,4
Azerbaijan,Wales,2019,0,2,2
Slovenia,Latvia,2019,1,0,1
Austria,North Macedonia,2019,2,1,3
Israel,Poland,2019,1,2,3
Cyprus,Scotland,2019,1,2,3
San Marino,Kazakhstan,2019,1,3,4
Russia,Belgium,2019,1,4,5
Saint Lucia,Dominican Republic,2019,1,0,1
El Salvador,Montserrat,2019,1,0,1
Saint Martin,Barbados,2019,1,0,1
Cayman Islands,United States Virgin Islands,2019,1,0,1
Guatemala,Puerto Rico,2019,5,0,5
Chad,Mali,2019,0,2,2
Guinea,Namibia,2019,2,0,2
South Sudan,Burkina Faso,2019,1,2,3
Uganda,Malawi,2019,2,0,2
South Africa,Sudan,2019,1,0,1
Gabon,Angola,2019,2,1,3
Rwanda,Cameroon,2019,0,1,1
Congo,Guinea-Bissau,2019,3,0,3
Eswatini,Senegal,2019,1,4,5
Benin,Sierra Leone,2019,1,0,1
Lesotho,Nigeria,2019,2,4,6
Kosovo,England,2019,0,4,4
Bulgaria,Czech Republic,2019,1,0,1
Luxembourg,Portugal,2019,0,2,2
Serbia,Ukraine,2019,2,2,4
Albania,France,2019,0,2,2
Andorra,Turkey,2019,0,2,2
Moldova,Iceland,2019,1,2,3
Honduras,Trinidad and Tobago,2019,4,0,4
Costa Rica,Haiti,2019,1,1,2
Grenada,Belize,2019,3,2,5
French Guiana,Saint Kitts and Nevis,2019,3,1,4
Bonaire,Bahamas,2019,1,1,2
Guadeloupe,Turks and Caicos Islands,2019,10,0,10
Lithuania,New Zealand,2019,1,0,1
São Tomé and Príncipe,Ghana,2019,0,1,1
Gambia,DR Congo,2019,2,2,4
Cape Verde,Mozambique,2019,2,2,4
Comoros,Egypt,2019,0,0,0
Kenya,Togo,2019,1,1,2
Botswana,Algeria,2019,0,1,1
Niger,Madagascar,2019,2,6,8
Republic of Ireland,Denmark,2019,1,1,2
Gibraltar,Switzerland,2019,1,6,7
Malta,Norway,2019,1,2,3
Spain,Romania,2019,5,0,5
Sweden,Faroe Islands,2019,3,0,3
Italy,Armenia,2019,9,1,10
Liechtenstein,Bosnia and Herzegovina,2019,0,3,3
Greece,Finland,2019,2,1,3
Jamaica,Guyana,2019,1,1,2
Aruba,Antigua and Barbuda,2019,2,3,5
Nicaragua,Suriname,2019,1,2,3
Dominica,Saint Vincent and the Grenadines,2019,1,0,1
Argentina,Uruguay,2019,2,2,4
Burundi,Morocco,2019,0,3,3
Mauritania,Central African Republic,2019,2,0,2
Zambia,Zimbabwe,2019,1,2,3
Equatorial Guinea,Tunisia,2019,0,1,1
Libya,Tanzania,2019,2,1,3
Ethiopia,Ivory Coast,2019,2,1,3
Germany,Northern Ireland,2019,6,1,7
Netherlands,Estonia,2019,5,0,5
Wales,Hungary,2019,2,0,2
Slovakia,Azerbaijan,2019,2,0,2
North Macedonia,Israel,2019,1,0,1
Japan,Venezuela,2019,1,4,5
Poland,Slovenia,2019,3,2,5
Latvia,Austria,2019,1,0,1
Scotland,Kazakhstan,2019,3,1,4
Belgium,Cyprus,2019,6,1,7
San Marino,Russia,2019,0,5,5
Cuba,United States,2019,0,4,4
Mexico,Bermuda,2019,2,1,3
El Salvador,Dominican Republic,2019,2,0,2
Saint Lucia,Montserrat,2019,0,1,1
Barbados,Cayman Islands,2019,3,0,3
United States Virgin Islands,Saint Martin,2019,1,2,3
Puerto Rico,Anguilla,2019,3,0,3
Brazil,South Korea,2019,3,0,3
Croatia,Georgia,2019,2,1,3
Ecuador,Colombia,2019,0,1,1
Montenegro,Belarus,2019,2,0,2
Saudi Arabia,Paraguay,2019,0,0,0
Maldives,Guam,2019,3,1,4
Syria,Philippines,2019,1,0,1
Nepal,Kuwait,2019,0,1,1
Jordan,Taiwan,2019,5,0,5
Iraq,Bahrain,2019,0,0,0
Hong Kong,Cambodia,2019,2,0,2
Uzbekistan,Palestine,2019,2,0,2
Yemen,Singapore,2019,1,2,3
Afghanistan,Qatar,2019,0,1,1
Oman,India,2019,1,0,1
Myanmar,Mongolia,2019,1,0,1
Kyrgyzstan,Tajikistan,2019,1,1,2
Vietnam,Thailand,2019,0,0,0
Malaysia,Indonesia,2019,2,0,2
Turkmenistan,Sri Lanka,2019,2,0,2
Lebanon,North Korea,2019,0,0,0
Guatemala,Antigua and Barbuda,2019,8,0,8
Qatar,Iraq,2019,1,2,3
United Arab Emirates,Yemen,2019,3,0,3
Oman,Bahrain,2019,0,0,0
Saudi Arabia,Kuwait,2019,1,3,4
United Arab Emirates,Iraq,2019,0,2,2
Qatar,Yemen,2019,6,0,6
Kuwait,Oman,2019,1,2,3
Bahrain,Saudi Arabia,2019,0,2,2
Qatar,United Arab Emirates,2019,4,2,6
Yemen,Iraq,2019,0,0,0
Kuwait,Bahrain,2019,2,4,6
Oman,Saudi Arabia,2019,1,3,4
Iraq,Bahrain,2019,2,2,4
Qatar,Saudi Arabia,2019,0,1,1
Bahrain,Saudi Arabia,2019,1,0,1
China PR,Japan,2019,1,2,3
South Korea,Hong Kong,2019,2,0,2
Japan,Hong Kong,2019,5,0,5
South Korea,China PR,2019,1,0,1
Hong Kong,China PR,2019,0,2,2
South Korea,Japan,2019,1,0,1
Barbados,Canada,2020,1,4,5
Moldova,Sweden,2020,0,1,1
Barbados,Canada,2020,1,4,5
Kosovo,Sweden,2020,0,1,1
Canada,Iceland,2020,0,1,1
El Salvador,Iceland,2020,0,1,1
United States,Costa Rica,2020,1,0,1
Germany,Spain,2020,1,1,2
Ukraine,Switzerland,2020,2,1,3
Russia,Serbia,2020,3,1,4
Turkey,Hungary,2020,0,1,1
Bulgaria,Republic of Ireland,2020,1,1,2
Finland,Wales,2020,0,1,1
Moldova,Kosovo,2020,1,1,2
Slovenia,Greece,2020,0,0,0
Latvia,Andorra,2020,0,0,0
Faroe Islands,Malta,2020,3,2,5
Italy,Bosnia and Herzegovina,2020,1,1,2
Netherlands,Poland,2020,1,0,1
Norway,Austria,2020,1,2,3
Romania,Northern Ireland,2020,1,1,2
Scotland,Israel,2020,1,1,2
Slovakia,Czech Republic,2020,1,3,4
Lithuania,Kazakhstan,2020,0,2,2
Belarus,Albania,2020,0,2,2
Iceland,England,2020,0,1,1
Denmark,Belgium,2020,0,2,2
Portugal,Croatia,2020,4,1,5
Sweden,France,2020,0,1,1
Cyprus,Montenegro,2020,0,2,2
Azerbaijan,Luxembourg,2020,1,2,3
North Macedonia,Armenia,2020,2,1,3
Estonia,Georgia,2020,0,1,1
Gibraltar,San Marino,2020,1,0,1
Spain,Ukraine,2020,4,0,4
Switzerland,Germany,2020,1,1,2
Hungary,Russia,2020,2,3,5
Serbia,Turkey,2020,0,0,0
Wales,Bulgaria,2020,1,0,1
Republic of Ireland,Finland,2020,0,1,1
Slovenia,Moldova,2020,1,0,1
Kosovo,Greece,2020,1,2,3
Andorra,Faroe Islands,2020,0,1,1
Malta,Latvia,2020,1,1,2
Bosnia and Herzegovina,Poland,2020,1,2,3
Netherlands,Italy,2020,0,1,1
Northern Ireland,Norway,2020,1,5,6
Austria,Romania,2020,2,3,5
Czech Republic,Scotland,2020,1,2,3
Israel,Slovakia,2020,1,1,2
Kazakhstan,Belarus,2020,1,2,3
Albania,Lithuania,2020,0,1,1
Belgium,Iceland,2020,5,1,6
Denmark,England,2020,0,0,0
France,Croatia,2020,4,2,6
Sweden,Portugal,2020,0,2,2
Luxembourg,Montenegro,2020,0,1,1
Cyprus,Azerbaijan,2020,0,1,1
Armenia,Estonia,2020,2,0,2
Georgia,North Macedonia,2020,1,1,2
San Marino,Liechtenstein,2020,0,2,2
Nicaragua,Guatemala,2020,0,0,0
Andorra,Cape Verde,2020,1,2,3
Austria,Greece,2020,2,1,3
Cyprus,Czech Republic,2020,1,2,3
Denmark,Faroe Islands,2020,4,0,4
Estonia,Lithuania,2020,1,3,4
France,Ukraine,2020,7,1,8
Germany,Turkey,2020,3,3,6
Italy,Moldova,2020,6,0,6
Luxembourg,Liechtenstein,2020,1,2,3
Malta,Gibraltar,2020,2,0,2
Montenegro,Latvia,2020,1,1,2
Netherlands,Mexico,2020,0,1,1
Poland,Finland,2020,5,1,6
Portugal,Spain,2020,0,0,0
Slovenia,San Marino,2020,4,0,4
Switzerland,Croatia,2020,1,2,3
Zambia,Malawi,2020,1,0,1
Belgium,Ivory Coast,2020,1,1,2
England,Wales,2020,3,0,3
Russia,Sweden,2020,1,2,3
South Africa,Namibia,2020,1,1,2
Uzbekistan,Iran,2020,1,2,3
Paraguay,Peru,2020,2,2,4
Uruguay,Chile,2020,2,1,3
Argentina,Ecuador,2020,1,0,1
Iceland,Romania,2020,2,1,3
Bulgaria,Hungary,2020,1,3,4
Bosnia and Herzegovina,Northern Ireland,2020,1,1,2
Slovakia,Republic of Ireland,2020,0,0,0
Scotland,Israel,2020,0,0,0
Norway,Serbia,2020,1,2,3
Georgia,Belarus,2020,1,0,1
North Macedonia,Kosovo,2020,2,1,3
Burkina Faso,DR Congo,2020,3,0,3
Congo,Gambia,2020,0,1,1
Japan,Cameroon,2020,0,0,0
Kenya,Zambia,2020,2,1,3
Mali,Ghana,2020,3,0,3
Mauritania,Sierra Leone,2020,2,1,3
Morocco,Senegal,2020,3,1,4
Nigeria,Algeria,2020,0,1,1
Tunisia,Sudan,2020,3,0,3
Colombia,Venezuela,2020,3,0,3
Brazil,Bolivia,2020,5,0,5
Spain,Switzerland,2020,1,0,1
Ukraine,Germany,2020,1,2,3
Luxembourg,Cyprus,2020,2,0,2
Montenegro,Azerbaijan,2020,2,0,2
Faroe Islands,Latvia,2020,1,1,2
Andorra,Malta,2020,0,0,0
Liechtenstein,Gibraltar,2020,0,1,1
Cape Verde,Guinea,2020,1,2,3
Costa Rica,Panama,2020,0,1,1
Honduras,Nicaragua,2020,1,1,2
Niger,Chad,2020,2,0,2
Bosnia and Herzegovina,Netherlands,2020,0,0,0
Poland,Italy,2020,0,0,0
England,Belgium,2020,2,1,3
Iceland,Denmark,2020,0,3,3
Croatia,Sweden,2020,2,1,3
France,Portugal,2020,0,0,0
Norway,Romania,2020,4,0,4
Northern Ireland,Austria,2020,0,1,1
Scotland,Slovakia,2020,1,0,1
Israel,Czech Republic,2020,1,2,3
Serbia,Hungary,2020,0,1,1
Russia,Turkey,2020,1,1,2
Republic of Ireland,Wales,2020,0,0,0
Finland,Bulgaria,2020,2,0,2
Armenia,Georgia,2020,2,2,4
Estonia,North Macedonia,2020,3,3,6
Kosovo,Slovenia,2020,0,1,1
Greece,Moldova,2020,2,0,2
Kazakhstan,Albania,2020,0,0,0
Lithuania,Belarus,2020,2,2,4
Gabon,Benin,2020,0,2,2
Malawi,Zimbabwe,2020,0,0,0
South Africa,Zambia,2020,1,2,3
Tanzania,Burundi,2020,0,1,1
Burkina Faso,Madagascar,2020,2,1,3
Ghana,Qatar,2020,5,1,6
Togo,Sudan,2020,1,1,2
United Arab Emirates,Uzbekistan,2020,1,2,3
Cameroon,South Sudan,2020,0,0,0
Germany,Switzerland,2020,3,3,6
Ukraine,Spain,2020,1,0,1
Azerbaijan,Cyprus,2020,0,0,0
Montenegro,Luxembourg,2020,1,2,3
Latvia,Malta,2020,0,1,1
Faroe Islands,Andorra,2020,2,0,2
Liechtenstein,San Marino,2020,0,0,0
Costa Rica,Panama,2020,0,1,1
Japan,Ivory Coast,2020,1,0,1
Mexico,Algeria,2020,2,2,4
Morocco,DR Congo,2020,1,1,2
Mozambique,Angola,2020,0,3,3
Niger,Sierra Leone,2020,1,0,1
Nigeria,Tunisia,2020,1,1,2
Bolivia,Argentina,2020,1,2,3
Ecuador,Uruguay,2020,4,2,6
Venezuela,Paraguay,2020,0,1,1
Peru,Brazil,2020,2,4,6
Chile,Colombia,2020,2,2,4
Italy,Netherlands,2020,1,1,2
Poland,Bosnia and Herzegovina,2020,3,0,3
Iceland,Belgium,2020,1,2,3
England,Denmark,2020,0,1,1
Portugal,Sweden,2020,3,0,3
Croatia,France,2020,1,2,3
Norway,Northern Ireland,2020,1,0,1
Romania,Austria,2020,0,1,1
Scotland,Czech Republic,2020,1,0,1
Slovakia,Israel,2020,2,3,5
Russia,Hungary,2020,0,0,0
Turkey,Serbia,2020,2,2,4
Finland,Republic of Ireland,2020,1,0,1
Bulgaria,Wales,2020,0,1,1
North Macedonia,Georgia,2020,1,1,2
Estonia,Armenia,2020,1,1,2
Greece,Kosovo,2020,0,0,0
Moldova,Slovenia,2020,0,4,4
Lithuania,Albania,2020,0,0,0
Belarus,Kazakhstan,2020,2,0,2
Ethiopia,Sudan,2020,2,2,4
Bahrain,Tajikistan,2020,1,0,1
Albania,Kosovo,2020,2,1,3
Belgium,Switzerland,2020,2,1,3
Bulgaria,Gibraltar,2020,3,0,3
Denmark,Sweden,2020,2,0,2
France,Finland,2020,0,2,2
Germany,Czech Republic,2020,1,0,1
Greece,Cyprus,2020,2,1,3
Italy,Estonia,2020,4,0,4
Lithuania,Faroe Islands,2020,2,1,3
Luxembourg,Austria,2020,0,3,3
Malta,Liechtenstein,2020,3,0,3
Montenegro,Kazakhstan,2020,0,0,0
Netherlands,Spain,2020,1,1,2
Poland,Ukraine,2020,2,0,2
Portugal,Andorra,2020,7,0,7
Romania,Belarus,2020,5,3,8
San Marino,Latvia,2020,0,3,3
Slovenia,Azerbaijan,2020,0,0,0
Turkey,Croatia,2020,3,3,6
Hungary,Iceland,2020,2,1,3
Northern Ireland,Slovakia,2020,1,2,3
Serbia,Scotland,2020,1,1,2
Georgia,North Macedonia,2020,0,1,1
Bosnia and Herzegovina,Iran,2020,0,2,2
England,Republic of Ireland,2020,3,0,3
Jordan,Iraq,2020,0,0,0
Lebanon,Bahrain,2020,1,3,4
Moldova,Russia,2020,0,0,0
United Arab Emirates,Tajikistan,2020,3,2,5
Uzbekistan,Syria,2020,0,1,1
Wales,United States,2020,0,0,0
Bolivia,Ecuador,2020,2,3,5
Argentina,Paraguay,2020,1,1,2
Bangladesh,Nepal,2020,2,0,2
Costa Rica,Qatar,2020,1,1,2
Japan,Panama,2020,1,0,1
Colombia,Uruguay,2020,0,3,3
Chile,Peru,2020,2,0,2
Brazil,Venezuela,2020,1,0,1
Portugal,France,2020,0,1,1
Sweden,Croatia,2020,2,1,3
Germany,Ukraine,2020,3,1,4
Switzerland,Spain,2020,1,1,2
Azerbaijan,Montenegro,2020,0,0,0
Cyprus,Luxembourg,2020,2,1,3
Malta,Andorra,2020,3,1,4
Latvia,Faroe Islands,2020,1,1,2
San Marino,Gibraltar,2020,0,0,0
Mexico,South Korea,2020,3,2,5
Saudi Arabia,Jamaica,2020,3,0,3
Netherlands,Bosnia and Herzegovina,2020,3,1,4
Italy,Poland,2020,2,0,2
Belgium,England,2020,2,0,2
Denmark,Iceland,2020,2,1,3
Austria,Northern Ireland,2020,2,1,3
Romania,Norway,2020,3,0,3
Slovakia,Scotland,2020,1,0,1
Czech Republic,Israel,2020,1,0,1
Turkey,Russia,2020,3,2,5
Hungary,Serbia,2020,1,1,2
Wales,Republic of Ireland,2020,1,0,1
Bulgaria,Finland,2020,1,2,3
North Macedonia,Estonia,2020,2,1,3
Georgia,Armenia,2020,1,2,3
Slovenia,Kosovo,2020,2,1,3
Moldova,Greece,2020,0,2,2
Albania,Kazakhstan,2020,3,1,4
Belarus,Lithuania,2020,2,0,2
Guatemala,Honduras,2020,2,1,3
Jordan,Syria,2020,1,0,1
United Arab Emirates,Bahrain,2020,1,0,1
United States,Panama,2020,6,2,8
Basque Country,Costa Rica,2020,2,1,3
Croatia,Portugal,2020,2,3,5
France,Sweden,2020,4,2,6
Spain,Germany,2020,6,0,6
Switzerland,Ukraine,2020,3,0,3
Luxembourg,Azerbaijan,2020,0,0,0
Montenegro,Cyprus,2020,4,0,4
Andorra,Latvia,2020,0,5,5
Malta,Faroe Islands,2020,1,1,2
Gibraltar,Liechtenstein,2020,1,1,2
Bangladesh,Nepal,2020,0,0,0
Japan,Mexico,2020,0,2,2
South Korea,Qatar,2020,2,1,3
Saudi Arabia,Jamaica,2020,1,2,3
Uzbekistan,Iraq,2020,1,2,3
Ecuador,Colombia,2020,6,1,7
Venezuela,Chile,2020,2,1,3
Peru,Argentina,2020,0,2,2
Paraguay,Bolivia,2020,2,2,4
Uruguay,Brazil,2020,0,2,2
Bosnia and Herzegovina,Italy,2020,0,2,2
Poland,Netherlands,2020,1,2,3
England,Iceland,2020,4,0,4
Belgium,Denmark,2020,4,2,6
Northern Ireland,Romania,2020,1,1,2
Austria,Norway,2020,1,1,2
Czech Republic,Slovakia,2020,2,0,2
Israel,Scotland,2020,1,0,1
Hungary,Turkey,2020,2,0,2
Serbia,Russia,2020,5,0,5
Republic of Ireland,Bulgaria,2020,0,0,0
Wales,Finland,2020,3,1,4
Armenia,North Macedonia,2020,1,0,1
Georgia,Estonia,2020,0,0,0
Kosovo,Moldova,2020,1,0,1
Greece,Slovenia,2020,0,0,0
Albania,Belarus,2020,3,2,5
Kazakhstan,Lithuania,2020,1,2,3
Qatar,Bangladesh,2020,5,0,5
United States,El Salvador,2020,6,0,6
United Arab Emirates,Iraq,2021,0,0,0
Kuwait,Palestine,2021,0,1,1
Dominican Republic,Puerto Rico,2021,0,1,1
Guatemala,Puerto Rico,2021,1,0,1
Dominican Republic,Serbia,2021,0,0,0
Iraq,Kuwait,2021,2,1,3
Panama,Serbia,2021,0,0,0
United States,Trinidad and Tobago,2021,7,0,7
Jordan,Tajikistan,2021,2,0,2
Jordan,Tajikistan,2021,0,1,1
Jordan,Uzbekistan,2021,0,2,2
Guatemala,Nicaragua,2021,1,0,1
Kenya,South Sudan,2021,1,0,1
Kenya,Tanzania,2021,2,1,3
Ethiopia,Malawi,2021,4,0,4
Oman,Jordan,2021,0,0,0
Belarus,Honduras,2021,1,1,2
Jordan,Lebanon,2021,1,0,1
Kosovo,Lithuania,2021,4,0,4
Qatar,Luxembourg,2021,1,0,1
Antigua and Barbuda,Montserrat,2021,2,2,4
Suriname,Cayman Islands,2021,3,0,3
Guatemala,Cuba,2021,1,0,1
Dominican Republic,Dominica,2021,1,0,1
Saint Kitts and Nevis,Puerto Rico,2021,1,0,1
Portugal,Azerbaijan,2021,1,0,1
Serbia,Republic of Ireland,2021,3,2,5
France,Ukraine,2021,1,1,2
Finland,Bosnia and Herzegovina,2021,2,2,4
Belgium,Wales,2021,3,1,4
Estonia,Czech Republic,2021,2,6,8
Turkey,Netherlands,2021,4,2,6
Gibraltar,Norway,2021,0,3,3
Latvia,Montenegro,2021,1,2,3
Malta,Russia,2021,1,3,4
Slovenia,Croatia,2021,1,0,1
Cyprus,Slovakia,2021,0,0,0
Chad,Namibia,2021,0,3,3
Guinea,Mali,2021,1,0,1
South Sudan,Malawi,2021,0,1,1
Uganda,Burkina Faso,2021,0,0,0
São Tomé and Príncipe,Sudan,2021,0,2,2
Rwanda,Mozambique,2021,1,0,1
Ethiopia,Madagascar,2021,4,0,4
Bahrain,Syria,2021,3,1,4
India,Oman,2021,1,1,2
Japan,South Korea,2021,3,0,3
Saudi Arabia,Kuwait,2021,1,0,1
United States,Jamaica,2021,4,1,5
El Salvador,Grenada,2021,2,0,2
Canada,Bermuda,2021,5,1,6
Curaçao,Saint Vincent and the Grenadines,2021,5,0,5
Panama,Barbados,2021,1,0,1
Haiti,Belize,2021,2,0,2
Trinidad and Tobago,Guyana,2021,3,0,3
Spain,Greece,2021,1,1,2
Sweden,Georgia,2021,1,0,1
Bulgaria,Switzerland,2021,1,3,4
Italy,Northern Ireland,2021,2,0,2
Israel,Denmark,2021,0,2,2
Scotland,Austria,2021,2,2,4
Moldova,Faroe Islands,2021,1,1,2
England,San Marino,2021,5,0,5
Andorra,Albania,2021,0,1,1
Hungary,Poland,2021,3,3,6
Germany,Iceland,2021,3,0,3
Liechtenstein,Armenia,2021,0,1,1
Romania,North Macedonia,2021,3,2,5
South Africa,Ghana,2021,1,1,2
Gambia,Angola,2021,1,0,1
Gabon,DR Congo,2021,3,0,3
Comoros,Togo,2021,0,0,0
Kenya,Egypt,2021,1,1,2
Botswana,Zimbabwe,2021,0,1,1
Zambia,Algeria,2021,3,3,6
Equatorial Guinea,Tanzania,2021,1,0,1
Libya,Tunisia,2021,2,5,7
Tajikistan,Mongolia,2021,3,0,3
Chile,Bolivia,2021,2,1,3
Burundi,Central African Republic,2021,2,2,4
Mauritania,Morocco,2021,0,0,0
Cape Verde,Cameroon,2021,3,1,4
Eswatini,Guinea-Bissau,2021,1,3,4
Congo,Senegal,2021,0,0,0
Niger,Ivory Coast,2021,0,3,3
Bosnia and Herzegovina,Costa Rica,2021,0,0,0
Nepal,Bangladesh,2021,0,0,0
Qatar,Azerbaijan,2021,2,1,3
Wales,Mexico,2021,1,0,1
United States Virgin Islands,Antigua and Barbuda,2021,0,3,3
Aruba,Suriname,2021,0,6,6
British Virgin Islands,Guatemala,2021,0,3,3
Anguilla,Dominican Republic,2021,0,6,6
Turks and Caicos Islands,Nicaragua,2021,0,7,7
Bahamas,Saint Kitts and Nevis,2021,0,4,4
Republic of Ireland,Luxembourg,2021,0,1,1
Serbia,Portugal,2021,2,2,4
Belarus,Estonia,2021,4,2,6
Czech Republic,Belgium,2021,1,1,2
Montenegro,Gibraltar,2021,4,1,5
Netherlands,Latvia,2021,2,0,2
Norway,Turkey,2021,0,3,3
Russia,Slovenia,2021,2,1,3
Croatia,Cyprus,2021,1,0,1
Slovakia,Malta,2021,2,2,4
Lesotho,Sierra Leone,2021,0,0,0
Benin,Nigeria,2021,0,1,1
Greece,Honduras,2021,2,1,3
Northern Ireland,United States,2021,1,2,3
Montserrat,El Salvador,2021,1,1,2
Cuba,Curaçao,2021,1,2,3
Dominica,Panama,2021,1,2,3
Puerto Rico,Trinidad and Tobago,2021,1,1,2
Georgia,Spain,2021,1,2,3
Kosovo,Sweden,2021,0,3,3
Switzerland,Lithuania,2021,1,0,1
Bulgaria,Italy,2021,0,2,2
Kazakhstan,France,2021,0,2,2
Ukraine,Finland,2021,1,1,2
Denmark,Moldova,2021,8,0,8
Austria,Faroe Islands,2021,3,1,4
Israel,Scotland,2021,1,1,2
Albania,England,2021,0,2,2
Poland,Andorra,2021,3,0,3
San Marino,Hungary,2021,0,3,3
Armenia,Iceland,2021,2,0,2
North Macedonia,Liechtenstein,2021,5,0,5
Romania,Germany,2021,0,1,1
Namibia,Guinea,2021,2,1,3
Mali,Chad,2021,3,0,3
Ghana,São Tomé and Príncipe,2021,3,1,4
Sudan,South Africa,2021,2,0,2
Tunisia,Equatorial Guinea,2021,2,1,3
Tanzania,Libya,2021,1,0,1
Ecuador,Bolivia,2021,2,1,3
Kuwait,Lebanon,2021,1,1,2
Nepal,Bangladesh,2021,2,1,3
Uzbekistan,Iraq,2021,0,1,1
Cayman Islands,Canada,2021,0,11,11
Burkina Faso,South Sudan,2021,1,0,1
Malawi,Uganda,2021,1,0,1
Angola,Gabon,2021,2,0,2
DR Congo,Gambia,2021,1,0,1
Togo,Kenya,2021,1,2,3
Egypt,Comoros,2021,4,0,4
Algeria,Botswana,2021,5,0,5
Zimbabwe,Zambia,2021,0,2,2
United Arab Emirates,India,2021,6,0,6
Bahrain,Jordan,2021,1,2,3
Costa Rica,Mexico,2021,0,1,1
Iran,Syria,2021,3,0,3
Republic of Ireland,Qatar,2021,1,1,2
Grenada,United States Virgin Islands,2021,1,0,1
Bermuda,Aruba,2021,5,0,5
Saint Vincent and the Grenadines,British Virgin Islands,2021,3,0,3
Barbados,Anguilla,2021,1,0,1
Belize,Turks and Caicos Islands,2021,5,0,5
Guyana,Bahamas,2021,4,0,4
Azerbaijan,Serbia,2021,1,2,3
Luxembourg,Portugal,2021,1,3,4
Wales,Czech Republic,2021,1,0,1
Belgium,Belarus,2021,8,0,8
Gibraltar,Netherlands,2021,0,7,7
Montenegro,Norway,2021,0,1,1
Turkey,Latvia,2021,3,3,6
Cyprus,Slovenia,2021,1,0,1
Croatia,Malta,2021,3,0,3
Slovakia,Russia,2021,2,1,3
Saudi Arabia,Palestine,2021,5,0,5
Japan,Mongolia,2021,14,0,14
Central African Republic,Mauritania,2021,0,1,1
Morocco,Burundi,2021,1,0,1
Cameroon,Rwanda,2021,0,0,0
Mozambique,Cape Verde,2021,0,1,1
Guinea-Bissau,Congo,2021,3,0,3
Senegal,Eswatini,2021,1,1,2
Ivory Coast,Ethiopia,2021,3,1,4
Madagascar,Niger,2021,0,0,0
Nigeria,Lesotho,2021,3,0,3
Sweden,Estonia,2021,1,0,1
Switzerland,Finland,2021,3,2,5
Spain,Kosovo,2021,3,1,4
Greece,Georgia,2021,1,1,2
Northern Ireland,Bulgaria,2021,0,0,0
Lithuania,Italy,2021,0,2,2
Bosnia and Herzegovina,France,2021,0,1,1
Ukraine,Kazakhstan,2021,1,1,2
Scotland,Faroe Islands,2021,4,0,4
Austria,Denmark,2021,0,4,4
Moldova,Israel,2021,1,4,5
England,Poland,2021,2,1,3
Andorra,Hungary,2021,1,4,5
San Marino,Albania,2021,0,2,2
Armenia,Romania,2021,3,2,5
Germany,North Macedonia,2021,1,2,3
Liechtenstein,Iceland,2021,1,4,5
Ukraine,Bahrain,2021,1,1,2
Iraq,Tajikistan,2021,0,0,0
United Arab Emirates,Jordan,2021,5,1,6
Indonesia,Afghanistan,2021,2,3,5
Oman,Thailand,2021,1,0,1
Turkey,Azerbaijan,2021,2,1,3
Bahrain,Malaysia,2021,2,0,2
Italy,San Marino,2021,7,0,7
Indonesia,Oman,2021,1,3,4
Iraq,Nepal,2021,6,2,8
Mexico,Iceland,2021,2,1,3
Singapore,Afghanistan,2021,1,1,2
Sweden,Finland,2021,2,0,2
Thailand,Tajikistan,2021,2,2,4
Malta,Northern Ireland,2021,0,3,3
Switzerland,United States,2021,2,1,3
Jordan,Vietnam,2021,1,1,2
Turkey,Guinea,2021,0,0,0
Croatia,Armenia,2021,1,1,2
Kosovo,San Marino,2021,4,1,5
North Macedonia,Slovenia,2021,1,1,2
Poland,Russia,2021,1,1,2
Slovakia,Bulgaria,2021,1,1,2
Lithuania,Estonia,2021,0,1,1
Belarus,Azerbaijan,2021,1,2,3
Bosnia and Herzegovina,Montenegro,2021,0,0,0
England,Austria,2021,1,0,1
France,Wales,2021,3,0,3
Germany,Denmark,2021,1,1,2
Mozambique,Lesotho,2021,5,0,5
Netherlands,Scotland,2021,2,2,4
Norway,Luxembourg,2021,1,0,1
Romania,Georgia,2021,1,2,3
Montserrat,United States Virgin Islands,2021,4,0,4
Cayman Islands,Aruba,2021,1,3,4
Cuba,British Virgin Islands,2021,5,0,5
Dominica,Anguilla,2021,3,0,3
Puerto Rico,Bahamas,2021,7,0,7
Algeria,Mauritania,2021,4,1,5
Andorra,Republic of Ireland,2021,1,4,5
Belgium,Greece,2021,1,1,2
Switzerland,Liechtenstein,2021,7,0,7
Turkey,Moldova,2021,2,0,2
Ukraine,Northern Ireland,2021,1,0,1
Mexico,Costa Rica,2021,0,0,0
United States,Honduras,2021,1,0,1
Nepal,Taiwan,2021,2,0,2
Iran,Hong Kong,2021,3,1,4
Bahrain,Cambodia,2021,8,0,8
Palestine,Singapore,2021,4,0,4
Bangladesh,Afghanistan,2021,1,1,2
United Arab Emirates,Malaysia,2021,4,0,4
Thailand,Indonesia,2021,2,2,4
Bolivia,Venezuela,2021,3,1,4
Uruguay,Paraguay,2021,0,0,0
Argentina,Chile,2021,1,1,2
Peru,Colombia,2021,0,3,3
Kuwait,Australia,2021,0,3,3
Qatar,India,2021,1,0,1
Faroe Islands,Iceland,2021,0,1,1
Finland,Estonia,2021,0,1,1
Hungary,Cyprus,2021,1,0,1
Italy,Czech Republic,2021,4,0,4
Kosovo,Malta,2021,2,1,3
Nigeria,Cameroon,2021,0,1,1
North Macedonia,Kazakhstan,2021,4,0,4
Rwanda,Central African Republic,2021,2,0,2
Slovenia,Gibraltar,2021,6,0,6
Spain,Portugal,2021,0,0,0
Latvia,Lithuania,2021,3,1,4
Maldives,Syria,2021,0,4,4
Antigua and Barbuda,Grenada,2021,1,0,1
Suriname,Bermuda,2021,6,0,6
Guatemala,Saint Vincent and the Grenadines,2021,10,0,10
Dominican Republic,Barbados,2021,1,1,2
Nicaragua,Belize,2021,3,0,3
Saint Kitts and Nevis,Guyana,2021,3,0,3
Brazil,Ecuador,2021,2,0,2
Guinea,Togo,2021,0,2,2
Ivory Coast,Burkina Faso,2021,2,1,3
Montenegro,Israel,2021,1,3,4
Niger,Gambia,2021,0,2,2
Russia,Bulgaria,2021,1,0,1
Senegal,Zambia,2021,3,1,4
Sweden,Armenia,2021,3,1,4
Tunisia,DR Congo,2021,1,0,1
Wales,Albania,2021,0,0,0
Saudi Arabia,Yemen,2021,3,0,3
Lebanon,Sri Lanka,2021,3,2,5
South Korea,Turkmenistan,2021,5,0,5
United States Virgin Islands,El Salvador,2021,0,7,7
Aruba,Canada,2021,0,7,7
British Virgin Islands,Curaçao,2021,0,8,8
Panama,Anguilla,2021,13,0,13
Turks and Caicos Islands,Haiti,2021,0,10,10
Bahamas,Trinidad and Tobago,2021,0,0,0
Algeria,Mali,2021,1,0,1
Austria,Slovakia,2021,0,0,0
Belgium,Croatia,2021,1,0,1
Denmark,Bosnia and Herzegovina,2021,2,0,2
England,Romania,2021,1,0,1
Luxembourg,Scotland,2021,0,1,1
Moldova,Azerbaijan,2021,1,0,1
Netherlands,Georgia,2021,3,0,3
Norway,Greece,2021,1,2,3
Honduras,Costa Rica,2021,2,2,4
United States,Mexico,2021,3,2,5
Andorra,Gibraltar,2021,0,0,0
Faroe Islands,Liechtenstein,2021,5,1,6
Germany,Latvia,2021,7,1,8
Rwanda,Central African Republic,2021,5,0,5
Serbia,Jamaica,2021,1,1,2
Ukraine,Cyprus,2021,4,0,4
Guam,Syria,2021,0,3,3
China PR,Philippines,2021,2,0,2
Nepal,Jordan,2021,0,3,3
Australia,Taiwan,2021,5,1,6
Iraq,Cambodia,2021,4,1,5
Uzbekistan,Singapore,2021,5,0,5
Bangladesh,India,2021,0,2,2
Kyrgyzstan,Mongolia,2021,0,1,1
Japan,Tajikistan,2021,4,1,5
United Arab Emirates,Thailand,2021,3,1,4
Vietnam,Indonesia,2021,4,0,4
Bahrain,Iran,2021,0,3,3
Qatar,Oman,2021,1,0,1
Benin,Zambia,2021,2,2,4
Cameroon,Nigeria,2021,0,0,0
Czech Republic,Albania,2021,3,1,4
France,Bulgaria,2021,3,0,3
Gambia,Togo,2021,1,0,1
Hungary,Republic of Ireland,2021,0,0,0
Kosovo,Guinea,2021,1,2,3
Morocco,Ghana,2021,1,0,1
Mozambique,Eswatini,2021,1,1,2
Poland,Iceland,2021,2,2,4
Senegal,Cape Verde,2021,2,0,2
Spain,Lithuania,2021,4,0,4
Grenada,Montserrat,2021,1,2,3
El Salvador,Antigua and Barbuda,2021,3,0,3
Canada,Suriname,2021,4,0,4
Bermuda,Cayman Islands,2021,1,1,2
Saint Vincent and the Grenadines,Cuba,2021,0,1,1
Curaçao,Guatemala,2021,0,0,0
Barbados,Dominica,2021,1,1,2
Panama,Dominican Republic,2021,3,0,3
Haiti,Nicaragua,2021,1,0,1
Guyana,Puerto Rico,2021,0,2,2
Trinidad and Tobago,Saint Kitts and Nevis,2021,2,0,2
Ecuador,Peru,2021,1,2,3
Colombia,Argentina,2021,2,2,4
Venezuela,Uruguay,2021,0,0,0
Paraguay,Brazil,2021,0,2,2
Chile,Bolivia,2021,1,1,2
Turkmenistan,Lebanon,2021,3,2,5
Niger,Congo,2021,0,1,1
Portugal,Israel,2021,4,0,4
United States,Costa Rica,2021,4,0,4
South Korea,Sri Lanka,2021,5,0,5
Estonia,Latvia,2021,2,1,3
South Africa,Uganda,2021,3,2,5
Philippines,Guam,2021,3,0,3
China PR,Maldives,2021,5,0,5
Nepal,Australia,2021,0,3,3
Kuwait,Jordan,2021,0,0,0
Cambodia,Iran,2021,0,10,10
Hong Kong,Iraq,2021,0,1,1
Yemen,Uzbekistan,2021,0,1,1
Afghanistan,Oman,2021,1,2,3
Myanmar,Kyrgyzstan,2021,1,8,9
Malaysia,Vietnam,2021,1,2,3
Japan,Serbia,2021,1,0,1
DR Congo,Mali,2021,1,1,2
Guinea,Niger,2021,2,1,3
Kosovo,Gambia,2021,1,0,1
Mauritania,Liberia,2021,1,0,1
Tunisia,Algeria,2021,0,2,2
Italy,Turkey,2021,3,0,3
Saudi Arabia,Singapore,2021,3,0,3
United Arab Emirates,Indonesia,2021,5,0,5
Haiti,Canada,2021,0,1,1
Panama,Curaçao,2021,2,1,3
Saint Kitts and Nevis,El Salvador,2021,0,4,4
Ghana,Ivory Coast,2021,0,0,0
Mexico,Honduras,2021,0,0,0
Morocco,Burkina Faso,2021,1,0,1
Wales,Switzerland,2021,1,1,2
Denmark,Finland,2021,0,1,1
Russia,Belgium,2021,0,3,3
South Korea,Lebanon,2021,2,1,3
Sudan,Zambia,2021,0,1,1
Tanzania,Malawi,2021,2,0,2
Austria,North Macedonia,2021,3,1,4
Netherlands,Ukraine,2021,3,2,5
England,Croatia,2021,1,0,1
Brazil,Venezuela,2021,3,0,3
Colombia,Ecuador,2021,1,0,1
Libya,Liberia,2021,0,1,1
Scotland,Czech Republic,2021,0,2,2
Poland,Slovakia,2021,1,2,3
Spain,Sweden,2021,0,0,0
Argentina,Chile,2021,1,1,2
Paraguay,Bolivia,2021,3,1,4
Philippines,Maldives,2021,1,1,2
China PR,Syria,2021,3,1,4
Australia,Jordan,2021,1,0,1
Bahrain,Hong Kong,2021,4,0,4
Iran,Iraq,2021,1,0,1
Palestine,Yemen,2021,3,0,3
Saudi Arabia,Uzbekistan,2021,3,0,3
Bangladesh,Oman,2021,0,3,3
India,Afghanistan,2021,1,1,2
Tajikistan,Myanmar,2021,4,0,4
Japan,Kyrgyzstan,2021,5,1,6
Thailand,Malaysia,2021,0,1,1
United Arab Emirates,Vietnam,2021,3,2,5
Canada,Haiti,2021,3,0,3
Curaçao,Panama,2021,0,0,0
El Salvador,Saint Kitts and Nevis,2021,2,0,2
Tunisia,Mali,2021,1,0,1
Djibouti,Somalia,2021,1,0,1
Hungary,Portugal,2021,0,3,3
Germany,France,2021,0,1,1
Kuwait,Taiwan,2021,2,1,3
Turkey,Wales,2021,0,2,2
Italy,Switzerland,2021,3,0,3
Russia,Finland,2021,1,0,1
Denmark,Belgium,2021,1,2,3
Ukraine,North Macedonia,2021,2,1,3
Netherlands,Austria,2021,2,0,2
Colombia,Venezuela,2021,0,0,0
Brazil,Peru,2021,4,0,4
Algeria,Liberia,2021,5,1,6
Croatia,Czech Republic,2021,1,1,2
England,Scotland,2021,0,0,0
Sweden,Slovakia,2021,1,0,1
Chile,Bolivia,2021,1,0,1
Argentina,Uruguay,2021,1,0,1
Spain,Poland,2021,1,1,2
Hungary,France,2021,1,1,2
Germany,Portugal,2021,4,2,6
Libya,Sudan,2021,0,1,1
Italy,Wales,2021,1,0,1
Switzerland,Turkey,2021,3,1,4
Venezuela,Ecuador,2021,2,2,4
Colombia,Peru,2021,1,2,3
Oman,Somalia,2021,2,1,3
Denmark,Russia,2021,4,1,5
Finland,Belgium,2021,0,2,2
Netherlands,North Macedonia,2021,3,0,3
Ukraine,Austria,2021,0,1,1
Uruguay,Chile,2021,1,1,2
Argentina,Paraguay,2021,1,0,1
Scotland,Croatia,2021,1,3,4
England,Czech Republic,2021,1,0,1
Mauritania,Yemen,2021,2,0,2
Spain,Slovakia,2021,5,0,5
Sweden,Poland,2021,3,2,5
Germany,Hungary,2021,2,2,4
Portugal,France,2021,2,2,4
Ecuador,Peru,2021,2,2,4
Brazil,Colombia,2021,2,1,3
Lebanon,Djibouti,2021,1,0,1
Bolivia,Uruguay,2021,0,2,2
Chile,Paraguay,2021,0,2,2
Palestine,Comoros,2021,5,1,6
Bahrain,Kuwait,2021,2,0,2
Italy,Austria,2021,2,1,3
Wales,Denmark,2021,0,4,4
Netherlands,Czech Republic,2021,0,2,2
Belgium,Portugal,2021,1,0,1
Brazil,Ecuador,2021,1,1,2
Venezuela,Peru,2021,0,1,1
El Salvador,Guatemala,2021,0,0,0
Croatia,Spain,2021,3,5,8
France,Switzerland,2021,3,3,6
Argentina,Bolivia,2021,4,1,5
Uruguay,Paraguay,2021,1,0,1
England,Germany,2021,2,0,2
Sweden,Ukraine,2021,1,2,3
Mexico,Panama,2021,3,0,3
Switzerland,Spain,2021,1,1,2
Belgium,Italy,2021,1,2,3
Peru,Paraguay,2021,3,3,6
Brazil,Chile,2021,1,0,1
Haiti,Saint Vincent and the Grenadines,2021,6,1,7
Trinidad and Tobago,Montserrat,2021,6,1,7
Bermuda,Barbados,2021,8,1,9
Czech Republic,Denmark,2021,1,2,3
Ukraine,England,2021,0,4,4
Mexico,Nigeria,2021,4,0,4
Uruguay,Colombia,2021,0,0,0
Argentina,Ecuador,2021,3,0,3
Guatemala,Guyana,2021,4,0,4
Cuba,French Guiana,2021,0,3,3
Guadeloupe,Bahamas,2021,2,0,2
Qatar,El Salvador,2021,1,0,1
Brazil,Peru,2021,1,0,1
Argentina,Colombia,2021,1,1,2
Italy,Spain,2021,1,1,2
Haiti,Bermuda,2021,4,1,5
Guatemala,Guadeloupe,2021,1,1,2
Trinidad and Tobago,French Guiana,2021,1,1,2
Eswatini,Lesotho,2021,3,1,4
South Africa,Botswana,2021,1,0,1
England,Denmark,2021,2,1,3
Mozambique,Zimbabwe,2021,0,0,0
Senegal,Namibia,2021,1,2,3
Zambia,Lesotho,2021,1,2,3
South Africa,Eswatini,2021,1,0,1
Peru,Colombia,2021,2,3,5
Malawi,Zimbabwe,2021,2,2,4
Senegal,Mozambique,2021,1,0,1
Brazil,Argentina,2021,0,1,1
Lesotho,Botswana,2021,0,4,4
Zambia,Eswatini,2021,0,1,1
Mexico,Trinidad and Tobago,2021,0,0,0
England,Italy,2021,1,1,2
Namibia,Zimbabwe,2021,2,0,2
Mozambique,Malawi,2021,2,0,2
El Salvador,Guatemala,2021,2,0,2
Canada,Martinique,2021,4,1,5
United States,Haiti,2021,1,0,1
Jamaica,Suriname,2021,2,0,2
Costa Rica,Guadeloupe,2021,3,1,4
Botswana,Zambia,2021,1,2,3
South Africa,Lesotho,2021,4,0,4
Senegal,Zimbabwe,2021,2,1,3
Malawi,Namibia,2021,1,1,2
Qatar,Panama,2021,3,3,6
Honduras,Grenada,2021,4,0,4
South Africa,Zambia,2021,0,0,0
Eswatini,Botswana,2021,1,1,2
Mozambique,Namibia,2021,1,0,1
Senegal,Malawi,2021,2,1,3
Trinidad and Tobago,El Salvador,2021,0,2,2
Guatemala,Mexico,2021,0,3,3
Haiti,Canada,2021,1,4,5
United States,Martinique,2021,6,1,7
Senegal,Eswatini,2021,2,2,4
South Africa,Mozambique,2021,3,0,3
Guadeloupe,Jamaica,2021,1,2,3
Suriname,Costa Rica,2021,1,2,3
Grenada,Qatar,2021,0,4,4
Panama,Honduras,2021,2,3,5
Eswatini,Mozambique,2021,1,1,2
South Africa,Senegal,2021,0,0,0
Guatemala,Trinidad and Tobago,2021,1,1,2
Mexico,El Salvador,2021,1,0,1
Martinique,Haiti,2021,1,2,3
United States,Canada,2021,1,0,1
Suriname,Guadeloupe,2021,2,1,3
Costa Rica,Jamaica,2021,1,0,1
Panama,Grenada,2021,3,1,4
Honduras,Qatar,2021,0,2,2
Mexico,Honduras,2021,3,0,3
Qatar,El Salvador,2021,3,2,5
Costa Rica,Canada,2021,0,2,2
United States,Jamaica,2021,1,0,1
Mexico,Canada,2021,2,1,3
United States,Qatar,2021,1,0,1
United States,Mexico,2021,1,0,1
El Salvador,Costa Rica,2021,0,0,0
Niger,Sudan,2021,2,1,3
Sudan,Niger,2021,3,0,3
Ethiopia,Sierra Leone,2021,0,0,0
Ethiopia,Uganda,2021,2,1,3
Bahrain,Haiti,2021,6,1,7
Comoros,Seychelles,2021,7,1,8
Finland,Wales,2021,0,0,0
Qatar,Serbia,2021,0,4,4
Switzerland,Greece,2021,2,1,3
Central African Republic,Cape Verde,2021,1,1,2
Mali,Rwanda,2021,1,0,1
Egypt,Angola,2021,1,0,1
Libya,Gabon,2021,2,1,3
Senegal,Togo,2021,2,0,2
Guinea-Bissau,Guinea,2021,1,1,2
Portugal,Republic of Ireland,2021,2,1,3
Luxembourg,Azerbaijan,2021,2,1,3
Kazakhstan,Ukraine,2021,2,2,4
France,Bosnia and Herzegovina,2021,1,1,2
Faroe Islands,Israel,2021,0,4,4
Denmark,Scotland,2021,2,0,2
Moldova,Austria,2021,0,2,2
Norway,Netherlands,2021,1,1,2
Latvia,Gibraltar,2021,3,1,4
Turkey,Montenegro,2021,2,2,4
Malta,Cyprus,2021,3,0,3
Slovenia,Slovakia,2021,1,1,2
Russia,Croatia,2021,0,0,0
Kyrgyzstan,Palestine,2021,1,0,1
Nepal,India,2021,1,1,2
Niger,Burkina Faso,2021,0,2,2
Algeria,Djibouti,2021,8,0,8
Kenya,Uganda,2021,0,0,0
Namibia,Congo,2021,1,1,2
Morocco,Sudan,2021,2,0,2
DR Congo,Tanzania,2021,1,1,2
Madagascar,Benin,2021,0,1,1
South Korea,Iraq,2021,0,0,0
Iran,Syria,2021,1,0,1
United Arab Emirates,Lebanon,2021,0,0,0
Japan,Oman,2021,0,1,1
Australia,China PR,2021,3,0,3
Saudi Arabia,Vietnam,2021,3,1,4
Georgia,Kosovo,2021,0,1,1
Sweden,Spain,2021,2,1,3
Italy,Bulgaria,2021,1,1,2
Lithuania,Northern Ireland,2021,1,4,5
Czech Republic,Belarus,2021,1,0,1
Estonia,Belgium,2021,2,5,7
Andorra,San Marino,2021,2,0,2
Hungary,England,2021,0,4,4
Poland,Albania,2021,4,1,5
Iceland,Romania,2021,0,2,2
Liechtenstein,Germany,2021,0,2,2
North Macedonia,Armenia,2021,0,0,0
Bolivia,Colombia,2021,1,1,2
Ecuador,Paraguay,2021,2,0,2
Peru,Uruguay,2021,1,1,2
Venezuela,Argentina,2021,1,3,4
Chile,Brazil,2021,0,1,1
Canada,Honduras,2021,1,1,2
El Salvador,United States,2021,0,0,0
Panama,Costa Rica,2021,0,0,0
Mexico,Jamaica,2021,2,1,3
Mauritania,Zambia,2021,1,2,3
Tunisia,Equatorial Guinea,2021,3,0,3
Nigeria,Liberia,2021,2,0,2
Mozambique,Ivory Coast,2021,0,0,0
Cameroon,Malawi,2021,2,0,2
Zimbabwe,South Africa,2021,0,0,0
Ghana,Ethiopia,2021,1,0,1
Bosnia and Herzegovina,Kuwait,2021,1,0,1
Burundi,Seychelles,2021,8,1,9
Haiti,Jordan,2021,2,0,2
Qatar,Portugal,2021,1,3,4
Republic of Ireland,Azerbaijan,2021,1,1,2
Serbia,Luxembourg,2021,4,1,5
Finland,Kazakhstan,2021,1,0,1
Ukraine,France,2021,1,1,2
Faroe Islands,Denmark,2021,0,1,1
Scotland,Moldova,2021,1,0,1
Israel,Austria,2021,5,2,7
Latvia,Norway,2021,0,2,2
Gibraltar,Turkey,2021,0,3,3
Netherlands,Montenegro,2021,4,0,4
Slovenia,Malta,2021,1,0,1
Cyprus,Russia,2021,0,2,2
Slovakia,Croatia,2021,0,1,1
Bangladesh,Palestine,2021,0,2,2
Estonia,Northern Ireland,2021,0,1,1
Nepal,India,2021,1,2,3
Sweden,Uzbekistan,2021,2,1,3
Rwanda,Kenya,2021,1,1,2
Gabon,Egypt,2021,1,1,2
Togo,Namibia,2021,0,1,1
Kosovo,Greece,2021,1,1,2
Spain,Georgia,2021,4,0,4
Bulgaria,Lithuania,2021,1,0,1
Switzerland,Italy,2021,0,0,0
Belarus,Wales,2021,2,3,5
Belgium,Czech Republic,2021,3,0,3
England,Andorra,2021,4,0,4
Albania,Hungary,2021,1,0,1
San Marino,Poland,2021,1,7,8
Iceland,North Macedonia,2021,2,2,4
Germany,Armenia,2021,6,0,6
Romania,Liechtenstein,2021,2,0,2
Ecuador,Chile,2021,0,0,0
Paraguay,Colombia,2021,1,1,2
Uruguay,Bolivia,2021,4,2,6
Peru,Venezuela,2021,1,0,1
Costa Rica,Mexico,2021,0,1,1
El Salvador,Honduras,2021,0,0,0
Jamaica,Panama,2021,0,3,3
United States,Canada,2021,1,1,2
Djibouti,Niger,2021,2,4,6
Liberia,Central African Republic,2021,1,0,1
Ivory Coast,Cameroon,2021,2,1,3
Uganda,Mali,2021,0,0,0
South Africa,Ghana,2021,1,0,1
Benin,DR Congo,2021,1,1,2
Kyrgyzstan,Bangladesh,2021,4,1,5
Bahrain,Jordan,2021,1,2,3
Comoros,Burundi,2021,1,0,1
Luxembourg,Qatar,2021,1,1,2
Burkina Faso,Algeria,2021,1,1,2
Zambia,Tunisia,2021,0,2,2
Equatorial Guinea,Mauritania,2021,1,0,1
Cape Verde,Nigeria,2021,1,2,3
Malawi,Mozambique,2021,1,0,1
Angola,Libya,2021,0,1,1
Ethiopia,Zimbabwe,2021,1,0,1
Congo,Senegal,2021,1,3,4
Sudan,Guinea-Bissau,2021,2,4,6
Tanzania,Madagascar,2021,3,2,5
Syria,United Arab Emirates,2021,1,1,2
South Korea,Lebanon,2021,1,0,1
Iraq,Iran,2021,0,3,3
China PR,Japan,2021,0,1,1
Vietnam,Australia,2021,0,1,1
Oman,Saudi Arabia,2021,0,1,1
Republic of Ireland,Serbia,2021,1,1,2
Azerbaijan,Portugal,2021,0,3,3
Bosnia and Herzegovina,Kazakhstan,2021,2,2,4
France,Finland,2021,2,0,2
Faroe Islands,Moldova,2021,2,1,3
Austria,Scotland,2021,0,1,1
Denmark,Israel,2021,5,0,5
Montenegro,Latvia,2021,0,0,0
Netherlands,Turkey,2021,6,1,7
Norway,Gibraltar,2021,5,1,6
Croatia,Slovenia,2021,3,0,3
Slovakia,Cyprus,2021,2,0,2
Russia,Malta,2021,2,0,2
Bulgaria,Georgia,2021,4,1,5
Czech Republic,Ukraine,2021,1,1,2
Guatemala,Nicaragua,2021,2,2,4
Kosovo,Spain,2021,0,2,2
Greece,Sweden,2021,2,1,3
Northern Ireland,Switzerland,2021,0,0,0
Italy,Lithuania,2021,5,0,5
Wales,Estonia,2021,0,0,0
Belarus,Belgium,2021,0,1,1
Albania,San Marino,2021,5,0,5
Hungary,Andorra,2021,2,1,3
Poland,England,2021,1,1,2
Iceland,Germany,2021,0,4,4
Armenia,Liechtenstein,2021,1,1,2
North Macedonia,Romania,2021,0,0,0
Costa Rica,Jamaica,2021,1,1,2
Panama,Mexico,2021,1,1,2
Canada,El Salvador,2021,3,0,3
Honduras,United States,2021,1,4,5
Colombia,Chile,2021,3,1,4
Paraguay,Venezuela,2021,2,1,3
Uruguay,Ecuador,2021,1,0,1
Argentina,Bolivia,2021,3,0,3
Brazil,Peru,2021,2,0,2
El Salvador,Guatemala,2021,0,2,2
Egypt,Liberia,2021,2,0,2
Sri Lanka,Bangladesh,2021,0,1,1
Maldives,Nepal,2021,0,1,1
Bangladesh,India,2021,1,1,2
Sri Lanka,Nepal,2021,2,3,5
Sudan,Guinea,2021,1,1,2
Morocco,Guinea-Bissau,2021,5,0,5
Bahrain,Curaçao,2021,4,0,4
Jordan,Malaysia,2021,4,0,4
Sierra Leone,South Sudan,2021,1,1,2
Italy,Spain,2021,1,2,3
Iraq,Lebanon,2021,0,0,0
South Korea,Syria,2021,2,1,3
United Arab Emirates,Iran,2021,0,1,1
Saudi Arabia,Japan,2021,1,0,1
China PR,Vietnam,2021,3,2,5
Australia,Oman,2021,3,1,4
Honduras,Costa Rica,2021,0,0,0
United States,Jamaica,2021,2,0,2
El Salvador,Panama,2021,1,0,1
Mexico,Canada,2021,1,1,2
Equatorial Guinea,Zambia,2021,2,0,2
Tunisia,Mauritania,2021,3,0,3
Liberia,Cape Verde,2021,1,2,3
Nigeria,Central African Republic,2021,0,1,1
Rwanda,Uganda,2021,0,1,1
Mali,Kenya,2021,5,0,5
DR Congo,Madagascar,2021,2,0,2
Tanzania,Benin,2021,0,1,1
Ecuador,Bolivia,2021,3,0,3
Venezuela,Brazil,2021,1,3,4
Paraguay,Argentina,2021,0,0,0
Peru,Chile,2021,2,0,2
Uruguay,Colombia,2021,0,0,0
Indonesia,Taiwan,2021,2,1,3
India,Sri Lanka,2021,0,0,0
Maldives,Bangladesh,2021,2,0,2
Belgium,France,2021,2,3,5
Czech Republic,Wales,2021,2,2,4
Estonia,Belarus,2021,2,0,2
Gibraltar,Montenegro,2021,0,3,3
Latvia,Netherlands,2021,0,1,1
Turkey,Norway,2021,1,1,2
Malta,Slovenia,2021,0,4,4
Cyprus,Croatia,2021,0,3,3
Russia,Slovakia,2021,1,0,1
Iceland,Armenia,2021,1,1,2
Germany,Romania,2021,2,1,3
Liechtenstein,North Macedonia,2021,0,4,4
Algeria,Niger,2021,6,1,7
Djibouti,Burkina Faso,2021,0,4,4
Malawi,Ivory Coast,2021,0,3,3
Cameroon,Mozambique,2021,3,1,4
Angola,Gabon,2021,3,1,4
Egypt,Libya,2021,1,0,1
Azerbaijan,Republic of Ireland,2021,0,3,3
Luxembourg,Serbia,2021,0,1,1
Sweden,Kosovo,2021,3,0,3
Georgia,Greece,2021,0,2,2
Lithuania,Bulgaria,2021,3,1,4
Switzerland,Northern Ireland,2021,2,0,2
Finland,Ukraine,2021,1,2,3
Kazakhstan,Bosnia and Herzegovina,2021,0,2,2
Scotland,Israel,2021,3,2,5
Faroe Islands,Austria,2021,0,2,2
Moldova,Denmark,2021,0,4,4
Andorra,England,2021,0,5,5
Hungary,Albania,2021,0,1,1
Poland,San Marino,2021,5,0,5
Ethiopia,South Africa,2021,1,3,4
Ghana,Zimbabwe,2021,3,1,4
Togo,Congo,2021,1,1,2
Senegal,Namibia,2021,4,1,5
Guinea,Sudan,2021,2,2,4
Curaçao,New Zealand,2021,1,2,3
Gambia,Sierra Leone,2021,1,2,3
Portugal,Qatar,2021,3,0,3
Uzbekistan,Malaysia,2021,5,1,6
Guam,Cambodia,2021,0,1,1
Morocco,Guinea-Bissau,2021,3,0,3
Costa Rica,El Salvador,2021,2,1,3
Jamaica,Canada,2021,0,0,0
Panama,United States,2021,1,0,1
Mexico,Honduras,2021,3,0,3
Zambia,Equatorial Guinea,2021,1,1,2
Mauritania,Tunisia,2021,0,0,0
Central African Republic,Nigeria,2021,0,2,2
Cape Verde,Liberia,2021,1,0,1
Kenya,Mali,2021,0,1,1
Uganda,Rwanda,2021,1,0,1
Benin,Tanzania,2021,0,1,1
Madagascar,DR Congo,2021,1,0,1
Bolivia,Peru,2021,1,0,1
Colombia,Brazil,2021,0,0,0
Venezuela,Ecuador,2021,2,1,3
Argentina,Uruguay,2021,3,0,3
Chile,Paraguay,2021,2,0,2
Maldives,Sri Lanka,2021,1,0,1
Nepal,India,2021,0,1,1
Italy,Belgium,2021,2,1,3
Spain,France,2021,1,2,3
Belarus,Czech Republic,2021,0,2,2
Estonia,Wales,2021,0,1,1
Netherlands,Gibraltar,2021,6,0,6
Norway,Montenegro,2021,2,0,2
Latvia,Turkey,2021,1,2,3
Cyprus,Malta,2021,2,2,4
Croatia,Slovakia,2021,2,2,4
Slovenia,Russia,2021,1,2,3
Iceland,Liechtenstein,2021,4,0,4
North Macedonia,Germany,2021,0,4,4
Romania,Armenia,2021,1,0,1
Burkina Faso,Djibouti,2021,2,0,2
Mozambique,Cameroon,2021,0,1,1
Ivory Coast,Malawi,2021,2,1,3
Gabon,Angola,2021,2,0,2
Libya,Egypt,2021,0,3,3
Taiwan,Indonesia,2021,0,3,3
Iran,South Korea,2021,1,1,2
Syria,Lebanon,2021,2,3,5
United Arab Emirates,Iraq,2021,2,2,4
Japan,Australia,2021,2,1,3
Oman,Vietnam,2021,3,1,4
Saudi Arabia,China PR,2021,3,2,5
Portugal,Luxembourg,2021,5,0,5
Serbia,Azerbaijan,2021,3,1,4
Kosovo,Georgia,2021,1,2,3
Sweden,Greece,2021,2,0,2
Bulgaria,Northern Ireland,2021,2,1,3
Lithuania,Switzerland,2021,0,4,4
Kazakhstan,Finland,2021,0,2,2
Ukraine,Bosnia and Herzegovina,2021,1,1,2
Faroe Islands,Scotland,2021,0,1,1
Denmark,Austria,2021,1,0,1
Israel,Moldova,2021,2,1,3
England,Hungary,2021,1,1,2
Albania,Poland,2021,0,1,1
San Marino,Andorra,2021,0,3,3
Niger,Algeria,2021,0,4,4
Zimbabwe,Ghana,2021,0,1,1
South Africa,Ethiopia,2021,1,0,1
Namibia,Senegal,2021,1,3,4
Congo,Togo,2021,1,2,3
Bahrain,New Zealand,2021,0,1,1
Jordan,Uzbekistan,2021,3,0,3
Republic of Ireland,Qatar,2021,4,0,4
South Sudan,Gambia,2021,1,2,3
Cambodia,Guam,2021,2,1,3
Morocco,Guinea,2021,4,1,5
Honduras,Jamaica,2021,0,2,2
United States,Costa Rica,2021,2,1,3
Canada,Panama,2021,4,1,5
El Salvador,Mexico,2021,0,2,2
Bangladesh,Nepal,2021,1,1,2
Maldives,India,2021,1,3,4
Bolivia,Paraguay,2021,4,0,4
Colombia,Ecuador,2021,0,0,0
Argentina,Peru,2021,1,0,1
Brazil,Uruguay,2021,4,1,5
Chile,Venezuela,2021,3,0,3
India,Nepal,2021,3,0,3
Mexico,Ecuador,2021,2,3,5
El Salvador,Bolivia,2021,0,1,1
Sri Lanka,Maldives,2021,4,4,8
Kosovo,Jordan,2021,0,2,2
Nicaragua,Cuba,2021,0,3,3
Bangladesh,Seychelles,2021,1,1,2
Czech Republic,Kuwait,2021,7,0,7
Kyrgyzstan,Singapore,2021,2,1,3
Serbia,Qatar,2021,4,0,4
Ukraine,Bulgaria,2021,1,1,2
Uganda,Kenya,2021,1,1,2
Rwanda,Mali,2021,0,3,3
Ethiopia,Ghana,2021,1,1,2
South Africa,Zimbabwe,2021,1,0,1
Congo,Namibia,2021,1,1,2
Togo,Senegal,2021,1,1,2
Tanzania,DR Congo,2021,0,3,3
Benin,Madagascar,2021,2,0,2
Lebanon,Iran,2021,1,2,3
Iraq,Syria,2021,1,1,2
South Korea,United Arab Emirates,2021,1,0,1
China PR,Oman,2021,1,1,2
Vietnam,Japan,2021,0,1,1
Australia,Saudi Arabia,2021,0,0,0
Republic of Ireland,Portugal,2021,0,0,0
Azerbaijan,Luxembourg,2021,1,3,4
Georgia,Sweden,2021,2,0,2
Greece,Spain,2021,0,1,1
Russia,Cyprus,2021,6,0,6
Malta,Croatia,2021,1,7,8
Slovakia,Slovenia,2021,2,2,4
Germany,Liechtenstein,2021,9,0,9
Armenia,North Macedonia,2021,0,5,5
Romania,Iceland,2021,0,0,0
Ecuador,Venezuela,2021,1,0,1
Paraguay,Chile,2021,0,1,1
Peru,Bolivia,2021,3,0,3
Brazil,Colombia,2021,1,0,1
Burkina Faso,Niger,2021,1,1,2
Djibouti,Algeria,2021,0,4,4
Gabon,Libya,2021,1,0,1
Angola,Egypt,2021,2,2,4
Guinea,Guinea-Bissau,2021,0,0,0
Morocco,Sudan,2021,3,0,3
Canada,Costa Rica,2021,1,0,1
Honduras,Panama,2021,2,3,5
El Salvador,Jamaica,2021,1,1,2
United States,Mexico,2021,2,0,2
Northern Ireland,Lithuania,2021,1,0,1
Italy,Switzerland,2021,1,1,2
Moldova,Scotland,2021,0,2,2
Denmark,Faroe Islands,2021,3,1,4
Austria,Israel,2021,4,2,6
England,Albania,2021,5,0,5
Andorra,Poland,2021,1,4,5
Hungary,San Marino,2021,4,0,4
Uruguay,Argentina,2021,0,1,1
Burundi,Myanmar,2021,2,1,3
Nicaragua,Cuba,2021,2,0,2
Sierra Leone,Comoros,2021,0,2,2
Bangladesh,Maldives,2021,2,1,3
Sri Lanka,Seychelles,2021,0,1,1
Zambia,Mauritania,2021,4,0,4
Equatorial Guinea,Tunisia,2021,1,0,1
Cape Verde,Central African Republic,2021,2,1,3
Liberia,Nigeria,2021,0,2,2
Malawi,Cameroon,2021,0,4,4
Ivory Coast,Mozambique,2021,3,0,3
Bosnia and Herzegovina,Finland,2021,1,3,4
France,Kazakhstan,2021,8,0,8
Wales,Belarus,2021,5,1,6
Belgium,Estonia,2021,3,1,4
Norway,Latvia,2021,0,0,0
Turkey,Gibraltar,2021,6,0,6
Montenegro,Netherlands,2021,2,2,4
Azerbaijan,Qatar,2021,2,2,4
Nicaragua,Cuba,2021,2,0,2
Mali,Uganda,2021,1,0,1
Zimbabwe,Ethiopia,2021,1,1,2
Ghana,South Africa,2021,1,0,1
Senegal,Congo,2021,2,0,2
DR Congo,Benin,2021,2,0,2
Madagascar,Tanzania,2021,1,1,2
Portugal,Serbia,2021,1,2,3
Luxembourg,Republic of Ireland,2021,0,3,3
Spain,Sweden,2021,1,0,1
Greece,Kosovo,2021,1,1,2
Croatia,Russia,2021,1,0,1
Malta,Slovakia,2021,0,6,6
Slovenia,Cyprus,2021,2,1,3
Liechtenstein,Romania,2021,0,2,2
North Macedonia,Iceland,2021,3,1,4
Armenia,Germany,2021,1,4,5
Georgia,Uzbekistan,2021,1,0,1
Lithuania,Kuwait,2021,1,1,2
Niger,Djibouti,2021,7,2,9
Kenya,Rwanda,2021,2,1,3
Namibia,Togo,2021,0,1,1
Guinea-Bissau,Sudan,2021,0,0,0
Northern Ireland,Italy,2021,0,0,0
Switzerland,Bulgaria,2021,4,0,4
Scotland,Denmark,2021,2,0,2
Austria,Moldova,2021,4,1,5
Israel,Faroe Islands,2021,3,2,5
Albania,Andorra,2021,1,0,1
Poland,Hungary,2021,1,2,3
San Marino,England,2021,0,10,10
Bahrain,Kyrgyzstan,2021,4,2,6
Belarus,Jordan,2021,1,0,1
Kazakhstan,Tajikistan,2021,1,0,1
New Zealand,Gambia,2021,2,0,2
Indonesia,Afghanistan,2021,0,1,1
Maldives,Seychelles,2021,0,0,0
Sri Lanka,Bangladesh,2021,2,1,3
Algeria,Burkina Faso,2021,2,2,4
Mauritania,Equatorial Guinea,2021,1,1,2
Tunisia,Zambia,2021,3,1,4
Liberia,Central African Republic,2021,3,1,4
Nigeria,Cape Verde,2021,1,1,2
Mozambique,Malawi,2021,1,0,1
Cameroon,Ivory Coast,2021,1,0,1
Egypt,Gabon,2021,2,1,3
Libya,Angola,2021,1,1,2
Morocco,Guinea,2021,3,0,3
Lebanon,United Arab Emirates,2021,0,1,1
Iraq,South Korea,2021,0,3,3
Syria,Iran,2021,0,3,3
China PR,Australia,2021,1,1,2
Vietnam,Saudi Arabia,2021,0,1,1
Oman,Japan,2021,0,1,1
Jamaica,United States,2021,1,1,2
Canada,Mexico,2021,2,1,3
Costa Rica,Honduras,2021,2,1,3
Panama,El Salvador,2021,2,1,3
Bosnia and Herzegovina,Ukraine,2021,0,2,2
Finland,France,2021,0,2,2
Wales,Belgium,2021,1,1,2
Czech Republic,Estonia,2021,2,0,2
Gibraltar,Latvia,2021,1,3,4
Montenegro,Turkey,2021,1,2,3
Netherlands,Norway,2021,2,0,2
Bolivia,Uruguay,2021,3,0,3
Venezuela,Peru,2021,1,2,3
Colombia,Paraguay,2021,0,0,0
Argentina,Brazil,2021,0,0,0
Chile,Ecuador,2021,0,2,2
Sri Lanka,Seychelles,2021,3,3,6
Indonesia,Myanmar,2021,4,1,5
Iraq,Oman,2021,1,1,2
Qatar,Bahrain,2021,1,0,1
Tunisia,Mauritania,2021,5,1,6
United Arab Emirates,Syria,2021,2,1,3
Morocco,Palestine,2021,4,0,4
Saudi Arabia,Jordan,2021,0,1,1
Algeria,Sudan,2021,4,0,4
Egypt,Lebanon,2021,1,0,1
Bahrain,Iraq,2021,0,0,0
Qatar,Oman,2021,2,1,3
Mauritania,United Arab Emirates,2021,0,1,1
Syria,Tunisia,2021,2,0,2
El Salvador,Ecuador,2021,1,1,2
Jordan,Morocco,2021,0,4,4
Palestine,Saudi Arabia,2021,1,1,2
Lebanon,Algeria,2021,0,2,2
Sudan,Egypt,2021,0,5,5
Oman,Bahrain,2021,3,0,3
Qatar,Iraq,2021,3,0,3
Syria,Mauritania,2021,1,2,3
Tunisia,United Arab Emirates,2021,1,0,1
Jordan,Palestine,2021,5,1,6
Morocco,Saudi Arabia,2021,1,0,1
Algeria,Egypt,2021,1,1,2
Lebanon,Sudan,2021,1,0,1
Mexico,Chile,2021,2,2,4
Tanzania,Uganda,2021,0,2,2
Tunisia,Oman,2021,2,1,3
Qatar,United Arab Emirates,2021,5,0,5
Egypt,Jordan,2021,3,1,4
Morocco,Algeria,2021,2,2,4
El Salvador,Chile,2021,0,1,1
Tunisia,Egypt,2021,1,0,1
Qatar,Algeria,2021,1,2,3
Qatar,Egypt,2021,0,0,0
Tunisia,Algeria,2021,0,2,2
United States,Bosnia and Herzegovina,2021,1,0,1
Mauritania,Burkina Faso,2021,0,0,0
Sudan,Ethiopia,2021,2,3,5
Malawi,Comoros,2021,2,1,3
Gabon,Burkina Faso,2022,0,3,3
Sudan,Zimbabwe,2022,0,0,0
Rwanda,Guinea,2022,3,0,3
Mauritania,Gabon,2022,1,1,2
Algeria,Ghana,2022,3,0,3
Rwanda,Guinea,2022,0,2,2
Cameroon,Burkina Faso,2022,2,1,3
Ethiopia,Cape Verde,2022,0,1,1
Senegal,Zimbabwe,2022,1,0,1
Guinea,Malawi,2022,1,0,1
Morocco,Ghana,2022,1,0,1
Comoros,Gabon,2022,0,1,1
Nigeria,Egypt,2022,1,0,1
Sudan,Guinea-Bissau,2022,0,0,0
Algeria,Sierra Leone,2022,0,0,0
Iceland,Uganda,2022,1,1,2
Equatorial Guinea,Ivory Coast,2022,0,1,1
Tunisia,Mali,2022,0,1,1
Mauritania,Gambia,2022,0,1,1
Cameroon,Ethiopia,2022,4,1,5
Cape Verde,Burkina Faso,2022,0,1,1
Senegal,Guinea,2022,0,0,0
Malawi,Zimbabwe,2022,2,1,3
Morocco,Comoros,2022,2,0,2
Gabon,Ghana,2022,1,1,2
South Korea,Iceland,2022,5,1,6
Nigeria,Sudan,2022,3,1,4
Guinea-Bissau,Egypt,2022,0,1,1
Colombia,Honduras,2022,2,1,3
Peru,Panama,2022,1,1,2
Ivory Coast,Sierra Leone,2022,2,2,4
Algeria,Equatorial Guinea,2022,0,1,1
Gambia,Mali,2022,1,1,2
Tunisia,Mauritania,2022,4,0,4
Burkina Faso,Ethiopia,2022,1,1,2
Cameroon,Cape Verde,2022,1,1,2
Moldova,Uganda,2022,2,3,5
Malawi,Senegal,2022,0,0,0
Zimbabwe,Guinea,2022,2,1,3
Gabon,Morocco,2022,2,2,4
Ghana,Comoros,2022,2,3,5
Egypt,Sudan,2022,1,0,1
Guinea-Bissau,Nigeria,2022,0,2,2
South Korea,Moldova,2022,4,0,4
Peru,Jamaica,2022,3,0,3
Ivory Coast,Algeria,2022,3,1,4
Sierra Leone,Equatorial Guinea,2022,0,1,1
Gambia,Tunisia,2022,1,0,1
Mali,Mauritania,2022,2,0,2
Bolivia,Trinidad and Tobago,2022,5,0,5
Iraq,Uganda,2022,1,0,1
Burkina Faso,Gabon,2022,1,1,2
Nigeria,Tunisia,2022,0,1,1
Cameroon,Comoros,2022,2,1,3
Guinea,Gambia,2022,0,1,1
Morocco,Malawi,2022,2,1,3
Senegal,Cape Verde,2022,2,0,2
Ivory Coast,Egypt,2022,0,0,0
Mali,Equatorial Guinea,2022,0,0,0
Bahrain,Uganda,2022,3,1,4
Indonesia,Timor-Leste,2022,4,1,5
Uzbekistan,South Sudan,2022,3,0,3
Jamaica,Mexico,2022,1,2,3
United States,El Salvador,2022,1,0,1
Honduras,Canada,2022,0,2,2
Costa Rica,Panama,2022,1,0,1
Lebanon,South Korea,2022,0,1,1
Iran,Iraq,2022,1,0,1
United Arab Emirates,Syria,2022,2,0,2
Japan,China PR,2022,2,0,2
Australia,Vietnam,2022,4,0,4
Saudi Arabia,Oman,2022,1,0,1
Ecuador,Brazil,2022,1,1,2
Paraguay,Uruguay,2022,0,1,1
Chile,Argentina,2022,1,2,3
Jordan,New Zealand,2022,3,1,4
Suriname,Barbados,2022,1,0,1
Colombia,Peru,2022,0,1,1
Venezuela,Bolivia,2022,4,1,5
Kuwait,Libya,2022,2,0,2
Nepal,Mauritius,2022,1,0,1
Nicaragua,Belize,2022,4,0,4
Burkina Faso,Tunisia,2022,1,0,1
Cameroon,Gambia,2022,2,0,2
Indonesia,Timor-Leste,2022,3,0,3
Egypt,Morocco,2022,2,1,3
Senegal,Equatorial Guinea,2022,3,1,4
Canada,United States,2022,2,0,2
Mexico,Costa Rica,2022,0,0,0
Panama,Jamaica,2022,3,2,5
Honduras,El Salvador,2022,0,2,2
Bahrain,DR Congo,2022,1,0,1
Kuwait,Libya,2022,0,2,2
Nepal,Mauritius,2022,1,0,1
Nicaragua,Belize,2022,1,1,2
Suriname,Guyana,2022,2,1,3
Lebanon,Iraq,2022,1,1,2
Iran,United Arab Emirates,2022,1,0,1
Syria,South Korea,2022,0,2,2
Vietnam,China PR,2022,3,1,4
Japan,Saudi Arabia,2022,2,0,2
Oman,Australia,2022,2,2,4
Bolivia,Chile,2022,2,3,5
Uruguay,Venezuela,2022,4,1,5
Argentina,Colombia,2022,1,0,1
Peru,Ecuador,2022,1,1,2
Brazil,Paraguay,2022,4,0,4
Burkina Faso,Senegal,2022,1,3,4
United States,Honduras,2022,3,0,3
Jamaica,Costa Rica,2022,0,1,1
El Salvador,Canada,2022,0,2,2
Mexico,Panama,2022,1,0,1
Cameroon,Egypt,2022,0,0,0
Cameroon,Burkina Faso,2022,3,3,6
Senegal,Egypt,2022,0,0,0
Cook Islands,Solomon Islands,2022,0,2,2
Papua New Guinea,New Zealand,2022,0,1,1
New Caledonia,Fiji,2022,1,2,3
Iraq,Zambia,2022,3,1,4
Mauritius,Seychelles,2022,0,0,0
Papua New Guinea,New Caledonia,2022,1,0,1
New Zealand,Fiji,2022,4,0,4
Bahrain,India,2022,2,1,3
Gibraltar,Grenada,2022,0,0,0
Guinea-Bissau,Equatorial Guinea,2022,3,0,3
Guadeloupe,Cape Verde,2022,0,2,2
Laos,Mongolia,2022,1,0,1
Malaysia,Philippines,2022,2,0,2
Mozambique,Niger,2022,1,1,2
Tanzania,Central African Republic,2022,3,1,4
Chad,Gambia,2022,0,1,1
Djibouti,South Sudan,2022,2,4,6
Seychelles,Lesotho,2022,0,0,0
Somalia,Eswatini,2022,0,3,3
Jamaica,El Salvador,2022,1,1,2
Mexico,United States,2022,0,0,0
Panama,Honduras,2022,1,1,2
Costa Rica,Canada,2022,1,0,1
Lebanon,Syria,2022,0,3,3
Iraq,United Arab Emirates,2022,1,0,1
South Korea,Iran,2022,2,0,2
China PR,Saudi Arabia,2022,1,1,2
Vietnam,Oman,2022,0,1,1
Australia,Japan,2022,0,2,2
Solomon Islands,Tahiti,2022,3,1,4
Fiji,Papua New Guinea,2022,1,2,3
New Zealand,New Caledonia,2022,7,1,8
Colombia,Bolivia,2022,3,0,3
Brazil,Chile,2022,4,0,4
Paraguay,Ecuador,2022,3,1,4
Uruguay,Peru,2022,1,0,1
Italy,North Macedonia,2022,0,1,1
Portugal,Turkey,2022,3,1,4
Sweden,Czech Republic,2022,1,0,1
Wales,Austria,2022,2,1,3
Armenia,Montenegro,2022,1,0,1
Guatemala,Cuba,2022,1,0,1
Hungary,Serbia,2022,0,1,1
Kosovo,Burkina Faso,2022,5,0,5
Liberia,Benin,2022,0,4,4
Maldives,Bangladesh,2022,2,0,2
Scotland,Poland,2022,1,1,2
Thailand,Nepal,2022,2,0,2
Togo,Sierra Leone,2022,3,0,3
Estonia,Cyprus,2022,0,0,0
Moldova,Kazakhstan,2022,1,2,3
Mauritius,São Tomé and Príncipe,2022,3,0,3
Cameroon,Algeria,2022,0,1,1
DR Congo,Morocco,2022,1,1,2
Egypt,Senegal,2022,1,0,1
Ghana,Nigeria,2022,0,0,0
Mali,Tunisia,2022,0,1,1
Argentina,Venezuela,2022,3,0,3
Andorra,Saint Kitts and Nevis,2022,1,0,1
Bosnia and Herzegovina,Georgia,2022,0,1,1
Cape Verde,Liechtenstein,2022,6,0,6
Comoros,Ethiopia,2022,2,1,3
Congo,Zambia,2022,1,3,4
France,Ivory Coast,2022,2,1,3
Latvia,Kuwait,2022,1,1,2
Luxembourg,Northern Ireland,2022,1,3,4
Malta,Azerbaijan,2022,1,0,1
Norway,Slovakia,2022,2,0,2
Romania,Greece,2022,0,1,1
San Marino,Lithuania,2022,1,2,3
South Africa,Guinea,2022,0,0,0
Tajikistan,Uganda,2022,1,1,2
Trinidad and Tobago,Barbados,2022,9,0,9
Uzbekistan,Kyrgyzstan,2022,3,1,4
Angola,Guinea-Bissau,2022,3,2,5
Bahrain,Burundi,2022,1,0,1
Belarus,India,2022,3,0,3
Central African Republic,Sudan,2022,0,0,0
Croatia,Slovenia,2022,1,1,2
England,Switzerland,2022,2,1,3
Finland,Iceland,2022,1,1,2
Germany,Israel,2022,2,0,2
Gibraltar,Faroe Islands,2022,0,0,0
Libya,Niger,2022,2,1,3
Mauritania,Mozambique,2022,2,1,3
Netherlands,Denmark,2022,4,2,6
Qatar,Bulgaria,2022,2,1,3
Republic of Ireland,Belgium,2022,2,2,4
Singapore,Malaysia,2022,2,1,3
Spain,Albania,2022,2,1,3
El Salvador,Costa Rica,2022,1,2,3
Canada,Jamaica,2022,4,0,4
Honduras,Mexico,2022,0,1,1
United States,Panama,2022,5,1,6
New Zealand,Tahiti,2022,1,0,1
Solomon Islands,Papua New Guinea,2022,3,2,5
Barbados,Guyana,2022,0,5,5
Belize,Cuba,2022,0,3,3
Benin,Zambia,2022,2,1,3
Guatemala,Haiti,2022,2,1,3
Laos,Brunei,2022,3,2,5
Liberia,Sierra Leone,2022,0,1,1
Thailand,Suriname,2022,1,0,1
South Sudan,Djibouti,2022,1,0,1
Lesotho,Seychelles,2022,3,1,4
Eswatini,Somalia,2022,2,1,3
Mauritius,São Tomé and Príncipe,2022,3,3,6
Andorra,Grenada,2022,1,0,1
Cape Verde,San Marino,2022,2,0,2
Montenegro,Greece,2022,1,0,1
Vanuatu,Fiji,2022,1,2,3
Algeria,Cameroon,2022,1,2,3
Morocco,DR Congo,2022,4,1,5
Nigeria,Ghana,2022,1,1,2
Senegal,Egypt,2022,1,0,1
Tunisia,Mali,2022,0,0,0
Iran,Lebanon,2022,2,0,2
Syria,Iraq,2022,1,1,2
United Arab Emirates,South Korea,2022,1,0,1
Japan,Vietnam,2022,1,1,2
Oman,China PR,2022,2,0,2
Saudi Arabia,Australia,2022,1,0,1
Ecuador,Argentina,2022,1,1,2
Peru,Paraguay,2022,2,0,2
Bolivia,Brazil,2022,0,4,4
Venezuela,Colombia,2022,0,1,1
Chile,Uruguay,2022,0,2,2
Poland,Sweden,2022,2,0,2
Portugal,North Macedonia,2022,2,0,2
Albania,Georgia,2022,0,0,0
Angola,Equatorial Guinea,2022,0,0,0
Austria,Scotland,2022,2,2,4
Azerbaijan,Latvia,2022,0,1,1
Bahrain,Belarus,2022,0,1,1
Bangladesh,Mongolia,2022,0,0,0
Belgium,Burkina Faso,2022,3,0,3
Bosnia and Herzegovina,Luxembourg,2022,1,0,1
Congo,Sierra Leone,2022,1,2,3
Croatia,Bulgaria,2022,2,1,3
Denmark,Serbia,2022,3,0,3
England,Ivory Coast,2022,3,0,3
Faroe Islands,Liechtenstein,2022,1,0,1
Finland,Slovakia,2022,0,2,2
France,South Africa,2022,5,0,5
Israel,Romania,2022,2,2,4
Liberia,Burundi,2022,1,2,3
Malta,Kuwait,2022,2,0,2
Mauritania,Libya,2022,2,0,2
Netherlands,Germany,2022,1,1,2
Northern Ireland,Hungary,2022,0,1,1
Norway,Armenia,2022,9,0,9
Qatar,Slovenia,2022,0,0,0
Republic of Ireland,Lithuania,2022,1,0,1
Singapore,Philippines,2022,2,0,2
Spain,Iceland,2022,5,0,5
Switzerland,Kosovo,2022,1,1,2
Tanzania,Sudan,2022,1,1,2
Togo,Benin,2022,1,1,2
Trinidad and Tobago,Guyana,2022,1,1,2
Turkey,Italy,2022,2,3,5
Wales,Czech Republic,2022,1,1,2
Tajikistan,Kyrgyzstan,2022,1,0,1
Uzbekistan,Uganda,2022,4,2,6
Cyprus,Estonia,2022,2,0,2
Kazakhstan,Moldova,2022,0,1,1
Gambia,Chad,2022,2,2,4
Mexico,El Salvador,2022,2,0,2
Costa Rica,United States,2022,2,0,2
Panama,Canada,2022,1,0,1
Jamaica,Honduras,2022,2,1,3
Solomon Islands,New Zealand,2022,0,5,5
El Salvador,Guatemala,2022,0,4,4
Mexico,Guatemala,2022,0,0,0
Bahamas,Turks and Caicos Islands,2022,4,2,6
Dominica,Saint Vincent and the Grenadines,2022,2,1,3
Bahamas,Turks and Caicos Islands,2022,1,2,3
Dominica,Saint Vincent and the Grenadines,2022,3,1,4
Yoruba Nation,Matabeleland,2022,1,1,2
Biafra,Matabeleland,2022,0,1,1
Yoruba Nation,Biafra,2022,0,1,1
Mozambique,Eswatini,2022,0,1,1
Thailand,Bahrain,2022,3,1,4
Biafra,Matabeleland,2022,1,0,1
Bahrain,Myanmar,2022,2,0,2
Malaysia,Brunei,2022,4,0,4
Thailand,Turkmenistan,2022,1,0,1
Ethiopia,Lesotho,2022,1,1,2
India,Jordan,2022,0,2,2
Mexico,Nigeria,2022,2,1,3
United Arab Emirates,Gambia,2022,1,1,2
Ethiopia,Lesotho,2022,1,1,2
Trinidad and Tobago,Saint Lucia,2022,1,0,1
Thailand,Bahrain,2022,1,2,3
Italy,Argentina,2022,0,3,3
Scotland,Ukraine,2022,1,3,4
Angola,Central African Republic,2022,2,1,3
Ghana,Madagascar,2022,3,0,3
Libya,Botswana,2022,1,0,1
Poland,Wales,2022,2,1,3
Australia,Jordan,2022,2,1,3
Indonesia,Bangladesh,2022,0,0,0
Malta,Venezuela,2022,0,1,1
Kuwait,Singapore,2022,0,0,0
Malaysia,Hong Kong,2022,2,0,2
Syria,Tajikistan,2022,1,0,1
United States,Morocco,2022,3,0,3
Vietnam,Afghanistan,2022,2,0,2
Tunisia,Equatorial Guinea,2022,4,0,4
Mozambique,Rwanda,2022,1,1,2
Panama,Costa Rica,2022,2,0,2
Barbados,Antigua and Barbuda,2022,0,1,1
Guadeloupe,Cuba,2022,2,1,3
Belize,Dominican Republic,2022,0,2,2
French Guiana,Guatemala,2022,2,0,2
Anguilla,Dominica,2022,0,0,0
Czech Republic,Switzerland,2022,2,1,3
Spain,Portugal,2022,1,1,2
Israel,Iceland,2022,2,2,4
Serbia,Norway,2022,0,1,1
Slovenia,Sweden,2022,0,2,2
Northern Ireland,Greece,2022,0,1,1
Cyprus,Kosovo,2022,0,2,2
Georgia,Gibraltar,2022,4,0,4
Bulgaria,North Macedonia,2022,1,1,2
Estonia,San Marino,2022,2,0,2
Cambodia,Timor-Leste,2022,2,1,3
Ecuador,Nigeria,2022,1,0,1
Japan,Paraguay,2022,4,1,5
South Korea,Brazil,2022,1,5,6
Mexico,Uruguay,2022,0,3,3
Togo,Eswatini,2022,2,2,4
Burkina Faso,Cape Verde,2022,2,0,2
Comoros,Lesotho,2022,2,0,2
Ivory Coast,Zambia,2022,3,1,4
Curaçao,Honduras,2022,0,1,1
Bahamas,Saint Vincent and the Grenadines,2022,1,0,1
Nicaragua,Trinidad and Tobago,2022,2,1,3
Sint Maarten,United States Virgin Islands,2022,1,1,2
Turks and Caicos Islands,Bonaire,2022,1,4,5
Saint Martin,Aruba,2022,0,0,0
British Virgin Islands,Cayman Islands,2022,1,1,2
Croatia,Austria,2022,0,3,3
France,Denmark,2022,1,2,3
Belgium,Netherlands,2022,1,4,5
Kazakhstan,Azerbaijan,2022,2,0,2
Belarus,Slovakia,2022,0,1,1
Liechtenstein,Moldova,2022,0,2,2
Latvia,Andorra,2022,3,0,3
Nepal,Oman,2022,0,2,2
Namibia,Burundi,2022,1,1,2
Niger,Tanzania,2022,1,1,2
Algeria,Uganda,2022,2,0,2
Gambia,South Sudan,2022,1,0,1
Mali,Congo,2022,4,0,4
Mauritania,Sudan,2022,3,0,3
DR Congo,Gabon,2022,0,1,1
Senegal,Benin,2022,3,1,4
Suriname,Jamaica,2022,1,1,2
El Salvador,Grenada,2022,3,1,4
Bermuda,Haiti,2022,0,0,0
Montserrat,Guyana,2022,1,2,3
Hungary,England,2022,1,0,1
Italy,Germany,2022,1,1,2
Armenia,Republic of Ireland,2022,1,0,1
Finland,Bosnia and Herzegovina,2022,1,1,2
Montenegro,Romania,2022,2,0,2
Lithuania,Luxembourg,2022,0,2,2
Turkey,Faroe Islands,2022,4,0,4
Wales,Ukraine,2022,1,0,1
Malawi,Ethiopia,2022,2,1,3
Egypt,Guinea,2022,1,0,1
Central African Republic,Ghana,2022,1,1,2
Madagascar,Angola,2022,1,1,2
Botswana,Tunisia,2022,0,0,0
Costa Rica,Martinique,2022,2,0,2
Cuba,Barbados,2022,3,0,3
Antigua and Barbuda,Guadeloupe,2022,1,0,1
Guatemala,Belize,2022,2,0,2
Dominican Republic,French Guiana,2022,2,3,5
Dominica,Anguilla,2022,1,1,2
Portugal,Switzerland,2022,4,0,4
Czech Republic,Spain,2022,2,2,4
Serbia,Slovenia,2022,4,1,5
Sweden,Norway,2022,1,2,3
Cyprus,Northern Ireland,2022,0,0,0
Kosovo,Greece,2022,0,1,1
Gibraltar,North Macedonia,2022,0,2,2
Bulgaria,Georgia,2022,2,5,7
San Marino,Malta,2022,0,2,2
Argentina,Estonia,2022,5,0,5
Mexico,Ecuador,2022,0,0,0
Peru,New Zealand,2022,1,0,1
Saudi Arabia,Colombia,2022,0,1,1
United States,Uruguay,2022,0,0,0
Equatorial Guinea,Libya,2022,2,0,2
Honduras,Curaçao,2022,1,2,3
Saint Vincent and the Grenadines,Nicaragua,2022,2,2,4
Trinidad and Tobago,Bahamas,2022,1,0,1
Bonaire,Sint Maarten,2022,2,2,4
United States Virgin Islands,Turks and Caicos Islands,2022,3,2,5
Aruba,Saint Martin,2022,3,0,3
Cayman Islands,British Virgin Islands,2022,1,1,2
Austria,Denmark,2022,1,2,3
Croatia,France,2022,1,1,2
Iceland,Albania,2022,1,1,2
Belarus,Azerbaijan,2022,0,0,0
Slovakia,Kazakhstan,2022,0,1,1
Latvia,Liechtenstein,2022,1,0,1
Andorra,Moldova,2022,0,0,0
South Korea,Chile,2022,2,0,2
Japan,Brazil,2022,0,1,1
Eswatini,Burkina Faso,2022,1,3,4
Cape Verde,Togo,2022,2,0,2
Zambia,Comoros,2022,2,1,3
Senegal,Rwanda,2022,1,0,1
Jamaica,Suriname,2022,3,1,4
Grenada,El Salvador,2022,2,2,4
Guyana,Bermuda,2022,2,1,3
Haiti,Montserrat,2022,3,2,5
Germany,England,2022,1,1,2
Italy,Hungary,2022,2,1,3
Finland,Montenegro,2022,2,0,2
Bosnia and Herzegovina,Romania,2022,1,0,1
Faroe Islands,Luxembourg,2022,0,1,1
Lithuania,Turkey,2022,0,6,6
Kuwait,Indonesia,2022,1,2,3
Jordan,Nepal,2022,2,0,2
Philippines,Yemen,2022,0,0,0
Mongolia,Palestine,2022,0,1,1
Thailand,Maldives,2022,3,0,3
Uzbekistan,Sri Lanka,2022,3,0,3
Hong Kong,Afghanistan,2022,2,1,3
India,Cambodia,2022,2,0,2
Bahrain,Bangladesh,2022,2,0,2
Malaysia,Turkmenistan,2022,3,1,4
Tajikistan,Myanmar,2022,4,0,4
Kyrgyzstan,Singapore,2022,2,1,3
Uganda,Niger,2022,1,1,2
Tanzania,Algeria,2022,0,2,2
Congo,Gambia,2022,1,0,1
Gabon,Mauritania,2022,0,0,0
Sudan,DR Congo,2022,2,1,3
Benin,Mozambique,2022,0,1,1
Wales,Netherlands,2022,1,2,3
Belgium,Poland,2022,6,1,7
Republic of Ireland,Ukraine,2022,0,1,1
Scotland,Armenia,2022,2,0,2
Guinea-Bissau,São Tomé and Príncipe,2022,5,1,6
Nigeria,Sierra Leone,2022,2,1,3
Burundi,Cameroon,2022,0,1,1
Ethiopia,Egypt,2022,2,0,2
Guinea,Malawi,2022,1,0,1
South Sudan,Mali,2022,1,3,4
Lesotho,Ivory Coast,2022,0,0,0
Morocco,South Africa,2022,2,1,3
Panama,Martinique,2022,5,0,5
Canada,Curaçao,2022,4,0,4
Barbados,Guadeloupe,2022,0,1,1
Antigua and Barbuda,Cuba,2022,0,2,2
Belize,French Guiana,2022,1,1,2
Aruba,Saint Kitts and Nevis,2022,2,3,5
Dominica,Saint Lucia,2022,0,1,1
Cayman Islands,Puerto Rico,2022,0,3,3
Portugal,Czech Republic,2022,2,0,2
Switzerland,Spain,2022,0,1,1
Norway,Slovenia,2022,0,0,0
Sweden,Serbia,2022,0,1,1
Kosovo,Northern Ireland,2022,3,2,5
Greece,Cyprus,2022,3,0,3
Gibraltar,Bulgaria,2022,1,1,2
North Macedonia,Georgia,2022,0,3,3
Malta,Estonia,2022,1,2,3
New Zealand,Oman,2022,0,0,0
San Marino,Iceland,2022,0,1,1
Saudi Arabia,Venezuela,2022,0,1,1
United States,Grenada,2022,5,0,5
Saint Vincent and the Grenadines,Trinidad and Tobago,2022,0,2,2
Bahamas,Nicaragua,2022,0,2,2
Dominican Republic,Guatemala,2022,1,1,2
Austria,France,2022,1,1,2
Denmark,Croatia,2022,0,1,1
Albania,Israel,2022,1,2,3
Azerbaijan,Slovakia,2022,0,1,1
Belarus,Kazakhstan,2022,1,1,2
Moldova,Latvia,2022,2,4,6
Andorra,Liechtenstein,2022,2,1,3
South Korea,Paraguay,2022,2,2,4
Chile,Tunisia,2022,0,2,2
Japan,Ghana,2022,4,1,5
Kuwait,Nepal,2022,4,1,5
Indonesia,Jordan,2022,0,1,1
Mongolia,Philippines,2022,0,1,1
Yemen,Palestine,2022,0,5,5
Sri Lanka,Thailand,2022,0,2,2
Uzbekistan,Maldives,2022,4,0,4
Cambodia,Hong Kong,2022,0,3,3
India,Afghanistan,2022,2,1,3
Bangladesh,Turkmenistan,2022,1,2,3
Malaysia,Bahrain,2022,1,2,3
Singapore,Tajikistan,2022,0,1,1
Kyrgyzstan,Myanmar,2022,2,0,2
Mexico,Suriname,2022,3,0,3
Guyana,Haiti,2022,2,6,8
Montserrat,Bermuda,2022,3,2,5
United States Virgin Islands,Bonaire,2022,0,2,2
Sint Maarten,Turks and Caicos Islands,2022,8,2,10
England,Italy,2022,0,0,0
Hungary,Germany,2022,1,1,2
Wales,Belgium,2022,1,1,2
Netherlands,Poland,2022,2,2,4
Ukraine,Armenia,2022,3,0,3
Republic of Ireland,Scotland,2022,3,0,3
Montenegro,Bosnia and Herzegovina,2022,1,1,2
Romania,Finland,2022,1,0,1
Faroe Islands,Lithuania,2022,2,1,3
Luxembourg,Turkey,2022,0,2,2
Ecuador,Cape Verde,2022,1,0,1
Uruguay,Panama,2022,5,0,5
Martinique,Panama,2022,0,0,0
Cuba,Antigua and Barbuda,2022,3,1,4
Guadeloupe,Barbados,2022,2,1,3
Saint Kitts and Nevis,Saint Martin,2022,1,1,2
Saint Lucia,Anguilla,2022,2,0,2
Puerto Rico,British Virgin Islands,2022,6,0,6
Spain,Czech Republic,2022,2,0,2
Switzerland,Portugal,2022,1,0,1
Norway,Sweden,2022,3,2,5
Slovenia,Serbia,2022,2,2,4
Northern Ireland,Cyprus,2022,2,2,4
Greece,Kosovo,2022,2,0,2
North Macedonia,Gibraltar,2022,4,0,4
Georgia,Bulgaria,2022,0,0,0
Malta,San Marino,2022,1,0,1
Iran,Algeria,2022,1,2,3
Australia,Peru,2022,0,0,0
São Tomé and Príncipe,Nigeria,2022,0,10,10
Sierra Leone,Guinea-Bissau,2022,2,2,4
Morocco,Liberia,2022,2,0,2
Honduras,Canada,2022,2,1,3
Nicaragua,Bahamas,2022,4,0,4
Trinidad and Tobago,Saint Vincent and the Grenadines,2022,4,1,5
Guatemala,Dominican Republic,2022,2,0,2
Denmark,Austria,2022,2,0,2
France,Croatia,2022,0,1,1
Iceland,Israel,2022,2,2,4
Azerbaijan,Belarus,2022,2,0,2
Kazakhstan,Slovakia,2022,2,1,3
Albania,Estonia,2022,0,0,0
Costa Rica,New Zealand,2022,1,0,1
Kuwait,Jordan,2022,0,3,3
Indonesia,Nepal,2022,7,0,7
Palestine,Philippines,2022,4,0,4
Mongolia,Yemen,2022,2,0,2
Maldives,Sri Lanka,2022,1,0,1
Uzbekistan,Thailand,2022,2,0,2
Afghanistan,Cambodia,2022,2,2,4
India,Hong Kong,2022,4,0,4
Bahrain,Turkmenistan,2022,1,0,1
Malaysia,Bangladesh,2022,4,1,5
Myanmar,Singapore,2022,2,6,8
Kyrgyzstan,Tajikistan,2022,0,0,0
Jamaica,Mexico,2022,1,1,2
El Salvador,United States,2022,1,1,2
Haiti,Guyana,2022,6,0,6
French Guiana,Belize,2022,1,0,1
Bonaire,United States Virgin Islands,2022,2,0,2
Turks and Caicos Islands,Sint Maarten,2022,2,0,2
England,Hungary,2022,0,4,4
Germany,Italy,2022,5,2,7
Netherlands,Wales,2022,3,2,5
Poland,Belgium,2022,0,1,1
Armenia,Scotland,2022,1,4,5
Ukraine,Republic of Ireland,2022,1,1,2
Bosnia and Herzegovina,Finland,2022,3,2,5
Romania,Montenegro,2022,0,3,3
Luxembourg,Faroe Islands,2022,2,2,4
Turkey,Lithuania,2022,2,0,2
Moldova,Andorra,2022,2,1,3
Liechtenstein,Latvia,2022,0,2,2
Chile,Ghana,2022,0,0,0
Japan,Tunisia,2022,0,3,3
South Korea,Egypt,2022,4,1,5
Mapuche,Maule Sur,2022,0,1,1
Mapuche,Aymara,2022,3,1,4
Aymara,Maule Sur,2022,0,1,1
Mexico,Paraguay,2022,0,1,1
Fiji,New Caledonia,2022,1,0,1
Solomon Islands,New Caledonia,2022,1,0,1
Brunei Darussalam,Maldives,2022,0,3,3
Hong Kong,Myanmar,2022,2,0,2
Libya,Uganda,2022,0,0,0
San Marino,Seychelles,2022,0,0,0
Vietnam,Singapore,2022,4,0,4
Scotland,Ukraine,2022,3,0,3
Australia,New Zealand,2022,1,0,1
Cambodia,Bangladesh,2022,0,1,1
Comoros,Tunisia,2022,0,1,1
Iceland,Venezuela,2022,1,0,1
Suriname,Nicaragua,2022,2,1,3
Thailand,Malaysia,2022,1,1,2
Trinidad and Tobago,Tajikistan,2022,1,2,3
Croatia,Denmark,2022,2,1,3
France,Austria,2022,2,0,2
Belgium,Wales,2022,2,1,3
Poland,Netherlands,2022,0,2,2
Lithuania,Faroe Islands,2022,1,1,2
Turkey,Luxembourg,2022,3,3,6
Kazakhstan,Belarus,2022,2,1,3
Slovakia,Azerbaijan,2022,1,2,3
Latvia,Moldova,2022,1,2,3
Liechtenstein,Andorra,2022,0,2,2
Japan,United States,2022,2,0,2
Algeria,Guinea,2022,1,0,1
Argentina,Honduras,2022,3,0,3
Bahrain,Cape Verde,2022,1,2,3
Brazil,Ghana,2022,3,0,3
Cameroon,Uzbekistan,2022,0,2,2
Canada,Qatar,2022,2,0,2
DR Congo,Burkina Faso,2022,0,1,1
Egypt,Niger,2022,3,0,3
Iran,Uruguay,2022,1,0,1
Iraq,Oman,2022,1,1,2
Jordan,Syria,2022,2,0,2
South Korea,Costa Rica,2022,2,2,4
Mali,Zambia,2022,1,0,1
Morocco,Chile,2022,2,0,2
Paraguay,United Arab Emirates,2022,1,0,1
Rwanda,Equatorial Guinea,2022,0,0,0
Saudi Arabia,Ecuador,2022,0,0,0
Germany,Hungary,2022,0,1,1
Italy,England,2022,1,0,1
Bosnia and Herzegovina,Montenegro,2022,1,0,1
Finland,Romania,2022,1,1,2
Georgia,North Macedonia,2022,2,0,2
Bulgaria,Gibraltar,2022,5,1,6
Estonia,Malta,2022,2,1,3
Bolivia,Senegal,2022,0,2,2
Colombia,Guatemala,2022,4,1,5
Fiji,Solomon Islands,2022,2,2,4
Grenada,Saint Vincent and the Grenadines,2022,1,3,4
Hong Kong,Myanmar,2022,0,0,0
India,Singapore,2022,1,1,2
Indonesia,Curaçao,2022,3,2,5
Ivory Coast,Togo,2022,2,1,3
Laos,Maldives,2022,1,3,4
Madagascar,Congo,2022,3,3,6
Mauritania,Benin,2022,1,0,1
Mexico,Peru,2022,1,0,1
South Africa,Sierra Leone,2022,4,0,4
Tanzania,Uganda,2022,1,0,1
Vanuatu,Papua New Guinea,2022,0,1,1
Czech Republic,Portugal,2022,0,4,4
Spain,Switzerland,2022,1,2,3
Armenia,Ukraine,2022,0,5,5
Scotland,Republic of Ireland,2022,2,1,3
Israel,Albania,2022,2,1,3
Slovenia,Norway,2022,2,1,3
Serbia,Sweden,2022,4,1,5
Northern Ireland,Kosovo,2022,2,1,3
Cyprus,Greece,2022,1,0,1
Thailand,Trinidad and Tobago,2022,2,1,3
Malaysia,Tajikistan,2022,0,0,0
New Zealand,Australia,2022,0,2,2
Niger,Liberia,2022,0,0,0
Austria,Croatia,2022,1,3,4
Denmark,France,2022,2,0,2
Wales,Poland,2022,0,1,1
Netherlands,Belgium,2022,1,0,1
Faroe Islands,Turkey,2022,2,1,3
Luxembourg,Lithuania,2022,1,0,1
Slovakia,Belarus,2022,1,1,2
Azerbaijan,Kazakhstan,2022,3,0,3
Andorra,Latvia,2022,1,1,2
Moldova,Liechtenstein,2022,2,0,2
Ethiopia,Sudan,2022,2,2,4
Iraq,Syria,2022,1,0,1
Jordan,Oman,2022,1,0,1
England,Germany,2022,3,3,6
Hungary,Italy,2022,0,2,2
Montenegro,Finland,2022,0,2,2
Romania,Bosnia and Herzegovina,2022,4,1,5
Gibraltar,Georgia,2022,1,2,3
North Macedonia,Bulgaria,2022,0,1,1
San Marino,Estonia,2022,0,4,4
Fiji,Papua New Guinea,2022,0,1,1
Algeria,Nigeria,2022,2,1,3
Argentina,Jamaica,2022,3,0,3
Bahrain,Panama,2022,0,2,2
Brazil,Tunisia,2022,5,1,6
Brunei Darussalam,Laos,2022,1,0,1
Burkina Faso,Comoros,2022,2,1,3
Canada,Uruguay,2022,0,2,2
DR Congo,Sierra Leone,2022,3,0,3
Costa Rica,Uzbekistan,2022,2,1,3
Ecuador,Japan,2022,0,0,0
Egypt,Liberia,2022,3,0,3
Equatorial Guinea,Togo,2022,2,2,4
Ghana,Nicaragua,2022,1,0,1
Honduras,Guatemala,2022,2,1,3
Indonesia,Curaçao,2022,2,1,3
Iran,Senegal,2022,1,1,2
Ivory Coast,Guinea,2022,3,1,4
South Korea,Cameroon,2022,1,0,1
Libya,Tanzania,2022,2,1,3
Madagascar,Benin,2022,3,1,4
Malta,Israel,2022,2,1,3
Mauritania,Congo,2022,2,0,2
Mexico,Colombia,2022,2,3,5
Nepal,Bangladesh,2022,3,1,4
Paraguay,Morocco,2022,0,0,0
Peru,El Salvador,2022,4,1,5
Qatar,Chile,2022,2,2,4
Saudi Arabia,United States,2022,0,0,0
South Africa,Botswana,2022,1,0,1
United Arab Emirates,Venezuela,2022,0,4,4
Vietnam,India,2022,3,0,3
Portugal,Spain,2022,0,1,1
Switzerland,Czech Republic,2022,2,1,3
Republic of Ireland,Armenia,2022,3,2,5
Ukraine,Scotland,2022,0,0,0
Albania,Iceland,2022,1,1,2
Norway,Serbia,2022,0,2,2
Sweden,Slovenia,2022,1,1,2
Kosovo,Cyprus,2022,5,1,6
Greece,Northern Ireland,2022,3,1,4
Fiji,Solomon Islands,2022,1,0,1
Saint Vincent and the Grenadines,Grenada,2022,1,5,6
Saudi Arabia,North Macedonia,2022,1,0,1
Qatar,Guatemala,2022,2,0,2
Saudi Arabia,Albania,2022,1,1,2
Qatar,Honduras,2022,1,0,1
Saudi Arabia,Honduras,2022,0,0,0
Brunei,Timor-Leste,2022,6,2,8
Saudi Arabia,Iceland,2022,1,0,1
Qatar,Panama,2022,2,1,3
Brunei,Timor-Leste,2022,0,1,1
Albania,Qatar,2022,0,1,1
Cameroon,Jamaica,2022,1,1,2
Costa Rica,Nigeria,2022,2,0,2
Mexico,Iraq,2022,4,0,4
Iran,Nicaragua,2022,1,0,1
Saudi Arabia,Panama,2022,1,1,2
Bahrain,Canada,2022,2,2,4
South Korea,Iceland,2022,1,0,1
Iraq,Ecuador,2022,0,0,0
Syria,Algeria,2022,0,1,1
Venezuela,Panama,2022,2,2,4
Albania,Italy,2022,1,3,4
Algeria,Mali,2022,1,1,2
Andorra,Austria,2022,0,1,1
Cyprus,Bulgaria,2022,0,2,2
Czech Republic,Faroe Islands,2022,5,0,5
Dominican Republic,Cuba,2022,2,4,6
Gibraltar,Liechtenstein,2022,2,0,2
Iran,Tunisia,2022,0,2,2
Ivory Coast,Burundi,2022,4,0,4
Kosovo,Armenia,2022,2,2,4
Mexico,Sweden,2022,1,2,3
Moldova,Azerbaijan,2022,1,2,3
Nepal,Pakistan,2022,1,0,1
Nicaragua,El Salvador,2022,1,0,1
Oman,Germany,2022,0,1,1
Peru,Paraguay,2022,1,0,1
Poland,Chile,2022,1,0,1
Saudi Arabia,Croatia,2022,0,1,1
Turkey,Scotland,2022,2,1,3
United Arab Emirates,Argentina,2022,0,5,5
Uzbekistan,Kazakhstan,2022,2,0,2
Lithuania,Iceland,2022,0,0,0
Latvia,Estonia,2022,1,1,2
Angola,Botswana,2022,1,0,1
Gabon,Guinea-Bissau,2022,3,1,4
Israel,Zambia,2022,4,2,6
Japan,Canada,2022,1,2,3
Jordan,Spain,2022,1,3,4
Luxembourg,Hungary,2022,2,2,4
Malta,Greece,2022,2,2,4
Montenegro,Slovakia,2022,2,2,4
Morocco,Georgia,2022,3,0,3
Niger,Libya,2022,2,3,5
North Macedonia,Finland,2022,1,1,2
Portugal,Nigeria,2022,4,0,4
Republic of Ireland,Norway,2022,1,2,3
Romania,Slovenia,2022,1,2,3
Rwanda,Sudan,2022,0,0,0
South Africa,Mozambique,2022,2,1,3
Saint Lucia,San Marino,2022,1,1,2
Switzerland,Ghana,2022,0,2,2
Syria,Belarus,2022,0,1,1
Tajikistan,Russia,2022,0,0,0
Bahrain,Serbia,2022,1,5,6
Cameroon,Panama,2022,1,1,2
Dominican Republic,Cuba,2022,1,1,2
Egypt,Belgium,2022,2,1,3
Albania,Armenia,2022,2,0,2
Colombia,Paraguay,2022,2,0,2
Gibraltar,Andorra,2022,1,0,1
Guatemala,Nicaragua,2022,3,1,4
Ivory Coast,Burkina Faso,2022,1,2,3
Kosovo,Faroe Islands,2022,1,1,2
Kuwait,Lebanon,2022,2,0,2
Peru,Bolivia,2022,1,0,1
Rwanda,Sudan,2022,1,0,1
Sweden,Algeria,2022,2,0,2
Turkey,Czech Republic,2022,2,1,3
United Arab Emirates,Kazakhstan,2022,2,1,3
Estonia,Lithuania,2022,2,0,2
Latvia,Iceland,2022,1,1,2
Austria,Italy,2022,2,0,2
Gambia,Guinea-Bissau,2022,0,0,0
Hungary,Greece,2022,2,1,3
Israel,Cyprus,2022,2,3,5
Luxembourg,Bulgaria,2022,0,0,0
Malta,Republic of Ireland,2022,0,1,1
Moldova,Romania,2022,0,5,5
Niger,Gabon,2022,1,3,4
North Macedonia,Azerbaijan,2022,1,3,4
Norway,Finland,2022,1,1,2
Oman,Belarus,2022,2,0,2
Slovakia,Chile,2022,0,0,0
Slovenia,Montenegro,2022,1,0,1
South Africa,Angola,2022,1,1,2
Saint Lucia,San Marino,2022,1,0,1
Syria,Venezuela,2022,1,2,3
Uzbekistan,Russia,2022,0,0,0
Qatar,Ecuador,2022,0,2,2
Senegal,Netherlands,2022,0,2,2
England,Iran,2022,6,2,8
United States,Wales,2022,1,1,2
Argentina,Saudi Arabia,2022,1,2,3
Mexico,Poland,2022,0,0,0
Denmark,Tunisia,2022,0,0,0
France,Australia,2022,4,1,5
Germany,Japan,2022,1,2,3
Spain,Costa Rica,2022,7,0,7
Morocco,Croatia,2022,0,0,0
Belgium,Canada,2022,1,0,1
Switzerland,Cameroon,2022,1,0,1
Brazil,Serbia,2022,2,0,2
Uruguay,South Korea,2022,0,0,0
Portugal,Ghana,2022,3,2,5
Qatar,Senegal,2022,1,3,4
Netherlands,Ecuador,2022,1,1,2
Wales,Iran,2022,0,2,2
